
PokerStars Zoom Hand #247959620609:  Hold'em No Limit ($0.01/$0.02) - 2023/12/30 15:01:31 WET [2023/12/30 10:01:31 ET]
Table 'Halley' 6-max Seat #1 is the button
Seat 1: LLregs ($2 in chips)
Seat 2: Brak3D0wn ($2 in chips)
Seat 3: 888lifeIS ($2 in chips)
Seat 4: marcio14 ($2.05 in chips)
Seat 5: Anthony2027 ($5.01 in chips)
Seat 6: syuden ($2.06 in chips)
Brak3D0wn: posts small blind $0.01
888lifeIS: posts big blind $0.02
*** HOLE CARDS ***
Dealt to LLregs [4d 9d]
marcio14: folds
Anthony2027: folds
syuden: folds
LLregs: folds
Brak3D0wn: folds
Uncalled bet ($0.01) returned to 888lifeIS
888lifeIS collected $0.02 from pot
888lifeIS: doesn't show hand
*** SUMMARY ***
Total pot $0.02 | Rake $0
Seat 1: LLregs (button) folded before Flop (didn't bet)
Seat 2: Brak3D0wn (small blind) folded before Flop
Seat 3: 888lifeIS (big blind) collected ($0.02)
Seat 4: marcio14 folded before Flop (didn't bet)
Seat 5: Anthony2027 folded before Flop (didn't bet)
Seat 6: syuden folded before Flop (didn't bet)

PokerStars Zoom Hand #247959616356:  Hold'em No Limit ($0.01/$0.02) - 2023/12/30 15:01:13 WET [2023/12/30 10:01:13 ET]
Table 'Halley' 6-max Seat #1 is the button
Seat 1: rafds765 ($4.22 in chips)
Seat 2: mangalisa ($2.11 in chips)
Seat 3: LLregs ($2 in chips)
Seat 4: glennmackey ($1.99 in chips)
Seat 5: Ukr Troll ($10.01 in chips)
Seat 6: anatoliw ($2.21 in chips)
mangalisa: posts small blind $0.01
LLregs: posts big blind $0.02
*** HOLE CARDS ***
Dealt to LLregs [2h 4s]
glennmackey: raises $0.02 to $0.04
Ukr Troll: calls $0.04
anatoliw: folds
rafds765: folds
mangalisa: folds
LLregs: folds
*** FLOP *** [9c 6c Js]
glennmackey: bets $0.04
Ukr Troll: calls $0.04
*** TURN *** [9c 6c Js] [5d]
glennmackey: bets $0.06
Ukr Troll: calls $0.06
*** RIVER *** [9c 6c Js 5d] [Ad]
glennmackey: checks
Ukr Troll: checks
*** SHOW DOWN ***
glennmackey: shows [Ts 9s] (a pair of Nines)
Ukr Troll: shows [9d Th] (a pair of Nines)
glennmackey collected $0.15 from pot
Ukr Troll collected $0.15 from pot
*** SUMMARY ***
Total pot $0.31 | Rake $0.01
Board [9c 6c Js 5d Ad]
Seat 1: rafds765 (button) folded before Flop (didn't bet)
Seat 2: mangalisa (small blind) folded before Flop
Seat 3: LLregs (big blind) folded before Flop
Seat 4: glennmackey showed [Ts 9s] and won ($0.15) with a pair of Nines
Seat 5: Ukr Troll showed [9d Th] and won ($0.15) with a pair of Nines
Seat 6: anatoliw folded before Flop (didn't bet)

PokerStars Zoom Hand #247959622661:  Hold'em No Limit ($0.01/$0.02) - 2023/12/30 15:01:39 WET [2023/12/30 10:01:39 ET]
Table 'Halley' 6-max Seat #1 is the button
Seat 1: tomcel160 ($3.24 in chips)
Seat 2: quiet64 ($1.01 in chips)
Seat 3: sotui ($0.61 in chips)
Seat 4: flopasaurus1 ($2.27 in chips)
Seat 5: LLregs ($2 in chips)
Seat 6: Loucomeloo ($2.05 in chips)
quiet64: posts small blind $0.01
sotui: posts big blind $0.02
*** HOLE CARDS ***
Dealt to LLregs [Kc Qd]
flopasaurus1: raises $0.02 to $0.04
LLregs: calls $0.04
Loucomeloo: folds
tomcel160: folds
quiet64: calls $0.03
sotui: calls $0.02
*** FLOP *** [6c Kd 9c]
quiet64: bets $0.03
sotui: folds
flopasaurus1: raises $0.11 to $0.14
LLregs: calls $0.14
quiet64: folds
*** TURN *** [6c Kd 9c] [7h]
flopasaurus1: bets $0.34
LLregs: calls $0.34
*** RIVER *** [6c Kd 9c 7h] [Ac]
flopasaurus1: bets $0.22
LLregs: calls $0.22
*** SHOW DOWN ***
flopasaurus1: shows [Js Ks] (a pair of Kings)
LLregs: shows [Kc Qd] (a pair of Kings - Ace+Queen kicker)
LLregs collected $1.53 from pot
*** SUMMARY ***
Total pot $1.59 | Rake $0.06
Board [6c Kd 9c 7h Ac]
Seat 1: tomcel160 (button) folded before Flop (didn't bet)
Seat 2: quiet64 (small blind) folded on the Flop
Seat 3: sotui (big blind) folded on the Flop
Seat 4: flopasaurus1 showed [Js Ks] and lost with a pair of Kings
Seat 5: LLregs showed [Kc Qd] and won ($1.53) with a pair of Kings
Seat 6: Loucomeloo folded before Flop (didn't bet)

PokerStars Zoom Hand #247959640640:  Hold'em No Limit ($0.01/$0.02) - 2023/12/30 15:02:52 WET [2023/12/30 10:02:52 ET]
Table 'Halley' 6-max Seat #1 is the button
Seat 1: AFB1975 ($2.05 in chips)
Seat 2: nuttymuch ($2 in chips)
Seat 3: k7allinn ($3.15 in chips)
Seat 4: LLregs ($2.79 in chips)
Seat 5: pjsgalvao ($2.74 in chips)
Seat 6: erikpavon ($2 in chips)
nuttymuch: posts small blind $0.01
k7allinn: posts big blind $0.02
*** HOLE CARDS ***
Dealt to LLregs [Td 6c]
LLregs: folds
pjsgalvao: folds
erikpavon: raises $0.04 to $0.06
AFB1975: folds
nuttymuch: folds
k7allinn: raises $0.13 to $0.19
erikpavon: folds
Uncalled bet ($0.13) returned to k7allinn
k7allinn collected $0.13 from pot
k7allinn: doesn't show hand
*** SUMMARY ***
Total pot $0.13 | Rake $0
Seat 1: AFB1975 (button) folded before Flop (didn't bet)
Seat 2: nuttymuch (small blind) folded before Flop
Seat 3: k7allinn (big blind) collected ($0.13)
Seat 4: LLregs folded before Flop (didn't bet)
Seat 5: pjsgalvao folded before Flop (didn't bet)
Seat 6: erikpavon folded before Flop

PokerStars Zoom Hand #247959645729:  Hold'em No Limit ($0.01/$0.02) - 2023/12/30 15:03:12 WET [2023/12/30 10:03:12 ET]
Table 'Halley' 6-max Seat #1 is the button
Seat 1: carloseri795 ($2.08 in chips)
Seat 2: LLregs ($2.79 in chips)
Seat 3: Alcapy ($7.67 in chips)
Seat 4: dmitriy2426 ($1.79 in chips)
Seat 5: FrancoGaston74 ($2.66 in chips)
Seat 6: k7allinn ($3.22 in chips)
LLregs: posts small blind $0.01
Alcapy: posts big blind $0.02
*** HOLE CARDS ***
Dealt to LLregs [3d 6c]
dmitriy2426: folds
FrancoGaston74: folds
k7allinn: folds
carloseri795: folds
LLregs: folds
Uncalled bet ($0.01) returned to Alcapy
Alcapy collected $0.02 from pot
Alcapy: doesn't show hand
*** SUMMARY ***
Total pot $0.02 | Rake $0
Seat 1: carloseri795 (button) folded before Flop (didn't bet)
Seat 2: LLregs (small blind) folded before Flop
Seat 3: Alcapy (big blind) collected ($0.02)
Seat 4: dmitriy2426 folded before Flop (didn't bet)
Seat 5: FrancoGaston74 folded before Flop (didn't bet)
Seat 6: k7allinn folded before Flop (didn't bet)

PokerStars Zoom Hand #247959644591:  Hold'em No Limit ($0.01/$0.02) - 2023/12/30 15:03:08 WET [2023/12/30 10:03:08 ET]
Table 'Halley' 6-max Seat #1 is the button
Seat 1: grunge&punk ($5.68 in chips)
Seat 2: Jrussy ($1.41 in chips)
Seat 3: Thooorrr ($2 in chips)
Seat 4: sotui ($0.51 in chips)
Seat 5: LLregs ($2.79 in chips)
Seat 6: psdgr3 ($2 in chips)
Jrussy: posts small blind $0.01
Thooorrr: posts big blind $0.02
*** HOLE CARDS ***
Dealt to LLregs [2c 8h]
sotui: folds
LLregs: folds
psdgr3: folds
grunge&punk: raises $0.04 to $0.06
Jrussy: folds
Thooorrr: calls $0.04
*** FLOP *** [Td 8d 5d]
Thooorrr: checks
grunge&punk: bets $0.13
Thooorrr: folds
Uncalled bet ($0.13) returned to grunge&punk
grunge&punk collected $0.13 from pot
grunge&punk: doesn't show hand
*** SUMMARY ***
Total pot $0.13 | Rake $0
Board [Td 8d 5d]
Seat 1: grunge&punk (button) collected ($0.13)
Seat 2: Jrussy (small blind) folded before Flop
Seat 3: Thooorrr (big blind) folded on the Flop
Seat 4: sotui folded before Flop (didn't bet)
Seat 5: LLregs folded before Flop (didn't bet)
Seat 6: psdgr3 folded before Flop (didn't bet)

PokerStars Zoom Hand #247959646999:  Hold'em No Limit ($0.01/$0.02) - 2023/12/30 15:03:17 WET [2023/12/30 10:03:17 ET]
Table 'Halley' 6-max Seat #1 is the button
Seat 1: founder9 ($1.57 in chips)
Seat 2: mangalisa ($5.40 in chips)
Seat 3: LLregs ($2.78 in chips)
Seat 4: Jhon Rambo.CL ($2 in chips)
Seat 5: StariEger ($2.22 in chips)
Seat 6: Prince Mantis ($6.25 in chips)
mangalisa: posts small blind $0.01
LLregs: posts big blind $0.02
*** HOLE CARDS ***
Dealt to LLregs [Qh 5d]
Jhon Rambo.CL: folds
StariEger: folds
Prince Mantis: raises $0.03 to $0.05
founder9: folds
mangalisa: folds
LLregs: folds
Uncalled bet ($0.03) returned to Prince Mantis
Prince Mantis collected $0.05 from pot
Prince Mantis: doesn't show hand
*** SUMMARY ***
Total pot $0.05 | Rake $0
Seat 1: founder9 (button) folded before Flop (didn't bet)
Seat 2: mangalisa (small blind) folded before Flop
Seat 3: LLregs (big blind) folded before Flop
Seat 4: Jhon Rambo.CL folded before Flop (didn't bet)
Seat 5: StariEger folded before Flop (didn't bet)
Seat 6: Prince Mantis collected ($0.05)

PokerStars Zoom Hand #247959642128:  Hold'em No Limit ($0.01/$0.02) - 2023/12/30 15:02:58 WET [2023/12/30 10:02:58 ET]
Table 'Halley' 6-max Seat #1 is the button
Seat 1: Loucomeloo ($2 in chips)
Seat 2: tomcel160 ($3.28 in chips)
Seat 3: theprince188 ($2.51 in chips)
Seat 4: LLregs ($2.79 in chips)
Seat 5: THXforFoldin ($2.08 in chips)
Seat 6: iliyan66 ($4.55 in chips)
tomcel160: posts small blind $0.01
theprince188: posts big blind $0.02
*** HOLE CARDS ***
Dealt to LLregs [5h 3d]
LLregs: folds
THXforFoldin: folds
iliyan66: raises $0.02 to $0.04
Loucomeloo: folds
tomcel160: folds
theprince188: calls $0.02
*** FLOP *** [Js 2d Kc]
theprince188: checks
iliyan66: bets $0.09
theprince188: folds
Uncalled bet ($0.09) returned to iliyan66
iliyan66 collected $0.09 from pot
iliyan66: doesn't show hand
*** SUMMARY ***
Total pot $0.09 | Rake $0
Board [Js 2d Kc]
Seat 1: Loucomeloo (button) folded before Flop (didn't bet)
Seat 2: tomcel160 (small blind) folded before Flop
Seat 3: theprince188 (big blind) folded on the Flop
Seat 4: LLregs folded before Flop (didn't bet)
Seat 5: THXforFoldin folded before Flop (didn't bet)
Seat 6: iliyan66 collected ($0.09)

PokerStars Zoom Hand #247959651786:  Hold'em No Limit ($0.01/$0.02) - 2023/12/30 15:03:37 WET [2023/12/30 10:03:37 ET]
Table 'Halley' 6-max Seat #1 is the button
Seat 1: laoban888 ($2.25 in chips)
Seat 2: PovilasX ($2.58 in chips)
Seat 3: Kkemma3285 ($5.04 in chips)
Seat 4: kosatkazostravy ($2 in chips)
Seat 5: DeadKiriyama ($1.58 in chips)
Seat 6: LLregs ($2.76 in chips)
PovilasX: posts small blind $0.01
Kkemma3285: posts big blind $0.02
*** HOLE CARDS ***
Dealt to LLregs [3s 9d]
kosatkazostravy: folds
DeadKiriyama: folds
LLregs: folds
laoban888: folds
PovilasX: folds
Uncalled bet ($0.01) returned to Kkemma3285
Kkemma3285 collected $0.02 from pot
Kkemma3285: doesn't show hand
*** SUMMARY ***
Total pot $0.02 | Rake $0
Seat 1: laoban888 (button) folded before Flop (didn't bet)
Seat 2: PovilasX (small blind) folded before Flop
Seat 3: Kkemma3285 (big blind) collected ($0.02)
Seat 4: kosatkazostravy folded before Flop (didn't bet)
Seat 5: DeadKiriyama folded before Flop (didn't bet)
Seat 6: LLregs folded before Flop (didn't bet)

PokerStars Zoom Hand #247959652615:  Hold'em No Limit ($0.01/$0.02) - 2023/12/30 15:03:41 WET [2023/12/30 10:03:41 ET]
Table 'Halley' 6-max Seat #1 is the button
Seat 1: ifiret68 ($3.05 in chips)
Seat 2: jindjifill ($4.05 in chips)
Seat 3: theprince188 ($3 in chips)
Seat 4: LLregs ($2.76 in chips)
Seat 5: kygo19 ($2 in chips)
Seat 6: Jrussy ($1.52 in chips)
jindjifill: posts small blind $0.01
theprince188: posts big blind $0.02
*** HOLE CARDS ***
Dealt to LLregs [9s 2c]
LLregs: folds
kygo19: folds
Jrussy: folds
ifiret68: folds
jindjifill: folds
Uncalled bet ($0.01) returned to theprince188
theprince188 collected $0.02 from pot
theprince188: doesn't show hand
*** SUMMARY ***
Total pot $0.02 | Rake $0
Seat 1: ifiret68 (button) folded before Flop (didn't bet)
Seat 2: jindjifill (small blind) folded before Flop
Seat 3: theprince188 (big blind) collected ($0.02)
Seat 4: LLregs folded before Flop (didn't bet)
Seat 5: kygo19 folded before Flop (didn't bet)
Seat 6: Jrussy folded before Flop (didn't bet)

PokerStars Zoom Hand #247959650191:  Hold'em No Limit ($0.01/$0.02) - 2023/12/30 15:03:30 WET [2023/12/30 10:03:30 ET]
Table 'Halley' 6-max Seat #1 is the button
Seat 1: LLregs ($2.76 in chips)
Seat 2: ifiret68 ($3.06 in chips)
Seat 3: aricast19 ($2.11 in chips)
Seat 4: syuden ($2 in chips)
Seat 5: dave40k ($2.52 in chips)
Seat 6: EricksonWendel ($3.90 in chips)
ifiret68: posts small blind $0.01
aricast19: posts big blind $0.02
*** HOLE CARDS ***
Dealt to LLregs [7h 8s]
syuden: raises $0.03 to $0.05
dave40k: folds
EricksonWendel: calls $0.05
LLregs: folds
ifiret68: folds
aricast19: folds
*** FLOP *** [Kd Ts Ac]
syuden: bets $0.04
EricksonWendel: calls $0.04
*** TURN *** [Kd Ts Ac] [Kh]
syuden: checks
EricksonWendel: checks
*** RIVER *** [Kd Ts Ac Kh] [Ah]
syuden: checks
EricksonWendel: checks
*** SHOW DOWN ***
syuden: shows [Th 9h] (two pair, Aces and Kings)
EricksonWendel: shows [7s 7c] (two pair, Aces and Kings)
syuden collected $0.10 from pot
EricksonWendel collected $0.10 from pot
*** SUMMARY ***
Total pot $0.21 | Rake $0.01
Board [Kd Ts Ac Kh Ah]
Seat 1: LLregs (button) folded before Flop (didn't bet)
Seat 2: ifiret68 (small blind) folded before Flop
Seat 3: aricast19 (big blind) folded before Flop
Seat 4: syuden showed [Th 9h] and won ($0.10) with two pair, Aces and Kings
Seat 5: dave40k folded before Flop (didn't bet)
Seat 6: EricksonWendel showed [7s 7c] and won ($0.10) with two pair, Aces and Kings

PokerStars Zoom Hand #247959657945:  Hold'em No Limit ($0.01/$0.02) - 2023/12/30 15:04:01 WET [2023/12/30 10:04:01 ET]
Table 'Halley' 6-max Seat #1 is the button
Seat 1: DKD34 ($2.23 in chips)
Seat 2: LLregs ($2.74 in chips)
Seat 3: Soli56 ($4 in chips)
Seat 4: September 022 ($2.39 in chips)
Seat 5: mixi08 ($7.97 in chips)
Seat 6: AFB1975 ($1.97 in chips)
LLregs: posts small blind $0.01
Soli56: posts big blind $0.02
*** HOLE CARDS ***
Dealt to LLregs [8s 7h]
September 022: folds
mixi08: folds
AFB1975: folds
DKD34: folds
LLregs: folds
Uncalled bet ($0.01) returned to Soli56
Soli56 collected $0.02 from pot
Soli56: doesn't show hand
*** SUMMARY ***
Total pot $0.02 | Rake $0
Seat 1: DKD34 (button) folded before Flop (didn't bet)
Seat 2: LLregs (small blind) folded before Flop
Seat 3: Soli56 (big blind) collected ($0.02)
Seat 4: September 022 folded before Flop (didn't bet)
Seat 5: mixi08 folded before Flop (didn't bet)
Seat 6: AFB1975 folded before Flop (didn't bet)

PokerStars Zoom Hand #247959655155:  Hold'em No Limit ($0.01/$0.02) - 2023/12/30 15:03:51 WET [2023/12/30 10:03:51 ET]
Table 'Halley' 6-max Seat #1 is the button
Seat 1: Harold_Seven ($1.99 in chips)
Seat 2: piloudij ($1.08 in chips)
Seat 3: LLregs ($2.76 in chips)
Seat 4: MSerik ($2.12 in chips)
Seat 5: therookie1008 ($3.30 in chips)
Seat 6: scurvy idler ($2.43 in chips)
piloudij: posts small blind $0.01
LLregs: posts big blind $0.02
*** HOLE CARDS ***
Dealt to LLregs [5c 5h]
MSerik: folds
therookie1008: raises $0.03 to $0.05
scurvy idler: folds
Harold_Seven: folds
piloudij: folds
LLregs: folds
Uncalled bet ($0.03) returned to therookie1008
therookie1008 collected $0.05 from pot
therookie1008: doesn't show hand
*** SUMMARY ***
Total pot $0.05 | Rake $0
Seat 1: Harold_Seven (button) folded before Flop (didn't bet)
Seat 2: piloudij (small blind) folded before Flop
Seat 3: LLregs (big blind) folded before Flop
Seat 4: MSerik folded before Flop (didn't bet)
Seat 5: therookie1008 collected ($0.05)
Seat 6: scurvy idler folded before Flop (didn't bet)

PokerStars Zoom Hand #247959653920:  Hold'em No Limit ($0.01/$0.02) - 2023/12/30 15:03:46 WET [2023/12/30 10:03:46 ET]
Table 'Halley' 6-max Seat #1 is the button
Seat 1: erkin180 ($4.30 in chips)
Seat 2: Alcapy ($3.35 in chips)
Seat 3: tomcel160 ($2.01 in chips)
Seat 4: LLregs ($2.76 in chips)
Seat 5: Thooorrr ($2.03 in chips)
Seat 6: mangalisa ($4.28 in chips)
Alcapy: posts small blind $0.01
tomcel160: posts big blind $0.02
*** HOLE CARDS ***
Dealt to LLregs [As 8d]
LLregs: folds
Thooorrr: folds
mangalisa: raises $0.04 to $0.06
erkin180: calls $0.06
Alcapy: folds
tomcel160: folds
*** FLOP *** [5s Qc Jc]
mangalisa: bets $0.07
erkin180: calls $0.07
*** TURN *** [5s Qc Jc] [Ad]
mangalisa: bets $0.14
erkin180: folds
Uncalled bet ($0.14) returned to mangalisa
mangalisa collected $0.28 from pot
mangalisa: doesn't show hand
*** SUMMARY ***
Total pot $0.29 | Rake $0.01
Board [5s Qc Jc Ad]
Seat 1: erkin180 (button) folded on the Turn
Seat 2: Alcapy (small blind) folded before Flop
Seat 3: tomcel160 (big blind) folded before Flop
Seat 4: LLregs folded before Flop (didn't bet)
Seat 5: Thooorrr folded before Flop (didn't bet)
Seat 6: mangalisa collected ($0.28)

PokerStars Zoom Hand #247959660881:  Hold'em No Limit ($0.01/$0.02) - 2023/12/30 15:04:13 WET [2023/12/30 10:04:13 ET]
Table 'Halley' 6-max Seat #1 is the button
Seat 1: avilaC73 ($1.46 in chips)
Seat 2: Quorthon_Zei ($3.75 in chips)
Seat 3: Donnnna ($2.76 in chips)
Seat 4: flopasaurus1 ($2 in chips)
Seat 5: LLregs ($2.73 in chips)
Seat 6: jiggidies117 ($2.08 in chips)
Quorthon_Zei: posts small blind $0.01
Donnnna: posts big blind $0.02
*** HOLE CARDS ***
Dealt to LLregs [4d 2h]
flopasaurus1: folds
LLregs: folds
jiggidies117: folds
avilaC73: folds
Quorthon_Zei: folds
Uncalled bet ($0.01) returned to Donnnna
Donnnna collected $0.02 from pot
Donnnna: doesn't show hand
*** SUMMARY ***
Total pot $0.02 | Rake $0
Seat 1: avilaC73 (button) folded before Flop (didn't bet)
Seat 2: Quorthon_Zei (small blind) folded before Flop
Seat 3: Donnnna (big blind) collected ($0.02)
Seat 4: flopasaurus1 folded before Flop (didn't bet)
Seat 5: LLregs folded before Flop (didn't bet)
Seat 6: jiggidies117 folded before Flop (didn't bet)

PokerStars Zoom Hand #247959659992:  Hold'em No Limit ($0.01/$0.02) - 2023/12/30 15:04:10 WET [2023/12/30 10:04:10 ET]
Table 'Halley' 6-max Seat #1 is the button
Seat 1: September 022 ($2.27 in chips)
Seat 2: Poklikash? ($2.67 in chips)
Seat 3: Playmaker_SA ($8.56 in chips)
Seat 4: gnom1977 ($2.01 in chips)
Seat 5: Wahnsinn24 ($0.69 in chips)
Seat 6: LLregs ($2.73 in chips)
Poklikash?: posts small blind $0.01
Playmaker_SA: posts big blind $0.02
*** HOLE CARDS ***
Dealt to LLregs [6d 2h]
gnom1977: folds
Wahnsinn24: folds
LLregs: folds
September 022: folds
Poklikash?: raises $0.04 to $0.06
Playmaker_SA: raises $0.04 to $0.10
Poklikash?: folds
Uncalled bet ($0.04) returned to Playmaker_SA
Playmaker_SA collected $0.12 from pot
Playmaker_SA: doesn't show hand
*** SUMMARY ***
Total pot $0.12 | Rake $0
Seat 1: September 022 (button) folded before Flop (didn't bet)
Seat 2: Poklikash? (small blind) folded before Flop
Seat 3: Playmaker_SA (big blind) collected ($0.12)
Seat 4: gnom1977 folded before Flop (didn't bet)
Seat 5: Wahnsinn24 folded before Flop (didn't bet)
Seat 6: LLregs folded before Flop (didn't bet)

PokerStars Zoom Hand #247959658970:  Hold'em No Limit ($0.01/$0.02) - 2023/12/30 15:04:06 WET [2023/12/30 10:04:06 ET]
Table 'Halley' 6-max Seat #1 is the button
Seat 1: LLregs ($2.73 in chips)
Seat 2: vgg76 ($2.02 in chips)
Seat 3: febritto ($3.94 in chips)
Seat 4: Quorthon_Zei ($6.50 in chips)
Seat 5: Pedrowilso ($1.49 in chips)
Seat 6: piccolino25 ($2.64 in chips)
vgg76: posts small blind $0.01
febritto: posts big blind $0.02
*** HOLE CARDS ***
Dealt to LLregs [7h 8c]
Quorthon_Zei: folds
Pedrowilso: folds
piccolino25: calls $0.02
LLregs: folds
vgg76: folds
febritto: checks
*** FLOP *** [5c 4h Js]
febritto: checks
piccolino25: checks
*** TURN *** [5c 4h Js] [5d]
febritto: checks
piccolino25: bets $0.05
febritto: calls $0.05
*** RIVER *** [5c 4h Js 5d] [8d]
febritto: checks
piccolino25: bets $0.24
febritto: calls $0.24
*** SHOW DOWN ***
piccolino25: shows [5s As] (three of a kind, Fives)
febritto: mucks hand
piccolino25 collected $0.61 from pot
*** SUMMARY ***
Total pot $0.63 | Rake $0.02
Board [5c 4h Js 5d 8d]
Seat 1: LLregs (button) folded before Flop (didn't bet)
Seat 2: vgg76 (small blind) folded before Flop
Seat 3: febritto (big blind) mucked [Kc 9d]
Seat 4: Quorthon_Zei folded before Flop (didn't bet)
Seat 5: Pedrowilso folded before Flop (didn't bet)
Seat 6: piccolino25 showed [5s As] and won ($0.61) with three of a kind, Fives

PokerStars Zoom Hand #247959662968:  Hold'em No Limit ($0.01/$0.02) - 2023/12/30 15:04:21 WET [2023/12/30 10:04:21 ET]
Table 'Halley' 6-max Seat #1 is the button
Seat 1: Gambit1526 ($1.50 in chips)
Seat 2: Gerard Hopkins ($4.21 in chips)
Seat 3: laoban888 ($2.24 in chips)
Seat 4: LLregs ($2.73 in chips)
Seat 5: franpalermo14 ($2.24 in chips)
Seat 6: Dimoni797979 ($1.77 in chips)
Gerard Hopkins: posts small blind $0.01
laoban888: posts big blind $0.02
*** HOLE CARDS ***
Dealt to LLregs [Qd Qc]
LLregs: raises $0.04 to $0.06
franpalermo14: folds
Dimoni797979: folds
Gambit1526: folds
Gerard Hopkins: folds
laoban888: folds
Uncalled bet ($0.04) returned to LLregs
LLregs collected $0.05 from pot
LLregs: doesn't show hand
*** SUMMARY ***
Total pot $0.05 | Rake $0
Seat 1: Gambit1526 (button) folded before Flop (didn't bet)
Seat 2: Gerard Hopkins (small blind) folded before Flop
Seat 3: laoban888 (big blind) folded before Flop
Seat 4: LLregs collected ($0.05)
Seat 5: franpalermo14 folded before Flop (didn't bet)
Seat 6: Dimoni797979 folded before Flop (didn't bet)

PokerStars Zoom Hand #247959661968:  Hold'em No Limit ($0.01/$0.02) - 2023/12/30 15:04:18 WET [2023/12/30 10:04:18 ET]
Table 'Halley' 6-max Seat #1 is the button
Seat 1: zxczxc9999 ($2.40 in chips)
Seat 2: ungiwar ($1.26 in chips)
Seat 3: ivciks74lv ($2.32 in chips)
Seat 4: LLregs ($2.73 in chips)
Seat 5: franpalermo14 ($2.81 in chips)
Seat 6: theprince188 ($2.58 in chips)
ungiwar: posts small blind $0.01
ivciks74lv: posts big blind $0.02
*** HOLE CARDS ***
Dealt to LLregs [8c Kh]
LLregs: folds
franpalermo14: raises $0.02 to $0.04
theprince188: folds
zxczxc9999: folds
ungiwar: folds
ivciks74lv: calls $0.02
*** FLOP *** [Jd Tc 7h]
ivciks74lv: checks
franpalermo14: bets $0.05
ivciks74lv: folds
Uncalled bet ($0.05) returned to franpalermo14
franpalermo14 collected $0.09 from pot
franpalermo14: doesn't show hand
*** SUMMARY ***
Total pot $0.09 | Rake $0
Board [Jd Tc 7h]
Seat 1: zxczxc9999 (button) folded before Flop (didn't bet)
Seat 2: ungiwar (small blind) folded before Flop
Seat 3: ivciks74lv (big blind) folded on the Flop
Seat 4: LLregs folded before Flop (didn't bet)
Seat 5: franpalermo14 collected ($0.09)
Seat 6: theprince188 folded before Flop (didn't bet)

PokerStars Zoom Hand #247959667190:  Hold'em No Limit ($0.01/$0.02) - 2023/12/30 15:04:39 WET [2023/12/30 10:04:39 ET]
Table 'Halley' 6-max Seat #1 is the button
Seat 1: zetaocav ($0.45 in chips)
Seat 2: edhillm ($2.73 in chips)
Seat 3: LLregs ($2.76 in chips)
Seat 4: THXforFoldin ($2.85 in chips)
Seat 5: crazyJP ($1.26 in chips)
Seat 6: syuden ($2.10 in chips)
edhillm: posts small blind $0.01
LLregs: posts big blind $0.02
*** HOLE CARDS ***
Dealt to LLregs [Ad Qc]
THXforFoldin: folds
crazyJP: folds
syuden: folds
zetaocav: calls $0.02
edhillm: raises $0.06 to $0.08
LLregs: calls $0.06
zetaocav: calls $0.06
*** FLOP *** [3d Ts 4h]
edhillm: checks
LLregs: checks
zetaocav: bets $0.37 and is all-in
edhillm: folds
LLregs: calls $0.37
*** TURN *** [3d Ts 4h] [Ac]
*** RIVER *** [3d Ts 4h Ac] [9h]
*** SHOW DOWN ***
LLregs: shows [Ad Qc] (a pair of Aces)
zetaocav: shows [Jh Tc] (a pair of Tens)
LLregs collected $0.95 from pot
*** SUMMARY ***
Total pot $0.98 | Rake $0.03
Board [3d Ts 4h Ac 9h]
Seat 1: zetaocav (button) showed [Jh Tc] and lost with a pair of Tens
Seat 2: edhillm (small blind) folded on the Flop
Seat 3: LLregs (big blind) showed [Ad Qc] and won ($0.95) with a pair of Aces
Seat 4: THXforFoldin folded before Flop (didn't bet)
Seat 5: crazyJP folded before Flop (didn't bet)
Seat 6: syuden folded before Flop (didn't bet)

PokerStars Zoom Hand #247959683416:  Hold'em No Limit ($0.01/$0.02) - 2023/12/30 15:05:43 WET [2023/12/30 10:05:43 ET]
Table 'Halley' 6-max Seat #1 is the button
Seat 1: LLregs ($3.25 in chips)
Seat 2: dave40k ($2.14 in chips)
Seat 3: PR3SUR3 ($2.47 in chips)
Seat 4: DKD34 ($2.28 in chips)
Seat 5: lordz1 ($3.86 in chips)
Seat 6: SerberStepan ($2.32 in chips)
dave40k: posts small blind $0.01
PR3SUR3: posts big blind $0.02
*** HOLE CARDS ***
Dealt to LLregs [5d Qd]
DKD34: folds
lordz1: folds
SerberStepan: raises $0.04 to $0.06
LLregs: folds
dave40k: folds
PR3SUR3: folds
Uncalled bet ($0.04) returned to SerberStepan
SerberStepan collected $0.05 from pot
SerberStepan: doesn't show hand
*** SUMMARY ***
Total pot $0.05 | Rake $0
Seat 1: LLregs (button) folded before Flop (didn't bet)
Seat 2: dave40k (small blind) folded before Flop
Seat 3: PR3SUR3 (big blind) folded before Flop
Seat 4: DKD34 folded before Flop (didn't bet)
Seat 5: lordz1 folded before Flop (didn't bet)
Seat 6: SerberStepan collected ($0.05)

PokerStars Zoom Hand #247959687097:  Hold'em No Limit ($0.01/$0.02) - 2023/12/30 15:05:57 WET [2023/12/30 10:05:57 ET]
Table 'Halley' 6-max Seat #1 is the button
Seat 1: ifiret68 ($2.99 in chips)
Seat 2: Nee82 ($5.01 in chips)
Seat 3: MSerik ($2.03 in chips)
Seat 4: Loucomeloo ($2.15 in chips)
Seat 5: psdgr3 ($2 in chips)
Seat 6: LLregs ($3.25 in chips)
Nee82: posts small blind $0.01
MSerik: posts big blind $0.02
*** HOLE CARDS ***
Dealt to LLregs [6h 3h]
Loucomeloo: folds
psdgr3: folds
LLregs: folds
ifiret68: folds
Nee82: folds
Uncalled bet ($0.01) returned to MSerik
MSerik collected $0.02 from pot
MSerik: doesn't show hand
*** SUMMARY ***
Total pot $0.02 | Rake $0
Seat 1: ifiret68 (button) folded before Flop (didn't bet)
Seat 2: Nee82 (small blind) folded before Flop
Seat 3: MSerik (big blind) collected ($0.02)
Seat 4: Loucomeloo folded before Flop (didn't bet)
Seat 5: psdgr3 folded before Flop (didn't bet)
Seat 6: LLregs folded before Flop (didn't bet)

PokerStars Zoom Hand #247959678811:  Hold'em No Limit ($0.01/$0.02) - 2023/12/30 15:05:25 WET [2023/12/30 10:05:25 ET]
Table 'Halley' 6-max Seat #1 is the button
Seat 1: laoban888 ($2 in chips)
Seat 2: LLregs ($3.26 in chips)
Seat 3: marcio14 ($2.22 in chips)
Seat 4: 888lifeIS ($2 in chips)
Seat 5: franpalermo14 ($2.21 in chips)
Seat 6: Sperick ($2 in chips)
LLregs: posts small blind $0.01
marcio14: posts big blind $0.02
*** HOLE CARDS ***
Dealt to LLregs [Jd 3d]
888lifeIS: folds
franpalermo14: folds
Sperick: folds
laoban888: raises $0.04 to $0.06
LLregs: folds
marcio14: calls $0.04
*** FLOP *** [Ad 5c 3c]
marcio14: checks
laoban888: bets $0.10
marcio14: folds
Uncalled bet ($0.10) returned to laoban888
laoban888 collected $0.13 from pot
laoban888: doesn't show hand
*** SUMMARY ***
Total pot $0.13 | Rake $0
Board [Ad 5c 3c]
Seat 1: laoban888 (button) collected ($0.13)
Seat 2: LLregs (small blind) folded before Flop
Seat 3: marcio14 (big blind) folded on the Flop
Seat 4: 888lifeIS folded before Flop (didn't bet)
Seat 5: franpalermo14 folded before Flop (didn't bet)
Seat 6: Sperick folded before Flop (didn't bet)

PokerStars Zoom Hand #247959689108:  Hold'em No Limit ($0.01/$0.02) - 2023/12/30 15:06:06 WET [2023/12/30 10:06:06 ET]
Table 'Halley' 6-max Seat #1 is the button
Seat 1: Loucomeloo ($2.15 in chips)
Seat 2: Cpt_Price_67 ($1.84 in chips)
Seat 3: LLregs ($3.25 in chips)
Seat 4: chucho82 ($1.82 in chips)
Seat 5: THXforFoldin ($2.19 in chips)
Seat 6: zxczxc9999 ($2.42 in chips)
Cpt_Price_67: posts small blind $0.01
LLregs: posts big blind $0.02
*** HOLE CARDS ***
Dealt to LLregs [3d 8c]
chucho82: folds
THXforFoldin: folds
zxczxc9999: folds
Loucomeloo: folds
Cpt_Price_67: folds
Uncalled bet ($0.01) returned to LLregs
LLregs collected $0.02 from pot
LLregs: doesn't show hand
*** SUMMARY ***
Total pot $0.02 | Rake $0
Seat 1: Loucomeloo (button) folded before Flop (didn't bet)
Seat 2: Cpt_Price_67 (small blind) folded before Flop
Seat 3: LLregs (big blind) collected ($0.02)
Seat 4: chucho82 folded before Flop (didn't bet)
Seat 5: THXforFoldin folded before Flop (didn't bet)
Seat 6: zxczxc9999 folded before Flop (didn't bet)

PokerStars Zoom Hand #247959688028:  Hold'em No Limit ($0.01/$0.02) - 2023/12/30 15:06:01 WET [2023/12/30 10:06:01 ET]
Table 'Halley' 6-max Seat #1 is the button
Seat 1: StaNiUA ($2.06 in chips)
Seat 2: Ukr Troll ($5.77 in chips)
Seat 3: VIDOPRO23 ($1.80 in chips)
Seat 4: SerberStepan ($2.35 in chips)
Seat 5: bartovskii ($4.45 in chips)
Seat 6: LLregs ($3.25 in chips)
Ukr Troll: posts small blind $0.01
VIDOPRO23: posts big blind $0.02
*** HOLE CARDS ***
Dealt to LLregs [9s 7d]
SerberStepan: folds
bartovskii: raises $0.03 to $0.05
LLregs: folds
StaNiUA: raises $0.11 to $0.16
Ukr Troll: folds
VIDOPRO23: folds
bartovskii: calls $0.11
*** FLOP *** [9d 5c 5d]
bartovskii: checks
StaNiUA: bets $0.11
bartovskii: calls $0.11
*** TURN *** [9d 5c 5d] [6s]
bartovskii: checks
StaNiUA: bets $0.40
bartovskii: raises $3.78 to $4.18 and is all-in
StaNiUA: folds
Uncalled bet ($3.78) returned to bartovskii
bartovskii collected $1.32 from pot
bartovskii: doesn't show hand
*** SUMMARY ***
Total pot $1.37 | Rake $0.05
Board [9d 5c 5d 6s]
Seat 1: StaNiUA (button) folded on the Turn
Seat 2: Ukr Troll (small blind) folded before Flop
Seat 3: VIDOPRO23 (big blind) folded before Flop
Seat 4: SerberStepan folded before Flop (didn't bet)
Seat 5: bartovskii collected ($1.32)
Seat 6: LLregs folded before Flop (didn't bet)

PokerStars Zoom Hand #247959692878:  Hold'em No Limit ($0.01/$0.02) - 2023/12/30 15:06:21 WET [2023/12/30 10:06:21 ET]
Table 'Halley' 6-max Seat #1 is the button
Seat 1: Dexter9922 ($3.41 in chips)
Seat 2: syuden ($2.05 in chips)
Seat 3: PR3SUR3 ($3.10 in chips)
Seat 4: magnus59 ($1.88 in chips)
Seat 5: LLregs ($3.26 in chips)
Seat 6: Cpt_Price_67 ($1.83 in chips)
syuden: posts small blind $0.01
PR3SUR3: posts big blind $0.02
*** HOLE CARDS ***
Dealt to LLregs [Jd Jc]
magnus59: folds
LLregs: raises $0.04 to $0.06
Cpt_Price_67: raises $0.06 to $0.12
Dexter9922: folds
syuden: folds
PR3SUR3: folds
LLregs: calls $0.06
*** FLOP *** [Ac 4h 8s]
LLregs: checks
Cpt_Price_67: bets $0.13
LLregs: raises $0.17 to $0.30
Cpt_Price_67: calls $0.17
*** TURN *** [Ac 4h 8s] [Kd]
LLregs: bets $0.40
Cpt_Price_67: raises $0.40 to $0.80
LLregs: folds
Uncalled bet ($0.40) returned to Cpt_Price_67
Cpt_Price_67 collected $1.61 from pot
Cpt_Price_67: doesn't show hand
*** SUMMARY ***
Total pot $1.67 | Rake $0.06
Board [Ac 4h 8s Kd]
Seat 1: Dexter9922 (button) folded before Flop (didn't bet)
Seat 2: syuden (small blind) folded before Flop
Seat 3: PR3SUR3 (big blind) folded before Flop
Seat 4: magnus59 folded before Flop (didn't bet)
Seat 5: LLregs folded on the Turn
Seat 6: Cpt_Price_67 collected ($1.61)

PokerStars Zoom Hand #247959716676:  Hold'em No Limit ($0.01/$0.02) - 2023/12/30 15:07:54 WET [2023/12/30 10:07:54 ET]
Table 'Halley' 6-max Seat #1 is the button
Seat 1: Playmaker_SA ($8.32 in chips)
Seat 2: LLregs ($2.44 in chips)
Seat 3: latinofac ($2.34 in chips)
Seat 4: nuttymuch ($2.79 in chips)
Seat 5: kosatkazostravy ($2 in chips)
Seat 6: mangalisa ($5.10 in chips)
LLregs: posts small blind $0.01
latinofac: posts big blind $0.02
*** HOLE CARDS ***
Dealt to LLregs [Ts 8s]
nuttymuch: folds
kosatkazostravy: folds
mangalisa: folds
Playmaker_SA is disconnected
Playmaker_SA has timed out while disconnected
Playmaker_SA: folds
LLregs: raises $0.04 to $0.06
latinofac: folds
Uncalled bet ($0.04) returned to LLregs
LLregs collected $0.04 from pot
LLregs: doesn't show hand
*** SUMMARY ***
Total pot $0.04 | Rake $0
Seat 1: Playmaker_SA (button) folded before Flop (didn't bet)
Seat 2: LLregs (small blind) collected ($0.04)
Seat 3: latinofac (big blind) folded before Flop
Seat 4: nuttymuch folded before Flop (didn't bet)
Seat 5: kosatkazostravy folded before Flop (didn't bet)
Seat 6: mangalisa folded before Flop (didn't bet)

PokerStars Zoom Hand #247959715678:  Hold'em No Limit ($0.01/$0.02) - 2023/12/30 15:07:50 WET [2023/12/30 10:07:50 ET]
Table 'Halley' 6-max Seat #1 is the button
Seat 1: LLregs ($2.44 in chips)
Seat 2: C2DFMNLH ($2.23 in chips)
Seat 3: fuzza wuzza ($2.01 in chips)
Seat 4: carloseri795 ($4 in chips)
Seat 5: iliyan66 ($4.55 in chips)
Seat 6: Sperick ($2.30 in chips)
C2DFMNLH: posts small blind $0.01
fuzza wuzza: posts big blind $0.02
*** HOLE CARDS ***
Dealt to LLregs [8d Tc]
carloseri795: raises $0.04 to $0.06
iliyan66: calls $0.06
Sperick: folds
LLregs: folds
C2DFMNLH: folds
fuzza wuzza: calls $0.04
*** FLOP *** [8h 5d 7d]
fuzza wuzza: checks
carloseri795: bets $0.06
iliyan66: calls $0.06
fuzza wuzza: folds
*** TURN *** [8h 5d 7d] [6s]
carloseri795: bets $0.15
iliyan66: folds
Uncalled bet ($0.15) returned to carloseri795
carloseri795 collected $0.30 from pot
carloseri795: doesn't show hand
*** SUMMARY ***
Total pot $0.31 | Rake $0.01
Board [8h 5d 7d 6s]
Seat 1: LLregs (button) folded before Flop (didn't bet)
Seat 2: C2DFMNLH (small blind) folded before Flop
Seat 3: fuzza wuzza (big blind) folded on the Flop
Seat 4: carloseri795 collected ($0.30)
Seat 5: iliyan66 folded on the Turn
Seat 6: Sperick folded before Flop (didn't bet)

PokerStars Zoom Hand #247959722887:  Hold'em No Limit ($0.01/$0.02) - 2023/12/30 15:08:18 WET [2023/12/30 10:08:18 ET]
Table 'Halley' 6-max Seat #1 is the button
Seat 1: 888lifeIS ($2.23 in chips)
Seat 2: Delfinnegro2023 ($2.34 in chips)
Seat 3: scurvy idler ($2.15 in chips)
Seat 4: Dimoni797979 ($1.65 in chips)
Seat 5: LLregs ($2.46 in chips)
Seat 6: TPB_088_PONG ($2.32 in chips)
Delfinnegro2023: posts small blind $0.01
scurvy idler: posts big blind $0.02
*** HOLE CARDS ***
Dealt to LLregs [4d 4s]
Dimoni797979: folds
LLregs: folds
TPB_088_PONG: raises $0.03 to $0.05
888lifeIS: folds
Delfinnegro2023: folds
scurvy idler: folds
Uncalled bet ($0.03) returned to TPB_088_PONG
TPB_088_PONG collected $0.05 from pot
TPB_088_PONG: doesn't show hand
*** SUMMARY ***
Total pot $0.05 | Rake $0
Seat 1: 888lifeIS (button) folded before Flop (didn't bet)
Seat 2: Delfinnegro2023 (small blind) folded before Flop
Seat 3: scurvy idler (big blind) folded before Flop
Seat 4: Dimoni797979 folded before Flop (didn't bet)
Seat 5: LLregs folded before Flop (didn't bet)
Seat 6: TPB_088_PONG collected ($0.05)

PokerStars Zoom Hand #247959723672:  Hold'em No Limit ($0.01/$0.02) - 2023/12/30 15:08:21 WET [2023/12/30 10:08:21 ET]
Table 'Halley' 6-max Seat #1 is the button
Seat 1: Kkemma3285 ($2.06 in chips)
Seat 2: crazyJP ($2.01 in chips)
Seat 3: LLregs ($2.46 in chips)
Seat 4: tsutomu.t ($1.97 in chips)
Seat 5: THXforFoldin ($2 in chips)
Seat 6: OFSHOR ($2.46 in chips)
crazyJP: posts small blind $0.01
LLregs: posts big blind $0.02
*** HOLE CARDS ***
Dealt to LLregs [As 5s]
tsutomu.t: folds
THXforFoldin: folds
OFSHOR: folds
Kkemma3285: folds
crazyJP: raises $0.04 to $0.06
LLregs: calls $0.04
*** FLOP *** [4c Jh 8c]
crazyJP: checks
LLregs: bets $0.04
crazyJP: folds
Uncalled bet ($0.04) returned to LLregs
LLregs collected $0.12 from pot
LLregs: doesn't show hand
*** SUMMARY ***
Total pot $0.12 | Rake $0
Board [4c Jh 8c]
Seat 1: Kkemma3285 (button) folded before Flop (didn't bet)
Seat 2: crazyJP (small blind) folded on the Flop
Seat 3: LLregs (big blind) collected ($0.12)
Seat 4: tsutomu.t folded before Flop (didn't bet)
Seat 5: THXforFoldin folded before Flop (didn't bet)
Seat 6: OFSHOR folded before Flop (didn't bet)

PokerStars Zoom Hand #247959729905:  Hold'em No Limit ($0.01/$0.02) - 2023/12/30 15:08:45 WET [2023/12/30 10:08:45 ET]
Table 'Halley' 6-max Seat #1 is the button
Seat 1: LLregs ($2.52 in chips)
Seat 2: chri_zockt ($2.12 in chips)
Seat 3: 888lifeIS ($2.10 in chips)
Seat 4: DKD34 ($2.62 in chips)
Seat 5: chinex_sba ($2 in chips)
Seat 6: cawi1963 ($2.02 in chips)
chri_zockt: posts small blind $0.01
888lifeIS: posts big blind $0.02
*** HOLE CARDS ***
Dealt to LLregs [Ac 4h]
DKD34: folds
chinex_sba: folds
cawi1963: calls $0.02
LLregs: raises $0.04 to $0.06
chri_zockt: raises $0.20 to $0.26
888lifeIS: folds
cawi1963: folds
LLregs: folds
Uncalled bet ($0.20) returned to chri_zockt
chri_zockt collected $0.16 from pot
chri_zockt: doesn't show hand
*** SUMMARY ***
Total pot $0.16 | Rake $0
Seat 1: LLregs (button) folded before Flop
Seat 2: chri_zockt (small blind) collected ($0.16)
Seat 3: 888lifeIS (big blind) folded before Flop
Seat 4: DKD34 folded before Flop (didn't bet)
Seat 5: chinex_sba folded before Flop (didn't bet)
Seat 6: cawi1963 folded before Flop

PokerStars Zoom Hand #247959734202:  Hold'em No Limit ($0.01/$0.02) - 2023/12/30 15:09:02 WET [2023/12/30 10:09:02 ET]
Table 'Halley' 6-max Seat #1 is the button
Seat 1: VIDOPRO23 ($3.13 in chips)
Seat 2: LLregs ($2.46 in chips)
Seat 3: GODMARS911 ($1.40 in chips)
Seat 4: bartovskii ($5.02 in chips)
Seat 5: BlackYisus23 ($2.38 in chips)
Seat 6: JucyBits ($2.02 in chips)
LLregs: posts small blind $0.01
GODMARS911: posts big blind $0.02
*** HOLE CARDS ***
Dealt to LLregs [9c Qs]
bartovskii: raises $0.03 to $0.05
BlackYisus23: folds
JucyBits: folds
VIDOPRO23: folds
LLregs: folds
GODMARS911: calls $0.03
*** FLOP *** [2s 2c Jh]
GODMARS911: checks
bartovskii: bets $0.06
GODMARS911: folds
Uncalled bet ($0.06) returned to bartovskii
bartovskii collected $0.11 from pot
bartovskii: doesn't show hand
*** SUMMARY ***
Total pot $0.11 | Rake $0
Board [2s 2c Jh]
Seat 1: VIDOPRO23 (button) folded before Flop (didn't bet)
Seat 2: LLregs (small blind) folded before Flop
Seat 3: GODMARS911 (big blind) folded on the Flop
Seat 4: bartovskii collected ($0.11)
Seat 5: BlackYisus23 folded before Flop (didn't bet)
Seat 6: JucyBits folded before Flop (didn't bet)

PokerStars Zoom Hand #247959741609:  Hold'em No Limit ($0.01/$0.02) - 2023/12/30 15:09:31 WET [2023/12/30 10:09:31 ET]
Table 'Halley' 6-max Seat #1 is the button
Seat 1: Arabescul ($2.23 in chips)
Seat 2: PovilasX ($2.16 in chips)
Seat 3: StaNiUA ($2.17 in chips)
Seat 4: zeroelegante ($9.13 in chips)
Seat 5: LLregs ($2.45 in chips)
Seat 6: mangalisa ($2.63 in chips)
PovilasX: posts small blind $0.01
StaNiUA: posts big blind $0.02
*** HOLE CARDS ***
Dealt to LLregs [As Js]
zeroelegante: folds
LLregs: raises $0.04 to $0.06
mangalisa: folds
Arabescul: folds
PovilasX: folds
StaNiUA: folds
Uncalled bet ($0.04) returned to LLregs
LLregs collected $0.05 from pot
LLregs: doesn't show hand
*** SUMMARY ***
Total pot $0.05 | Rake $0
Seat 1: Arabescul (button) folded before Flop (didn't bet)
Seat 2: PovilasX (small blind) folded before Flop
Seat 3: StaNiUA (big blind) folded before Flop
Seat 4: zeroelegante folded before Flop (didn't bet)
Seat 5: LLregs collected ($0.05)
Seat 6: mangalisa folded before Flop (didn't bet)

PokerStars Zoom Hand #247959739793:  Hold'em No Limit ($0.01/$0.02) - 2023/12/30 15:09:24 WET [2023/12/30 10:09:24 ET]
Table 'Halley' 6-max Seat #1 is the button
Seat 1: THXforFoldin ($3.16 in chips)
Seat 2: Harold_Seven ($1.06 in chips)
Seat 3: SerberStepan ($2.69 in chips)
Seat 4: MishimaJin1808 ($3.89 in chips)
Seat 5: Jhon Rambo.CL ($2.47 in chips)
Seat 6: LLregs ($2.45 in chips)
Harold_Seven: posts small blind $0.01
SerberStepan: posts big blind $0.02
*** HOLE CARDS ***
Dealt to LLregs [Tc 3c]
MishimaJin1808: raises $0.03 to $0.05
Jhon Rambo.CL: calls $0.05
LLregs: folds
THXforFoldin: folds
Harold_Seven: raises $0.17 to $0.22
SerberStepan: folds
MishimaJin1808: folds
Jhon Rambo.CL: folds
Uncalled bet ($0.17) returned to Harold_Seven
Harold_Seven collected $0.17 from pot
Harold_Seven: doesn't show hand
*** SUMMARY ***
Total pot $0.17 | Rake $0
Seat 1: THXforFoldin (button) folded before Flop (didn't bet)
Seat 2: Harold_Seven (small blind) collected ($0.17)
Seat 3: SerberStepan (big blind) folded before Flop
Seat 4: MishimaJin1808 folded before Flop
Seat 5: Jhon Rambo.CL folded before Flop
Seat 6: LLregs folded before Flop (didn't bet)

PokerStars Zoom Hand #247959745418:  Hold'em No Limit ($0.01/$0.02) - 2023/12/30 15:09:46 WET [2023/12/30 10:09:46 ET]
Table 'Halley' 6-max Seat #1 is the button
Seat 1: manoblack51 ($4.42 in chips)
Seat 2: Art Koneskii ($1.14 in chips)
Seat 3: BsbFox ($3.16 in chips)
Seat 4: LLregs ($2.48 in chips)
Seat 5: psdgr3 ($2.11 in chips)
Seat 6: mackas72 ($2 in chips)
Art Koneskii: posts small blind $0.01
BsbFox: posts big blind $0.02
*** HOLE CARDS ***
Dealt to LLregs [As Ks]
LLregs: raises $0.04 to $0.06
psdgr3: folds
mackas72: folds
manoblack51: folds
Art Koneskii: folds
BsbFox: folds
Uncalled bet ($0.04) returned to LLregs
LLregs collected $0.05 from pot
LLregs: doesn't show hand
*** SUMMARY ***
Total pot $0.05 | Rake $0
Seat 1: manoblack51 (button) folded before Flop (didn't bet)
Seat 2: Art Koneskii (small blind) folded before Flop
Seat 3: BsbFox (big blind) folded before Flop
Seat 4: LLregs collected ($0.05)
Seat 5: psdgr3 folded before Flop (didn't bet)
Seat 6: mackas72 folded before Flop (didn't bet)

PokerStars Zoom Hand #247959748905:  Hold'em No Limit ($0.01/$0.02) - 2023/12/30 15:10:00 WET [2023/12/30 10:10:00 ET]
Table 'Halley' 6-max Seat #1 is the button
Seat 1: Danlaus ($1.52 in chips)
Seat 2: glennmackey ($1.52 in chips)
Seat 3: k7allinn ($4.21 in chips)
Seat 4: LLregs ($2.51 in chips)
Seat 5: Harold_Seven ($1.10 in chips)
Seat 6: chri_zockt ($4.26 in chips)
glennmackey: posts small blind $0.01
k7allinn: posts big blind $0.02
*** HOLE CARDS ***
Dealt to LLregs [Js Ah]
LLregs: raises $0.04 to $0.06
Harold_Seven: folds
chri_zockt: folds
Danlaus: calls $0.06
glennmackey: folds
k7allinn: calls $0.04
*** FLOP *** [9h 7c 3h]
k7allinn: checks
LLregs: checks
Danlaus: bets $0.14
k7allinn: calls $0.14
LLregs: folds
*** TURN *** [9h 7c 3h] [Td]
k7allinn: checks
Danlaus: checks
*** RIVER *** [9h 7c 3h Td] [5s]
k7allinn: bets $0.22
Danlaus: folds
Uncalled bet ($0.22) returned to k7allinn
k7allinn collected $0.45 from pot
k7allinn: doesn't show hand
*** SUMMARY ***
Total pot $0.47 | Rake $0.02
Board [9h 7c 3h Td 5s]
Seat 1: Danlaus (button) folded on the River
Seat 2: glennmackey (small blind) folded before Flop
Seat 3: k7allinn (big blind) collected ($0.45)
Seat 4: LLregs folded on the Flop
Seat 5: Harold_Seven folded before Flop (didn't bet)
Seat 6: chri_zockt folded before Flop (didn't bet)

PokerStars Zoom Hand #247959764143:  Hold'em No Limit ($0.01/$0.02) - 2023/12/30 15:11:00 WET [2023/12/30 10:11:00 ET]
Table 'Halley' 6-max Seat #1 is the button
Seat 1: syuden ($2.58 in chips)
Seat 2: LLregs ($2.43 in chips)
Seat 3: Harold_Seven ($1.85 in chips)
Seat 4: Jhon Rambo.CL ($2.09 in chips)
Seat 5: dmitriy2426 ($1.87 in chips)
Seat 6: piccolino25 ($2.84 in chips)
LLregs: posts small blind $0.01
Harold_Seven: posts big blind $0.02
*** HOLE CARDS ***
Dealt to LLregs [5c 4h]
Jhon Rambo.CL: folds
dmitriy2426: raises $0.04 to $0.06
piccolino25: folds
syuden: folds
LLregs: folds
Harold_Seven: folds
Uncalled bet ($0.04) returned to dmitriy2426
dmitriy2426 collected $0.05 from pot
dmitriy2426: doesn't show hand
*** SUMMARY ***
Total pot $0.05 | Rake $0
Seat 1: syuden (button) folded before Flop (didn't bet)
Seat 2: LLregs (small blind) folded before Flop
Seat 3: Harold_Seven (big blind) folded before Flop
Seat 4: Jhon Rambo.CL folded before Flop (didn't bet)
Seat 5: dmitriy2426 collected ($0.05)
Seat 6: piccolino25 folded before Flop (didn't bet)

PokerStars Zoom Hand #247959765338:  Hold'em No Limit ($0.01/$0.02) - 2023/12/30 15:11:05 WET [2023/12/30 10:11:05 ET]
Table 'Halley' 6-max Seat #1 is the button
Seat 1: LLregs ($2.42 in chips)
Seat 2: DeadKiriyama ($2.95 in chips)
Seat 3: Good2CUBack ($3.03 in chips)
Seat 4: Dexter9922 ($3.14 in chips)
Seat 5: TPB_088_PONG ($2.38 in chips)
Seat 6: manoblack51 ($2 in chips)
DeadKiriyama: posts small blind $0.01
Good2CUBack: posts big blind $0.02
*** HOLE CARDS ***
Dealt to LLregs [Qs 8h]
Dexter9922: folds
TPB_088_PONG: folds
manoblack51: raises $0.03 to $0.05
LLregs: folds
DeadKiriyama: folds
Good2CUBack: folds
Uncalled bet ($0.03) returned to manoblack51
manoblack51 collected $0.05 from pot
manoblack51: doesn't show hand
*** SUMMARY ***
Total pot $0.05 | Rake $0
Seat 1: LLregs (button) folded before Flop (didn't bet)
Seat 2: DeadKiriyama (small blind) folded before Flop
Seat 3: Good2CUBack (big blind) folded before Flop
Seat 4: Dexter9922 folded before Flop (didn't bet)
Seat 5: TPB_088_PONG folded before Flop (didn't bet)
Seat 6: manoblack51 collected ($0.05)

PokerStars Zoom Hand #247959769738:  Hold'em No Limit ($0.01/$0.02) - 2023/12/30 15:11:22 WET [2023/12/30 10:11:22 ET]
Table 'Halley' 6-max Seat #1 is the button
Seat 1: chinex_sba ($2.03 in chips)
Seat 2: nuttymuch ($3.12 in chips)
Seat 3: Angel2480 ($1.86 in chips)
Seat 4: MSerik ($2.55 in chips)
Seat 5: ivciks74lv ($2.01 in chips)
Seat 6: LLregs ($2.42 in chips)
nuttymuch: posts small blind $0.01
Angel2480: posts big blind $0.02
*** HOLE CARDS ***
Dealt to LLregs [2c Jh]
MSerik: folds
ivciks74lv: folds
LLregs: folds
chinex_sba: folds
nuttymuch: raises $0.04 to $0.06
Angel2480: folds
Uncalled bet ($0.04) returned to nuttymuch
nuttymuch collected $0.04 from pot
nuttymuch: doesn't show hand
*** SUMMARY ***
Total pot $0.04 | Rake $0
Seat 1: chinex_sba (button) folded before Flop (didn't bet)
Seat 2: nuttymuch (small blind) collected ($0.04)
Seat 3: Angel2480 (big blind) folded before Flop
Seat 4: MSerik folded before Flop (didn't bet)
Seat 5: ivciks74lv folded before Flop (didn't bet)
Seat 6: LLregs folded before Flop (didn't bet)

PokerStars Zoom Hand #247959759247:  Hold'em No Limit ($0.01/$0.02) - 2023/12/30 15:10:41 WET [2023/12/30 10:10:41 ET]
Table 'Halley' 6-max Seat #1 is the button
Seat 1: TPB_088_PONG ($2.39 in chips)
Seat 2: TrickyJ75 ($2 in chips)
Seat 3: LLregs ($2.45 in chips)
Seat 4: kosatkazostravy ($2 in chips)
Seat 5: InnerRingSting ($2.15 in chips)
Seat 6: carloseri795 ($4.30 in chips)
TrickyJ75: posts small blind $0.01
LLregs: posts big blind $0.02
*** HOLE CARDS ***
Dealt to LLregs [5s 4s]
kosatkazostravy: folds
InnerRingSting: raises $0.04 to $0.06
carloseri795: calls $0.06
TPB_088_PONG: folds
TrickyJ75: raises $0.18 to $0.24
LLregs: folds
InnerRingSting: raises $0.38 to $0.62
carloseri795: folds
TrickyJ75: calls $0.38
*** FLOP *** [4c 4h Td]
TrickyJ75: checks
InnerRingSting: bets $0.30
TrickyJ75: calls $0.30
*** TURN *** [4c 4h Td] [Qh]
TrickyJ75: checks
InnerRingSting: bets $1.23 and is all-in
TrickyJ75: calls $1.08 and is all-in
Uncalled bet ($0.15) returned to InnerRingSting
*** RIVER *** [4c 4h Td Qh] [Ts]
*** SHOW DOWN ***
TrickyJ75: shows [Kd Qd] (two pair, Queens and Tens)
InnerRingSting: shows [Ac Ks] (two pair, Tens and Fours)
TrickyJ75 collected $3.94 from pot
*** SUMMARY ***
Total pot $4.08 | Rake $0.14
Board [4c 4h Td Qh Ts]
Seat 1: TPB_088_PONG (button) folded before Flop (didn't bet)
Seat 2: TrickyJ75 (small blind) showed [Kd Qd] and won ($3.94) with two pair, Queens and Tens
Seat 3: LLregs (big blind) folded before Flop
Seat 4: kosatkazostravy folded before Flop (didn't bet)
Seat 5: InnerRingSting showed [Ac Ks] and lost with two pair, Tens and Fours
Seat 6: carloseri795 folded before Flop

PokerStars Zoom Hand #247959771383:  Hold'em No Limit ($0.01/$0.02) - 2023/12/30 15:11:28 WET [2023/12/30 10:11:28 ET]
Table 'Halley' 6-max Seat #1 is the button
Seat 1: tallist_jm ($6.44 in chips)
Seat 2: StaNiUA ($2 in chips)
Seat 3: syuden ($2.57 in chips)
Seat 4: LLregs ($2.42 in chips)
Seat 5: tsutomu.t ($1.87 in chips)
Seat 6: marioleaoo ($1.32 in chips)
StaNiUA: posts small blind $0.01
syuden: posts big blind $0.02
*** HOLE CARDS ***
Dealt to LLregs [Tc Ah]
LLregs: raises $0.04 to $0.06
tsutomu.t: calls $0.06
marioleaoo: calls $0.06
tallist_jm: calls $0.06
StaNiUA: folds
syuden: calls $0.04
*** FLOP *** [4s 4h Jd]
syuden: checks
LLregs: checks
tsutomu.t: checks
marioleaoo: bets $0.04
tallist_jm is disconnected
tallist_jm is connected
tallist_jm: calls $0.04
syuden: calls $0.04
LLregs: calls $0.04
tsutomu.t: calls $0.04
*** TURN *** [4s 4h Jd] [Jc]
syuden: checks
LLregs: checks
tsutomu.t: checks
marioleaoo: checks
tallist_jm: checks
*** RIVER *** [4s 4h Jd Jc] [9d]
syuden: bets $0.37
LLregs: folds
tsutomu.t: calls $0.37
marioleaoo: folds
tallist_jm: folds
*** SHOW DOWN ***
syuden: shows [Js Qs] (a full house, Jacks full of Fours)
tsutomu.t: mucks hand
syuden collected $1.21 from pot
*** SUMMARY ***
Total pot $1.25 | Rake $0.04
Board [4s 4h Jd Jc 9d]
Seat 1: tallist_jm (button) folded on the River
Seat 2: StaNiUA (small blind) folded before Flop
Seat 3: syuden (big blind) showed [Js Qs] and won ($1.21) with a full house, Jacks full of Fours
Seat 4: LLregs folded on the River
Seat 5: tsutomu.t mucked [Qd Qc]
Seat 6: marioleaoo folded on the River

PokerStars Zoom Hand #247959803088:  Hold'em No Limit ($0.01/$0.02) - 2023/12/30 15:13:32 WET [2023/12/30 10:13:32 ET]
Table 'Halley' 6-max Seat #1 is the button
Seat 1: despot17 ($1.47 in chips)
Seat 2: TPB_088_PONG ($2.22 in chips)
Seat 3: OmegaDeltaPo ($1.15 in chips)
Seat 4: laoban888 ($2.07 in chips)
Seat 5: LLregs ($2.32 in chips)
Seat 6: Poklikash? ($2.55 in chips)
TPB_088_PONG: posts small blind $0.01
OmegaDeltaPo: posts big blind $0.02
*** HOLE CARDS ***
Dealt to LLregs [2s Jc]
laoban888: folds
LLregs: folds
Poklikash?: raises $0.03 to $0.05
despot17: folds
TPB_088_PONG: folds
OmegaDeltaPo: calls $0.03
*** FLOP *** [Ad Qh 4h]
OmegaDeltaPo: checks
Poklikash?: bets $0.08
OmegaDeltaPo: folds
Uncalled bet ($0.08) returned to Poklikash?
Poklikash? collected $0.11 from pot
Poklikash?: doesn't show hand
*** SUMMARY ***
Total pot $0.11 | Rake $0
Board [Ad Qh 4h]
Seat 1: despot17 (button) folded before Flop (didn't bet)
Seat 2: TPB_088_PONG (small blind) folded before Flop
Seat 3: OmegaDeltaPo (big blind) folded on the Flop
Seat 4: laoban888 folded before Flop (didn't bet)
Seat 5: LLregs folded before Flop (didn't bet)
Seat 6: Poklikash? collected ($0.11)

PokerStars Zoom Hand #247959805218:  Hold'em No Limit ($0.01/$0.02) - 2023/12/30 15:13:40 WET [2023/12/30 10:13:40 ET]
Table 'Halley' 6-max Seat #1 is the button
Seat 1: piccolino25 ($2.45 in chips)
Seat 2: DonVasileeee ($2 in chips)
Seat 3: FEROIZ ($2 in chips)
Seat 4: leonardoobsb ($1.66 in chips)
Seat 5: dimitrsko ($0.62 in chips)
Seat 6: LLregs ($2.32 in chips)
DonVasileeee: posts small blind $0.01
FEROIZ: posts big blind $0.02
*** HOLE CARDS ***
Dealt to LLregs [5d Ts]
leonardoobsb: folds
dimitrsko: folds
LLregs: folds
piccolino25: folds
DonVasileeee: folds
Uncalled bet ($0.01) returned to FEROIZ
FEROIZ collected $0.02 from pot
FEROIZ: doesn't show hand
*** SUMMARY ***
Total pot $0.02 | Rake $0
Seat 1: piccolino25 (button) folded before Flop (didn't bet)
Seat 2: DonVasileeee (small blind) folded before Flop
Seat 3: FEROIZ (big blind) collected ($0.02)
Seat 4: leonardoobsb folded before Flop (didn't bet)
Seat 5: dimitrsko folded before Flop (didn't bet)
Seat 6: LLregs folded before Flop (didn't bet)

PokerStars Zoom Hand #247959807024:  Hold'em No Limit ($0.01/$0.02) - 2023/12/30 15:13:47 WET [2023/12/30 10:13:47 ET]
Table 'Halley' 6-max Seat #1 is the button
Seat 1: JORDYLEON ($3.96 in chips)
Seat 2: laoban888 ($2.01 in chips)
Seat 3: LLregs ($2.32 in chips)
Seat 4: carloseri795 ($4.45 in chips)
Seat 5: Mamirox ($2.25 in chips)
Seat 6: ungiwar ($0.38 in chips)
laoban888: posts small blind $0.01
LLregs: posts big blind $0.02
*** HOLE CARDS ***
Dealt to LLregs [Kc 3d]
carloseri795: folds
Mamirox: folds
ungiwar: folds
JORDYLEON: folds
laoban888: raises $0.04 to $0.06
LLregs: calls $0.04
*** FLOP *** [7c Jd 4c]
laoban888: checks
LLregs: bets $0.06
laoban888: folds
Uncalled bet ($0.06) returned to LLregs
LLregs collected $0.12 from pot
LLregs: doesn't show hand
*** SUMMARY ***
Total pot $0.12 | Rake $0
Board [7c Jd 4c]
Seat 1: JORDYLEON (button) folded before Flop (didn't bet)
Seat 2: laoban888 (small blind) folded on the Flop
Seat 3: LLregs (big blind) collected ($0.12)
Seat 4: carloseri795 folded before Flop (didn't bet)
Seat 5: Mamirox folded before Flop (didn't bet)
Seat 6: ungiwar folded before Flop (didn't bet)

PokerStars Zoom Hand #247959804177:  Hold'em No Limit ($0.01/$0.02) - 2023/12/30 15:13:36 WET [2023/12/30 10:13:36 ET]
Table 'Halley' 6-max Seat #1 is the button
Seat 1: LLregs ($2.32 in chips)
Seat 2: asbjmc5 ($1.98 in chips)
Seat 3: avilaC73 ($2.94 in chips)
Seat 4: Jhon Rambo.CL ($2.75 in chips)
Seat 5: BiG whaIe ($2.20 in chips)
Seat 6: THXforFoldin ($4.02 in chips)
asbjmc5: posts small blind $0.01
avilaC73: posts big blind $0.02
*** HOLE CARDS ***
Dealt to LLregs [Ac 3h]
Jhon Rambo.CL: folds
BiG whaIe: folds
THXforFoldin: folds
LLregs: folds
asbjmc5: raises $0.04 to $0.06
avilaC73: calls $0.04
*** FLOP *** [Qd 2s 6d]
asbjmc5: checks
avilaC73: checks
*** TURN *** [Qd 2s 6d] [9h]
asbjmc5: bets $0.06
avilaC73: folds
Uncalled bet ($0.06) returned to asbjmc5
asbjmc5 collected $0.12 from pot
asbjmc5: doesn't show hand
*** SUMMARY ***
Total pot $0.12 | Rake $0
Board [Qd 2s 6d 9h]
Seat 1: LLregs (button) folded before Flop (didn't bet)
Seat 2: asbjmc5 (small blind) collected ($0.12)
Seat 3: avilaC73 (big blind) folded on the Turn
Seat 4: Jhon Rambo.CL folded before Flop (didn't bet)
Seat 5: BiG whaIe folded before Flop (didn't bet)
Seat 6: THXforFoldin folded before Flop (didn't bet)

PokerStars Zoom Hand #247959816385:  Hold'em No Limit ($0.01/$0.02) - 2023/12/30 15:14:23 WET [2023/12/30 10:14:23 ET]
Table 'Halley' 6-max Seat #1 is the button
Seat 1: Fukudasai ($2.01 in chips)
Seat 2: LLregs ($2.38 in chips)
Seat 3: 888lifeIS ($2.13 in chips)
Seat 4: ungiwar ($0.39 in chips)
Seat 5: mixi08 ($9.02 in chips)
Seat 6: kosatkazostravy ($2.22 in chips)
LLregs: posts small blind $0.01
888lifeIS: posts big blind $0.02
*** HOLE CARDS ***
Dealt to LLregs [Td Kh]
ungiwar: folds
mixi08: folds
kosatkazostravy: folds
Fukudasai: folds
LLregs: raises $0.04 to $0.06
888lifeIS: calls $0.04
*** FLOP *** [3d 5s Qh]
LLregs: checks
888lifeIS: checks
*** TURN *** [3d 5s Qh] [5h]
LLregs: bets $0.04
888lifeIS: folds
Uncalled bet ($0.04) returned to LLregs
LLregs collected $0.12 from pot
LLregs: doesn't show hand
*** SUMMARY ***
Total pot $0.12 | Rake $0
Board [3d 5s Qh 5h]
Seat 1: Fukudasai (button) folded before Flop (didn't bet)
Seat 2: LLregs (small blind) collected ($0.12)
Seat 3: 888lifeIS (big blind) folded on the Turn
Seat 4: ungiwar folded before Flop (didn't bet)
Seat 5: mixi08 folded before Flop (didn't bet)
Seat 6: kosatkazostravy folded before Flop (didn't bet)

PokerStars Zoom Hand #247959824915:  Hold'em No Limit ($0.01/$0.02) - 2023/12/30 15:14:56 WET [2023/12/30 10:14:56 ET]
Table 'Halley' 6-max Seat #1 is the button
Seat 1: THXforFoldin ($2.18 in chips)
Seat 2: VIDOPRO23 ($2.83 in chips)
Seat 3: iliyan66 ($3.32 in chips)
Seat 4: LLregs ($2.44 in chips)
Seat 5: AllstarCon ($2 in chips)
Seat 6: aricast19 ($2.48 in chips)
VIDOPRO23: posts small blind $0.01
iliyan66: posts big blind $0.02
*** HOLE CARDS ***
Dealt to LLregs [9d 3c]
LLregs: folds
AllstarCon: folds
aricast19: raises $0.03 to $0.05
THXforFoldin: folds
VIDOPRO23: folds
iliyan66: folds
Uncalled bet ($0.03) returned to aricast19
aricast19 collected $0.05 from pot
aricast19: doesn't show hand
*** SUMMARY ***
Total pot $0.05 | Rake $0
Seat 1: THXforFoldin (button) folded before Flop (didn't bet)
Seat 2: VIDOPRO23 (small blind) folded before Flop
Seat 3: iliyan66 (big blind) folded before Flop
Seat 4: LLregs folded before Flop (didn't bet)
Seat 5: AllstarCon folded before Flop (didn't bet)
Seat 6: aricast19 collected ($0.05)

PokerStars Zoom Hand #247959825921:  Hold'em No Limit ($0.01/$0.02) - 2023/12/30 15:15:00 WET [2023/12/30 10:15:00 ET]
Table 'Halley' 6-max Seat #1 is the button
Seat 1: iliyan66 ($11.59 in chips)
Seat 2: avilaC73 ($2.66 in chips)
Seat 3: LLregs ($2.44 in chips)
Seat 4: piccolino25 ($2.42 in chips)
Seat 5: MSerik ($2.31 in chips)
Seat 6: dmitryi546 ($0.74 in chips)
avilaC73: posts small blind $0.01
LLregs: posts big blind $0.02
*** HOLE CARDS ***
Dealt to LLregs [Ac 8s]
piccolino25: folds
MSerik: folds
dmitryi546: folds
iliyan66: folds
avilaC73: folds
Uncalled bet ($0.01) returned to LLregs
LLregs collected $0.02 from pot
LLregs: doesn't show hand
*** SUMMARY ***
Total pot $0.02 | Rake $0
Seat 1: iliyan66 (button) folded before Flop (didn't bet)
Seat 2: avilaC73 (small blind) folded before Flop
Seat 3: LLregs (big blind) collected ($0.02)
Seat 4: piccolino25 folded before Flop (didn't bet)
Seat 5: MSerik folded before Flop (didn't bet)
Seat 6: dmitryi546 folded before Flop (didn't bet)

PokerStars Zoom Hand #247959823880:  Hold'em No Limit ($0.01/$0.02) - 2023/12/30 15:14:52 WET [2023/12/30 10:14:52 ET]
Table 'Halley' 6-max Seat #1 is the button
Seat 1: Arabescul ($2 in chips)
Seat 2: EL AS BS AS ($2.41 in chips)
Seat 3: Mikeloko182 ($2.09 in chips)
Seat 4: franpalermo14 ($3.65 in chips)
Seat 5: LLregs ($2.44 in chips)
Seat 6: Prince Mantis ($2 in chips)
EL AS BS AS: posts small blind $0.01
Mikeloko182: posts big blind $0.02
*** HOLE CARDS ***
Dealt to LLregs [Kc 3c]
franpalermo14: raises $0.04 to $0.06
LLregs: folds
Prince Mantis: folds
Arabescul: folds
EL AS BS AS: folds
Mikeloko182: raises $0.18 to $0.24
franpalermo14: folds
Uncalled bet ($0.18) returned to Mikeloko182
Mikeloko182 collected $0.13 from pot
Mikeloko182: doesn't show hand
*** SUMMARY ***
Total pot $0.13 | Rake $0
Seat 1: Arabescul (button) folded before Flop (didn't bet)
Seat 2: EL AS BS AS (small blind) folded before Flop
Seat 3: Mikeloko182 (big blind) collected ($0.13)
Seat 4: franpalermo14 folded before Flop
Seat 5: LLregs folded before Flop (didn't bet)
Seat 6: Prince Mantis folded before Flop (didn't bet)

PokerStars Zoom Hand #247959822866:  Hold'em No Limit ($0.01/$0.02) - 2023/12/30 15:14:48 WET [2023/12/30 10:14:48 ET]
Table 'Halley' 6-max Seat #1 is the button
Seat 1: franpalermo14 ($4.15 in chips)
Seat 2: StaNiUA ($2.14 in chips)
Seat 3: AndGPR ($2.74 in chips)
Seat 4: LLregs ($2.44 in chips)
Seat 5: Loucomeloo ($2.23 in chips)
Seat 6: Mantaray68 ($1.72 in chips)
StaNiUA: posts small blind $0.01
AndGPR: posts big blind $0.02
*** HOLE CARDS ***
Dealt to LLregs [6c 7h]
LLregs: folds
Loucomeloo: folds
Mantaray68: folds
franpalermo14: folds
StaNiUA: raises $0.04 to $0.06
AndGPR: calls $0.04
*** FLOP *** [Td 2c Ac]
StaNiUA: bets $0.04
AndGPR: calls $0.04
*** TURN *** [Td 2c Ac] [Js]
StaNiUA: checks
AndGPR: bets $0.10
StaNiUA: calls $0.10
*** RIVER *** [Td 2c Ac Js] [Kd]
StaNiUA: checks
AndGPR: checks
*** SHOW DOWN ***
StaNiUA: shows [Qh Th] (a straight, Ten to Ace)
AndGPR: mucks hand
StaNiUA collected $0.39 from pot
*** SUMMARY ***
Total pot $0.40 | Rake $0.01
Board [Td 2c Ac Js Kd]
Seat 1: franpalermo14 (button) folded before Flop (didn't bet)
Seat 2: StaNiUA (small blind) showed [Qh Th] and won ($0.39) with a straight, Ten to Ace
Seat 3: AndGPR (big blind) mucked [9s 8d]
Seat 4: LLregs folded before Flop (didn't bet)
Seat 5: Loucomeloo folded before Flop (didn't bet)
Seat 6: Mantaray68 folded before Flop (didn't bet)

PokerStars Zoom Hand #247959829683:  Hold'em No Limit ($0.01/$0.02) - 2023/12/30 15:15:14 WET [2023/12/30 10:15:14 ET]
Table 'Halley' 6-max Seat #1 is the button
Seat 1: PR3SUR3 ($4.21 in chips)
Seat 2: LLregs ($2.45 in chips)
Seat 3: Fukudasai ($2.24 in chips)
Seat 4: dave40k ($1.47 in chips)
Seat 5: BlackYisus23 ($6.16 in chips)
Seat 6: psdgr3 ($2.33 in chips)
LLregs: posts small blind $0.01
Fukudasai: posts big blind $0.02
*** HOLE CARDS ***
Dealt to LLregs [Ad 9h]
dave40k: folds
BlackYisus23: raises $0.03 to $0.05
psdgr3: folds
PR3SUR3: folds
LLregs: raises $0.11 to $0.16
Fukudasai: folds
BlackYisus23: folds
Uncalled bet ($0.11) returned to LLregs
LLregs collected $0.12 from pot
LLregs: doesn't show hand
*** SUMMARY ***
Total pot $0.12 | Rake $0
Seat 1: PR3SUR3 (button) folded before Flop (didn't bet)
Seat 2: LLregs (small blind) collected ($0.12)
Seat 3: Fukudasai (big blind) folded before Flop
Seat 4: dave40k folded before Flop (didn't bet)
Seat 5: BlackYisus23 folded before Flop
Seat 6: psdgr3 folded before Flop (didn't bet)

PokerStars Zoom Hand #247959840591:  Hold'em No Limit ($0.01/$0.02) - 2023/12/30 15:15:55 WET [2023/12/30 10:15:55 ET]
Table 'Halley' 6-max Seat #1 is the button
Seat 1: LLregs ($2.52 in chips)
Seat 2: MystryMchine ($1.75 in chips)
Seat 3: Arabescul ($2.03 in chips)
Seat 4: maressen ($2.27 in chips)
Seat 5: PovilasX ($2.03 in chips)
Seat 6: quiet64 ($0.58 in chips)
MystryMchine: posts small blind $0.01
Arabescul: posts big blind $0.02
*** HOLE CARDS ***
Dealt to LLregs [Tc Qc]
maressen: raises $0.02 to $0.04
PovilasX: folds
quiet64: folds
LLregs: calls $0.04
MystryMchine: folds
Arabescul: folds
*** FLOP *** [8c Ah 6h]
maressen: checks
LLregs: checks
*** TURN *** [8c Ah 6h] [5c]
maressen: checks
LLregs: bets $0.05
maressen: folds
Uncalled bet ($0.05) returned to LLregs
LLregs collected $0.11 from pot
LLregs: doesn't show hand
*** SUMMARY ***
Total pot $0.11 | Rake $0
Board [8c Ah 6h 5c]
Seat 1: LLregs (button) collected ($0.11)
Seat 2: MystryMchine (small blind) folded before Flop
Seat 3: Arabescul (big blind) folded before Flop
Seat 4: maressen folded on the Turn
Seat 5: PovilasX folded before Flop (didn't bet)
Seat 6: quiet64 folded before Flop (didn't bet)

PokerStars Zoom Hand #247959851624:  Hold'em No Limit ($0.01/$0.02) - 2023/12/30 15:16:36 WET [2023/12/30 10:16:36 ET]
Table 'Halley' 6-max Seat #1 is the button
Seat 1: LLregs ($2.59 in chips)
Seat 2: DeadKiriyama ($2.07 in chips)
Seat 3: manoblack51 ($2.11 in chips)
Seat 4: Vimpex ($1.84 in chips)
Seat 5: iliyan66 ($11.71 in chips)
Seat 6: gnom1977 ($2.29 in chips)
DeadKiriyama: posts small blind $0.01
manoblack51: posts big blind $0.02
*** HOLE CARDS ***
Dealt to LLregs [6h Th]
Vimpex: folds
iliyan66: folds
gnom1977: folds
LLregs: folds
DeadKiriyama: raises $0.04 to $0.06
manoblack51: folds
Uncalled bet ($0.04) returned to DeadKiriyama
DeadKiriyama collected $0.04 from pot
DeadKiriyama: doesn't show hand
*** SUMMARY ***
Total pot $0.04 | Rake $0
Seat 1: LLregs (button) folded before Flop (didn't bet)
Seat 2: DeadKiriyama (small blind) collected ($0.04)
Seat 3: manoblack51 (big blind) folded before Flop
Seat 4: Vimpex folded before Flop (didn't bet)
Seat 5: iliyan66 folded before Flop (didn't bet)
Seat 6: gnom1977 folded before Flop (didn't bet)

PokerStars Zoom Hand #247959852470:  Hold'em No Limit ($0.01/$0.02) - 2023/12/30 15:16:39 WET [2023/12/30 10:16:39 ET]
Table 'Halley' 6-max Seat #1 is the button
Seat 1: podrevnik2 ($4.10 in chips)
Seat 2: Mikeloko182 ($2 in chips)
Seat 3: boyacky66 ($7.36 in chips)
Seat 4: mangalisa ($2.37 in chips)
Seat 5: LLregs ($2.59 in chips)
Seat 6: OskyP ($2 in chips)
Mikeloko182: posts small blind $0.01
boyacky66: posts big blind $0.02
*** HOLE CARDS ***
Dealt to LLregs [Ad 6s]
mangalisa: folds
LLregs: folds
OskyP: folds
podrevnik2: raises $0.04 to $0.06
Mikeloko182: folds
boyacky66: folds
Uncalled bet ($0.04) returned to podrevnik2
podrevnik2 collected $0.05 from pot
podrevnik2: doesn't show hand
*** SUMMARY ***
Total pot $0.05 | Rake $0
Seat 1: podrevnik2 (button) collected ($0.05)
Seat 2: Mikeloko182 (small blind) folded before Flop
Seat 3: boyacky66 (big blind) folded before Flop
Seat 4: mangalisa folded before Flop (didn't bet)
Seat 5: LLregs folded before Flop (didn't bet)
Seat 6: OskyP folded before Flop (didn't bet)

PokerStars Zoom Hand #247959849191:  Hold'em No Limit ($0.01/$0.02) - 2023/12/30 15:16:28 WET [2023/12/30 10:16:28 ET]
Table 'Halley' 6-max Seat #1 is the button
Seat 1: JerkBagg ($0.29 in chips)
Seat 2: DKD34 ($2.01 in chips)
Seat 3: kygo19 ($10.65 in chips)
Seat 4: DonVasileeee ($2.27 in chips)
Seat 5: Fukudasai ($2.03 in chips)
Seat 6: LLregs ($2.59 in chips)
DKD34: posts small blind $0.01
kygo19: posts big blind $0.02
*** HOLE CARDS ***
Dealt to LLregs [Kd 7h]
DonVasileeee: folds
Fukudasai: folds
LLregs: folds
JerkBagg: calls $0.02
DKD34: folds
kygo19: raises $0.12 to $0.14
JerkBagg: folds
Uncalled bet ($0.12) returned to kygo19
kygo19 collected $0.05 from pot
kygo19: doesn't show hand
*** SUMMARY ***
Total pot $0.05 | Rake $0
Seat 1: JerkBagg (button) folded before Flop
Seat 2: DKD34 (small blind) folded before Flop
Seat 3: kygo19 (big blind) collected ($0.05)
Seat 4: DonVasileeee folded before Flop (didn't bet)
Seat 5: Fukudasai folded before Flop (didn't bet)
Seat 6: LLregs folded before Flop (didn't bet)

PokerStars Zoom Hand #247959854272:  Hold'em No Limit ($0.01/$0.02) - 2023/12/30 15:16:46 WET [2023/12/30 10:16:46 ET]
Table 'Halley' 6-max Seat #1 is the button
Seat 1: Nisquu1 ($2 in chips)
Seat 2: JucyBits ($2.45 in chips)
Seat 3: LLregs ($2.59 in chips)
Seat 4: Mikeloko182 ($2.13 in chips)
Seat 5: 39REDMAN ($1.82 in chips)
Seat 6: Mumbeer1978 ($1.81 in chips)
JucyBits: posts small blind $0.01
LLregs: posts big blind $0.02
*** HOLE CARDS ***
Dealt to LLregs [8c 9s]
Mikeloko182: folds
39REDMAN: folds
Mumbeer1978: folds
Nisquu1: raises $0.03 to $0.05
JucyBits: raises $0.17 to $0.22
LLregs: folds
Nisquu1: folds
Uncalled bet ($0.17) returned to JucyBits
JucyBits collected $0.12 from pot
JucyBits: doesn't show hand
*** SUMMARY ***
Total pot $0.12 | Rake $0
Seat 1: Nisquu1 (button) folded before Flop
Seat 2: JucyBits (small blind) collected ($0.12)
Seat 3: LLregs (big blind) folded before Flop
Seat 4: Mikeloko182 folded before Flop (didn't bet)
Seat 5: 39REDMAN folded before Flop (didn't bet)
Seat 6: Mumbeer1978 folded before Flop (didn't bet)

PokerStars Zoom Hand #247959850548:  Hold'em No Limit ($0.01/$0.02) - 2023/12/30 15:16:32 WET [2023/12/30 10:16:32 ET]
Table 'Halley' 6-max Seat #1 is the button
Seat 1: Bigtallpaul85 ($2 in chips)
Seat 2: zoro782 ($9.39 in chips)
Seat 3: EL AS BS AS ($2.24 in chips)
Seat 4: LLregs ($2.59 in chips)
Seat 5: PR3SUR3 ($4.08 in chips)
Seat 6: cala23 ($1.13 in chips)
zoro782: posts small blind $0.01
EL AS BS AS: posts big blind $0.02
*** HOLE CARDS ***
Dealt to LLregs [7s Ks]
LLregs: folds
PR3SUR3: folds
cala23: raises $0.02 to $0.04
Bigtallpaul85: folds
zoro782: calls $0.03
EL AS BS AS: folds
*** FLOP *** [3d 7d 5c]
zoro782: checks
cala23: bets $0.05
zoro782: calls $0.05
*** TURN *** [3d 7d 5c] [4s]
zoro782: checks
cala23: checks
*** RIVER *** [3d 7d 5c 4s] [6d]
zoro782: checks
cala23: checks
*** SHOW DOWN ***
zoro782: shows [8c 8h] (a straight, Four to Eight)
cala23: mucks hand
zoro782 collected $0.19 from pot
*** SUMMARY ***
Total pot $0.20 | Rake $0.01
Board [3d 7d 5c 4s 6d]
Seat 1: Bigtallpaul85 (button) folded before Flop (didn't bet)
Seat 2: zoro782 (small blind) showed [8c 8h] and won ($0.19) with a straight, Four to Eight
Seat 3: EL AS BS AS (big blind) folded before Flop
Seat 4: LLregs folded before Flop (didn't bet)
Seat 5: PR3SUR3 folded before Flop (didn't bet)
Seat 6: cala23 mucked [Qc 9c]

PokerStars Zoom Hand #247959860254:  Hold'em No Limit ($0.01/$0.02) - 2023/12/30 15:17:08 WET [2023/12/30 10:17:08 ET]
Table 'Halley' 6-max Seat #1 is the button
Seat 1: mixi08 ($8.81 in chips)
Seat 2: LLregs ($2.57 in chips)
Seat 3: Mikeloko182 ($2.09 in chips)
Seat 4: Casinoca$h ($5.08 in chips)
Seat 5: 888lifeIS ($2.03 in chips)
Seat 6: edhillm ($2 in chips)
LLregs: posts small blind $0.01
Mikeloko182: posts big blind $0.02
*** HOLE CARDS ***
Dealt to LLregs [Tc 5h]
Casinoca$h: folds
888lifeIS: folds
edhillm: folds
mixi08: raises $0.03 to $0.05
LLregs: folds
Mikeloko182: folds
Uncalled bet ($0.03) returned to mixi08
mixi08 collected $0.05 from pot
mixi08: doesn't show hand
*** SUMMARY ***
Total pot $0.05 | Rake $0
Seat 1: mixi08 (button) collected ($0.05)
Seat 2: LLregs (small blind) folded before Flop
Seat 3: Mikeloko182 (big blind) folded before Flop
Seat 4: Casinoca$h folded before Flop (didn't bet)
Seat 5: 888lifeIS folded before Flop (didn't bet)
Seat 6: edhillm folded before Flop (didn't bet)

PokerStars Zoom Hand #247959861341:  Hold'em No Limit ($0.01/$0.02) - 2023/12/30 15:17:12 WET [2023/12/30 10:17:12 ET]
Table 'Halley' 6-max Seat #1 is the button
Seat 1: Alcapy ($8.44 in chips)
Seat 2: ZiggyBoy90 ($2 in chips)
Seat 3: Mamirox ($2.65 in chips)
Seat 4: Shmatrixs ($4.30 in chips)
Seat 5: BiG whaIe ($2.22 in chips)
Seat 6: LLregs ($2.56 in chips)
ZiggyBoy90: posts small blind $0.01
Mamirox: posts big blind $0.02
*** HOLE CARDS ***
Dealt to LLregs [7d 7h]
Shmatrixs: folds
BiG whaIe: folds
LLregs: raises $0.04 to $0.06
Alcapy: folds
ZiggyBoy90: folds
Mamirox: calls $0.04
*** FLOP *** [6c 6s 8s]
Mamirox: checks
LLregs: bets $0.06
Mamirox: folds
Uncalled bet ($0.06) returned to LLregs
LLregs collected $0.13 from pot
LLregs: doesn't show hand
*** SUMMARY ***
Total pot $0.13 | Rake $0
Board [6c 6s 8s]
Seat 1: Alcapy (button) folded before Flop (didn't bet)
Seat 2: ZiggyBoy90 (small blind) folded before Flop
Seat 3: Mamirox (big blind) folded on the Flop
Seat 4: Shmatrixs folded before Flop (didn't bet)
Seat 5: BiG whaIe folded before Flop (didn't bet)
Seat 6: LLregs collected ($0.13)

PokerStars Zoom Hand #247959869153:  Hold'em No Limit ($0.01/$0.02) - 2023/12/30 15:17:41 WET [2023/12/30 10:17:41 ET]
Table 'Halley' 6-max Seat #1 is the button
Seat 1: kosatkazostravy ($2 in chips)
Seat 2: StaNiUA ($2.53 in chips)
Seat 3: nestor-ruso ($2.32 in chips)
Seat 4: Arabescul ($2 in chips)
Seat 5: LLregs ($2.63 in chips)
Seat 6: Harold_Seven ($2.32 in chips)
StaNiUA: posts small blind $0.01
nestor-ruso: posts big blind $0.02
*** HOLE CARDS ***
Dealt to LLregs [8c 9c]
Arabescul: folds
LLregs: raises $0.04 to $0.06
Harold_Seven: folds
kosatkazostravy: folds
StaNiUA: folds
nestor-ruso: folds
Uncalled bet ($0.04) returned to LLregs
LLregs collected $0.05 from pot
LLregs: doesn't show hand
*** SUMMARY ***
Total pot $0.05 | Rake $0
Seat 1: kosatkazostravy (button) folded before Flop (didn't bet)
Seat 2: StaNiUA (small blind) folded before Flop
Seat 3: nestor-ruso (big blind) folded before Flop
Seat 4: Arabescul folded before Flop (didn't bet)
Seat 5: LLregs collected ($0.05)
Seat 6: Harold_Seven folded before Flop (didn't bet)

PokerStars Zoom Hand #247959875992:  Hold'em No Limit ($0.01/$0.02) - 2023/12/30 15:18:06 WET [2023/12/30 10:18:06 ET]
Table 'Halley' 6-max Seat #1 is the button
Seat 1: LLregs ($2.66 in chips)
Seat 2: mangalisa ($4.82 in chips)
Seat 3: TPB_088_PONG ($2.16 in chips)
Seat 4: StaNiUA ($2.50 in chips)
Seat 5: Karteireiter ($2.17 in chips)
Seat 6: ungiwar ($0.90 in chips)
mangalisa: posts small blind $0.01
TPB_088_PONG: posts big blind $0.02
*** HOLE CARDS ***
Dealt to LLregs [5s 9d]
StaNiUA: folds
Karteireiter: raises $0.04 to $0.06
ungiwar: folds
LLregs: folds
mangalisa: calls $0.05
TPB_088_PONG: folds
*** FLOP *** [As Td Qc]
mangalisa: checks
Karteireiter: bets $0.07
mangalisa: folds
Uncalled bet ($0.07) returned to Karteireiter
Karteireiter collected $0.14 from pot
Karteireiter: doesn't show hand
*** SUMMARY ***
Total pot $0.14 | Rake $0
Board [As Td Qc]
Seat 1: LLregs (button) folded before Flop (didn't bet)
Seat 2: mangalisa (small blind) folded on the Flop
Seat 3: TPB_088_PONG (big blind) folded before Flop
Seat 4: StaNiUA folded before Flop (didn't bet)
Seat 5: Karteireiter collected ($0.14)
Seat 6: ungiwar folded before Flop (didn't bet)

PokerStars Zoom Hand #247959885797:  Hold'em No Limit ($0.01/$0.02) - 2023/12/30 15:18:43 WET [2023/12/30 10:18:43 ET]
Table 'Halley' 6-max Seat #1 is the button
Seat 1: TPB_088_PONG ($2.13 in chips)
Seat 2: LLregs ($2.64 in chips)
Seat 3: therookie1008 ($3.64 in chips)
Seat 4: Shmatrixs ($1.81 in chips)
Seat 5: nuttymuch ($2 in chips)
Seat 6: Jhon Rambo.CL ($2.46 in chips)
LLregs: posts small blind $0.01
therookie1008: posts big blind $0.02
*** HOLE CARDS ***
Dealt to LLregs [8h 3d]
Shmatrixs: folds
nuttymuch: folds
Jhon Rambo.CL: folds
TPB_088_PONG: raises $0.03 to $0.05
LLregs: folds
therookie1008: folds
Uncalled bet ($0.03) returned to TPB_088_PONG
TPB_088_PONG collected $0.05 from pot
TPB_088_PONG: doesn't show hand
*** SUMMARY ***
Total pot $0.05 | Rake $0
Seat 1: TPB_088_PONG (button) collected ($0.05)
Seat 2: LLregs (small blind) folded before Flop
Seat 3: therookie1008 (big blind) folded before Flop
Seat 4: Shmatrixs folded before Flop (didn't bet)
Seat 5: nuttymuch folded before Flop (didn't bet)
Seat 6: Jhon Rambo.CL folded before Flop (didn't bet)

PokerStars Zoom Hand #247959886863:  Hold'em No Limit ($0.01/$0.02) - 2023/12/30 15:18:47 WET [2023/12/30 10:18:47 ET]
Table 'Halley' 6-max Seat #1 is the button
Seat 1: cala23 ($1.15 in chips)
Seat 2: shermheadryder ($2.16 in chips)
Seat 3: CKStz ($0.96 in chips)
Seat 4: 888lifeIS ($2.02 in chips)
Seat 5: VIDOPRO23 ($2.85 in chips)
Seat 6: LLregs ($2.63 in chips)
shermheadryder: posts small blind $0.01
CKStz: posts big blind $0.02
*** HOLE CARDS ***
Dealt to LLregs [Th Qc]
888lifeIS: folds
VIDOPRO23: folds
LLregs: raises $0.04 to $0.06
cala23: folds
shermheadryder: folds
CKStz: calls $0.04
*** FLOP *** [9h Qs 7d]
CKStz: checks
LLregs: bets $0.04
CKStz: folds
Uncalled bet ($0.04) returned to LLregs
LLregs collected $0.13 from pot
LLregs: doesn't show hand
*** SUMMARY ***
Total pot $0.13 | Rake $0
Board [9h Qs 7d]
Seat 1: cala23 (button) folded before Flop (didn't bet)
Seat 2: shermheadryder (small blind) folded before Flop
Seat 3: CKStz (big blind) folded on the Flop
Seat 4: 888lifeIS folded before Flop (didn't bet)
Seat 5: VIDOPRO23 folded before Flop (didn't bet)
Seat 6: LLregs collected ($0.13)

PokerStars Zoom Hand #247959891850:  Hold'em No Limit ($0.01/$0.02) - 2023/12/30 15:19:05 WET [2023/12/30 10:19:05 ET]
Table 'Halley' 6-max Seat #1 is the button
Seat 1: PR3SUR3 ($3.96 in chips)
Seat 2: mmmggg001 ($1.94 in chips)
Seat 3: Na shpilyu ($2 in chips)
Seat 4: LLregs ($2.70 in chips)
Seat 5: Käpt.Ahab ($4.55 in chips)
Seat 6: ShearersRBoot ($1.78 in chips)
mmmggg001: posts small blind $0.01
Na shpilyu: posts big blind $0.02
*** HOLE CARDS ***
Dealt to LLregs [3s 5s]
LLregs: folds
Käpt.Ahab: folds
ShearersRBoot is disconnected
ShearersRBoot has timed out while disconnected
ShearersRBoot: folds
PR3SUR3: folds
mmmggg001: folds
Uncalled bet ($0.01) returned to Na shpilyu
Na shpilyu collected $0.02 from pot
Na shpilyu: doesn't show hand
*** SUMMARY ***
Total pot $0.02 | Rake $0
Seat 1: PR3SUR3 (button) folded before Flop (didn't bet)
Seat 2: mmmggg001 (small blind) folded before Flop
Seat 3: Na shpilyu (big blind) collected ($0.02)
Seat 4: LLregs folded before Flop (didn't bet)
Seat 5: Käpt.Ahab folded before Flop (didn't bet)
Seat 6: ShearersRBoot folded before Flop (didn't bet)

PokerStars Zoom Hand #247959894148:  Hold'em No Limit ($0.01/$0.02) - 2023/12/30 15:19:14 WET [2023/12/30 10:19:14 ET]
Table 'Halley' 6-max Seat #1 is the button
Seat 1: Fukudasai ($2.39 in chips)
Seat 2: nestor-ruso ($2 in chips)
Seat 3: ImpEdGard ($2.10 in chips)
Seat 4: LLregs ($2.70 in chips)
Seat 5: btbass ($2.03 in chips)
Seat 6: hondaandy ($1.19 in chips)
nestor-ruso: posts small blind $0.01
ImpEdGard: posts big blind $0.02
*** HOLE CARDS ***
Dealt to LLregs [As Qs]
LLregs: raises $0.04 to $0.06
btbass: folds
hondaandy: folds
Fukudasai: folds
nestor-ruso: folds
ImpEdGard: folds
Uncalled bet ($0.04) returned to LLregs
LLregs collected $0.05 from pot
LLregs: doesn't show hand
*** SUMMARY ***
Total pot $0.05 | Rake $0
Seat 1: Fukudasai (button) folded before Flop (didn't bet)
Seat 2: nestor-ruso (small blind) folded before Flop
Seat 3: ImpEdGard (big blind) folded before Flop
Seat 4: LLregs collected ($0.05)
Seat 5: btbass folded before Flop (didn't bet)
Seat 6: hondaandy folded before Flop (didn't bet)

PokerStars Zoom Hand #247959884689:  Hold'em No Limit ($0.01/$0.02) - 2023/12/30 15:18:39 WET [2023/12/30 10:18:39 ET]
Table 'Halley' 6-max Seat #1 is the button
Seat 1: iliyan66 ($4.50 in chips)
Seat 2: laoban888 ($2.87 in chips)
Seat 3: karintou8888 ($2 in chips)
Seat 4: September 022 ($2.07 in chips)
Seat 5: LLregs ($2.64 in chips)
Seat 6: JucyBits ($5.17 in chips)
laoban888: posts small blind $0.01
karintou8888: posts big blind $0.02
*** HOLE CARDS ***
Dealt to LLregs [7c 4c]
September 022: folds
LLregs: folds
JucyBits: folds
iliyan66: folds
laoban888: raises $0.04 to $0.06
karintou8888: calls $0.04
*** FLOP *** [Qs Ah Tc]
laoban888: bets $0.06
karintou8888: calls $0.06
*** TURN *** [Qs Ah Tc] [5d]
laoban888: checks
karintou8888: checks
*** RIVER *** [Qs Ah Tc 5d] [Kh]
laoban888: checks
karintou8888: checks
*** SHOW DOWN ***
laoban888: shows [6h 6c] (a pair of Sixes)
karintou8888: shows [Qc 9h] (a pair of Queens)
karintou8888 collected $0.23 from pot
*** SUMMARY ***
Total pot $0.24 | Rake $0.01
Board [Qs Ah Tc 5d Kh]
Seat 1: iliyan66 (button) folded before Flop (didn't bet)
Seat 2: laoban888 (small blind) showed [6h 6c] and lost with a pair of Sixes
Seat 3: karintou8888 (big blind) showed [Qc 9h] and won ($0.23) with a pair of Queens
Seat 4: September 022 folded before Flop (didn't bet)
Seat 5: LLregs folded before Flop (didn't bet)
Seat 6: JucyBits folded before Flop (didn't bet)

PokerStars Zoom Hand #247959897109:  Hold'em No Limit ($0.01/$0.02) - 2023/12/30 15:19:25 WET [2023/12/30 10:19:25 ET]
Table 'Halley' 6-max Seat #1 is the button
Seat 1: Mikeloko182 ($2.31 in chips)
Seat 2: Loucomeloo ($2.35 in chips)
Seat 3: Balla Vilmos ($1.90 in chips)
Seat 4: LLregs ($2.73 in chips)
Seat 5: Prince Mantis ($7.62 in chips)
Seat 6: Negro-Lavie ($2.17 in chips)
Loucomeloo: posts small blind $0.01
Balla Vilmos: posts big blind $0.02
*** HOLE CARDS ***
Dealt to LLregs [7h Th]
LLregs: folds
Prince Mantis: folds
Negro-Lavie: folds
Mikeloko182: raises $0.04 to $0.06
Loucomeloo: folds
Balla Vilmos: folds
Uncalled bet ($0.04) returned to Mikeloko182
Mikeloko182 collected $0.05 from pot
Mikeloko182: doesn't show hand
*** SUMMARY ***
Total pot $0.05 | Rake $0
Seat 1: Mikeloko182 (button) collected ($0.05)
Seat 2: Loucomeloo (small blind) folded before Flop
Seat 3: Balla Vilmos (big blind) folded before Flop
Seat 4: LLregs folded before Flop (didn't bet)
Seat 5: Prince Mantis folded before Flop (didn't bet)
Seat 6: Negro-Lavie folded before Flop (didn't bet)

PokerStars Zoom Hand #247959877090:  Hold'em No Limit ($0.01/$0.02) - 2023/12/30 15:18:10 WET [2023/12/30 10:18:10 ET]
Table 'Halley' 6-max Seat #1 is the button
Seat 1: Inokuchi ($1.94 in chips)
Seat 2: PovilasX ($2 in chips)
Seat 3: LLregs ($2.66 in chips)
Seat 4: theprince188 ($2.96 in chips)
Seat 5: ShearersRBoot ($2.06 in chips)
Seat 6: 888lifeIS ($2.26 in chips)
PovilasX: posts small blind $0.01
LLregs: posts big blind $0.02
*** HOLE CARDS ***
Dealt to LLregs [2c Ah]
theprince188: raises $0.03 to $0.05
ShearersRBoot: folds
888lifeIS: folds
Inokuchi: raises $0.11 to $0.16
PovilasX: folds
LLregs: folds
theprince188: raises $0.22 to $0.38
Inokuchi: calls $0.22
*** FLOP *** [8d Ad 8c]
theprince188: checks
Inokuchi: checks
*** TURN *** [8d Ad 8c] [Ac]
theprince188: checks
Inokuchi: bets $0.32
theprince188: calls $0.32
*** RIVER *** [8d Ad 8c Ac] [7h]
theprince188: bets $0.46
Inokuchi: calls $0.46
*** SHOW DOWN ***
theprince188: shows [As Kh] (a full house, Aces full of Eights)
Inokuchi: mucks hand
theprince188 collected $2.27 from pot
*** SUMMARY ***
Total pot $2.35 | Rake $0.08
Board [8d Ad 8c Ac 7h]
Seat 1: Inokuchi (button) mucked [Ks Kd]
Seat 2: PovilasX (small blind) folded before Flop
Seat 3: LLregs (big blind) folded before Flop
Seat 4: theprince188 showed [As Kh] and won ($2.27) with a full house, Aces full of Eights
Seat 5: ShearersRBoot folded before Flop (didn't bet)
Seat 6: 888lifeIS folded before Flop (didn't bet)

PokerStars Zoom Hand #247959893012:  Hold'em No Limit ($0.01/$0.02) - 2023/12/30 15:19:10 WET [2023/12/30 10:19:10 ET]
Table 'Halley' 6-max Seat #1 is the button
Seat 1: LLregs ($2.70 in chips)
Seat 2: AndGPR ($3.07 in chips)
Seat 3: ifiret68 ($2.74 in chips)
Seat 4: therookie1008 ($1.94 in chips)
Seat 5: ungiwar ($1.09 in chips)
Seat 6: avilaC73 ($2.16 in chips)
AndGPR: posts small blind $0.01
ifiret68: posts big blind $0.02
*** HOLE CARDS ***
Dealt to LLregs [7d 2d]
therookie1008: folds
ungiwar: raises $0.02 to $0.04
avilaC73: folds
LLregs: folds
AndGPR: calls $0.03
ifiret68: folds
*** FLOP *** [Ts Th Td]
AndGPR: checks
ungiwar: bets $0.05
AndGPR: calls $0.05
*** TURN *** [Ts Th Td] [As]
AndGPR: checks
ungiwar: checks
*** RIVER *** [Ts Th Td As] [4c]
AndGPR: checks
ungiwar: checks
*** SHOW DOWN ***
AndGPR: shows [6h 6s] (a full house, Tens full of Sixes)
ungiwar: mucks hand
AndGPR collected $0.19 from pot
*** SUMMARY ***
Total pot $0.20 | Rake $0.01
Board [Ts Th Td As 4c]
Seat 1: LLregs (button) folded before Flop (didn't bet)
Seat 2: AndGPR (small blind) showed [6h 6s] and won ($0.19) with a full house, Tens full of Sixes
Seat 3: ifiret68 (big blind) folded before Flop
Seat 4: therookie1008 folded before Flop (didn't bet)
Seat 5: ungiwar mucked [5s 5c]
Seat 6: avilaC73 folded before Flop (didn't bet)

PokerStars Zoom Hand #247959900359:  Hold'em No Limit ($0.01/$0.02) - 2023/12/30 15:19:37 WET [2023/12/30 10:19:37 ET]
Table 'Halley' 6-max Seat #1 is the button
Seat 1: Reaver993 ($1.91 in chips)
Seat 2: FEROIZ ($2.12 in chips)
Seat 3: LLregs ($2.73 in chips)
Seat 4: Harold_Seven ($2.75 in chips)
Seat 5: DeadKiriyama ($1.67 in chips)
Seat 6: Shmatrixs ($1.78 in chips)
FEROIZ: posts small blind $0.01
LLregs: posts big blind $0.02
*** HOLE CARDS ***
Dealt to LLregs [4d Td]
Harold_Seven: folds
DeadKiriyama: folds
Shmatrixs: folds
Reaver993: raises $0.03 to $0.05
FEROIZ: folds
LLregs: calls $0.03
*** FLOP *** [5c Ah 3c]
LLregs: checks
Reaver993: bets $0.04
LLregs: folds
Uncalled bet ($0.04) returned to Reaver993
Reaver993 collected $0.11 from pot
Reaver993: doesn't show hand
*** SUMMARY ***
Total pot $0.11 | Rake $0
Board [5c Ah 3c]
Seat 1: Reaver993 (button) collected ($0.11)
Seat 2: FEROIZ (small blind) folded before Flop
Seat 3: LLregs (big blind) folded on the Flop
Seat 4: Harold_Seven folded before Flop (didn't bet)
Seat 5: DeadKiriyama folded before Flop (didn't bet)
Seat 6: Shmatrixs folded before Flop (didn't bet)

PokerStars Zoom Hand #247959910061:  Hold'em No Limit ($0.01/$0.02) - 2023/12/30 15:20:13 WET [2023/12/30 10:20:13 ET]
Table 'Halley' 6-max Seat #1 is the button
Seat 1: September 022 ($2.03 in chips)
Seat 2: Alcapy ($8.44 in chips)
Seat 3: Dimoni797979 ($2.09 in chips)
Seat 4: zxczxc9999 ($1.96 in chips)
Seat 5: edhillm ($2.01 in chips)
Seat 6: LLregs ($2.67 in chips)
Alcapy: posts small blind $0.01
Dimoni797979: posts big blind $0.02
*** HOLE CARDS ***
Dealt to LLregs [Ac Th]
zxczxc9999: folds
edhillm: folds
LLregs: raises $0.04 to $0.06
September 022: folds
Alcapy: folds
Dimoni797979: folds
Uncalled bet ($0.04) returned to LLregs
LLregs collected $0.05 from pot
LLregs: doesn't show hand
*** SUMMARY ***
Total pot $0.05 | Rake $0
Seat 1: September 022 (button) folded before Flop (didn't bet)
Seat 2: Alcapy (small blind) folded before Flop
Seat 3: Dimoni797979 (big blind) folded before Flop
Seat 4: zxczxc9999 folded before Flop (didn't bet)
Seat 5: edhillm folded before Flop (didn't bet)
Seat 6: LLregs collected ($0.05)

PokerStars Zoom Hand #247959908977:  Hold'em No Limit ($0.01/$0.02) - 2023/12/30 15:20:09 WET [2023/12/30 10:20:09 ET]
Table 'Halley' 6-max Seat #1 is the button
Seat 1: Shmatrixs ($4.51 in chips)
Seat 2: LLregs ($2.68 in chips)
Seat 3: PovilasX ($2.85 in chips)
Seat 4: Mikeloko182 ($2 in chips)
Seat 5: zxczxc9999 ($1.96 in chips)
Seat 6: Loucomeloo ($2.26 in chips)
LLregs: posts small blind $0.01
PovilasX: posts big blind $0.02
*** HOLE CARDS ***
Dealt to LLregs [2d 7s]
Mikeloko182: folds
zxczxc9999: folds
Loucomeloo: raises $0.03 to $0.05
Shmatrixs: folds
LLregs: folds
PovilasX: folds
Uncalled bet ($0.03) returned to Loucomeloo
Loucomeloo collected $0.05 from pot
Loucomeloo: doesn't show hand
*** SUMMARY ***
Total pot $0.05 | Rake $0
Seat 1: Shmatrixs (button) folded before Flop (didn't bet)
Seat 2: LLregs (small blind) folded before Flop
Seat 3: PovilasX (big blind) folded before Flop
Seat 4: Mikeloko182 folded before Flop (didn't bet)
Seat 5: zxczxc9999 folded before Flop (didn't bet)
Seat 6: Loucomeloo collected ($0.05)

PokerStars Zoom Hand #247959913579:  Hold'em No Limit ($0.01/$0.02) - 2023/12/30 15:20:26 WET [2023/12/30 10:20:26 ET]
Table 'Halley' 6-max Seat #1 is the button
Seat 1: LLregs ($2.70 in chips)
Seat 2: sverduu ($1.04 in chips)
Seat 3: snapdrago241 ($0.49 in chips)
Seat 4: paulinura ($2.11 in chips)
Seat 5: tom216216216 ($2 in chips)
Seat 6: 3 gabriel ($2.34 in chips)
sverduu: posts small blind $0.01
snapdrago241: posts big blind $0.02
*** HOLE CARDS ***
Dealt to LLregs [Qs Jd]
paulinura: folds
tom216216216: folds
3 gabriel: folds
LLregs: raises $0.04 to $0.06
sverduu: calls $0.05
snapdrago241: calls $0.04
*** FLOP *** [8d 4s 8h]
sverduu: bets $0.05
snapdrago241: folds
LLregs: folds
Uncalled bet ($0.05) returned to sverduu
sverduu collected $0.17 from pot
sverduu: doesn't show hand
*** SUMMARY ***
Total pot $0.18 | Rake $0.01
Board [8d 4s 8h]
Seat 1: LLregs (button) folded on the Flop
Seat 2: sverduu (small blind) collected ($0.17)
Seat 3: snapdrago241 (big blind) folded on the Flop
Seat 4: paulinura folded before Flop (didn't bet)
Seat 5: tom216216216 folded before Flop (didn't bet)
Seat 6: 3 gabriel folded before Flop (didn't bet)

PokerStars Zoom Hand #247959924150:  Hold'em No Limit ($0.01/$0.02) - 2023/12/30 15:21:05 WET [2023/12/30 10:21:05 ET]
Table 'Halley' 6-max Seat #1 is the button
Seat 1: Makedonskiyy ($0.97 in chips)
Seat 2: chinex_sba ($2 in chips)
Seat 3: piccolino25 ($2.22 in chips)
Seat 4: ungiwar ($0.80 in chips)
Seat 5: LLregs ($2.62 in chips)
Seat 6: cr@sh test ($2 in chips)
chinex_sba: posts small blind $0.01
piccolino25: posts big blind $0.02
*** HOLE CARDS ***
Dealt to LLregs [Kd 6c]
ungiwar: folds
LLregs: folds
cr@sh test: folds
Makedonskiyy: folds
chinex_sba: raises $0.04 to $0.06
piccolino25: folds
Uncalled bet ($0.04) returned to chinex_sba
chinex_sba collected $0.04 from pot
chinex_sba: doesn't show hand
*** SUMMARY ***
Total pot $0.04 | Rake $0
Seat 1: Makedonskiyy (button) folded before Flop (didn't bet)
Seat 2: chinex_sba (small blind) collected ($0.04)
Seat 3: piccolino25 (big blind) folded before Flop
Seat 4: ungiwar folded before Flop (didn't bet)
Seat 5: LLregs folded before Flop (didn't bet)
Seat 6: cr@sh test folded before Flop (didn't bet)

PokerStars Zoom Hand #247959928094:  Hold'em No Limit ($0.01/$0.02) - 2023/12/30 15:21:19 WET [2023/12/30 10:21:19 ET]
Table 'Halley' 6-max Seat #1 is the button
Seat 1: ZWEZDA126 ($1.69 in chips)
Seat 2: 15Thousand ($1.01 in chips)
Seat 3: LLregs ($2.61 in chips)
Seat 4: FrancoGaston74 ($4.97 in chips)
Seat 5: Jhon Rambo.CL ($2.49 in chips)
Seat 6: Donnnna ($2.29 in chips)
15Thousand: posts small blind $0.01
LLregs: posts big blind $0.02
*** HOLE CARDS ***
Dealt to LLregs [Kh 5s]
FrancoGaston74: folds
Jhon Rambo.CL: folds
Donnnna: folds
ZWEZDA126: raises $0.05 to $0.07
15Thousand: folds
LLregs: folds
Uncalled bet ($0.05) returned to ZWEZDA126
ZWEZDA126 collected $0.05 from pot
ZWEZDA126: doesn't show hand
*** SUMMARY ***
Total pot $0.05 | Rake $0
Seat 1: ZWEZDA126 (button) collected ($0.05)
Seat 2: 15Thousand (small blind) folded before Flop
Seat 3: LLregs (big blind) folded before Flop
Seat 4: FrancoGaston74 folded before Flop (didn't bet)
Seat 5: Jhon Rambo.CL folded before Flop (didn't bet)
Seat 6: Donnnna folded before Flop (didn't bet)

PokerStars Zoom Hand #247959918987:  Hold'em No Limit ($0.01/$0.02) - 2023/12/30 15:20:46 WET [2023/12/30 10:20:46 ET]
Table 'Halley' 6-max Seat #1 is the button
Seat 1: EL AS BS AS ($2.22 in chips)
Seat 2: 39REDMAN ($0.41 in chips)
Seat 3: LLregs ($2.64 in chips)
Seat 4: Svetlana-ck ($2.11 in chips)
Seat 5: PovilasX ($2 in chips)
Seat 6: karintou8888 ($2.08 in chips)
39REDMAN: posts small blind $0.01
LLregs: posts big blind $0.02
*** HOLE CARDS ***
Dealt to LLregs [2h Tc]
Svetlana-ck: folds
PovilasX: folds
karintou8888: folds
EL AS BS AS: raises $0.02 to $0.04
39REDMAN: calls $0.03
LLregs: folds
*** FLOP *** [7s 9h Kc]
39REDMAN: checks
EL AS BS AS: bets $0.04
39REDMAN: raises $0.33 to $0.37 and is all-in
EL AS BS AS: calls $0.33
*** TURN *** [7s 9h Kc] [5s]
*** RIVER *** [7s 9h Kc 5s] [Td]
*** SHOW DOWN ***
39REDMAN: shows [3h Kh] (a pair of Kings)
EL AS BS AS: shows [Jh 9c] (a pair of Nines)
EL AS BS AS cashed out the hand for $0.17
39REDMAN cashed out the hand for $0.63 | Cash Out Fee $0.01
*** SUMMARY ***
Total pot $0.84 | Rake $0.03
Board [7s 9h Kc 5s Td]
Seat 1: EL AS BS AS (button) showed [Jh 9c] and lost with a pair of Nines (cashed out).
Seat 2: 39REDMAN (small blind) showed [3h Kh] and won ($0.81) with a pair of Kings (pot not awarded as player cashed out)
Seat 3: LLregs (big blind) folded before Flop
Seat 4: Svetlana-ck folded before Flop (didn't bet)
Seat 5: PovilasX folded before Flop (didn't bet)
Seat 6: karintou8888 folded before Flop (didn't bet)

PokerStars Zoom Hand #247959925256:  Hold'em No Limit ($0.01/$0.02) - 2023/12/30 15:21:09 WET [2023/12/30 10:21:09 ET]
Table 'Halley' 6-max Seat #1 is the button
Seat 1: chinex_sba ($2.04 in chips)
Seat 2: LLregs ($2.62 in chips)
Seat 3: Josip1119 ($3.50 in chips)
Seat 4: 15Thousand ($1.03 in chips)
Seat 5: Mamirox ($2.24 in chips)
Seat 6: Balla Vilmos ($1.76 in chips)
LLregs: posts small blind $0.01
Josip1119: posts big blind $0.02
*** HOLE CARDS ***
Dealt to LLregs [2c Qh]
15Thousand: folds
Mamirox: folds
Balla Vilmos: folds
chinex_sba: raises $0.03 to $0.05
LLregs: folds
Josip1119: calls $0.03
*** FLOP *** [6c 6h Kh]
Josip1119: checks
chinex_sba: bets $0.04
Josip1119: folds
Uncalled bet ($0.04) returned to chinex_sba
chinex_sba collected $0.11 from pot
chinex_sba: doesn't show hand
*** SUMMARY ***
Total pot $0.11 | Rake $0
Board [6c 6h Kh]
Seat 1: chinex_sba (button) collected ($0.11)
Seat 2: LLregs (small blind) folded before Flop
Seat 3: Josip1119 (big blind) folded on the Flop
Seat 4: 15Thousand folded before Flop (didn't bet)
Seat 5: Mamirox folded before Flop (didn't bet)
Seat 6: Balla Vilmos folded before Flop (didn't bet)

PokerStars Zoom Hand #247959917892:  Hold'em No Limit ($0.01/$0.02) - 2023/12/30 15:20:42 WET [2023/12/30 10:20:42 ET]
Table 'Halley' 6-max Seat #1 is the button
Seat 1: bartovskii ($5.65 in chips)
Seat 2: theprince188 ($6.98 in chips)
Seat 3: nestor-ruso ($3.59 in chips)
Seat 4: DeadKiriyama ($2.02 in chips)
Seat 5: LLregs ($2.64 in chips)
Seat 6: zeroelegante ($9.86 in chips)
theprince188: posts small blind $0.01
nestor-ruso: posts big blind $0.02
*** HOLE CARDS ***
Dealt to LLregs [6h 2c]
DeadKiriyama: raises $0.04 to $0.06
LLregs: folds
zeroelegante: folds
bartovskii: folds
theprince188: folds
nestor-ruso: calls $0.04
*** FLOP *** [6d 6s 2s]
nestor-ruso: checks
DeadKiriyama: bets $0.06
nestor-ruso: calls $0.06
*** TURN *** [6d 6s 2s] [4d]
nestor-ruso: bets $0.08
DeadKiriyama: calls $0.08
*** RIVER *** [6d 6s 2s 4d] [6c]
nestor-ruso: bets $0.04
DeadKiriyama: calls $0.04
*** SHOW DOWN ***
nestor-ruso: shows [Ad Ks] (three of a kind, Sixes)
DeadKiriyama: shows [Td Th] (a full house, Sixes full of Tens)
DeadKiriyama collected $0.47 from pot
*** SUMMARY ***
Total pot $0.49 | Rake $0.02
Board [6d 6s 2s 4d 6c]
Seat 1: bartovskii (button) folded before Flop (didn't bet)
Seat 2: theprince188 (small blind) folded before Flop
Seat 3: nestor-ruso (big blind) showed [Ad Ks] and lost with three of a kind, Sixes
Seat 4: DeadKiriyama showed [Td Th] and won ($0.47) with a full house, Sixes full of Tens
Seat 5: LLregs folded before Flop (didn't bet)
Seat 6: zeroelegante folded before Flop (didn't bet)

PokerStars Zoom Hand #247959930548:  Hold'em No Limit ($0.01/$0.02) - 2023/12/30 15:21:28 WET [2023/12/30 10:21:28 ET]
Table 'Halley' 6-max Seat #1 is the button
Seat 1: kygo19 ($5.01 in chips)
Seat 2: LLregs ($2.59 in chips)
Seat 3: Mamirox ($2.72 in chips)
Seat 4: snap604 ($4.31 in chips)
Seat 5: lapoleka ($0.68 in chips)
Seat 6: ilian1111 ($2 in chips)
LLregs: posts small blind $0.01
Mamirox: posts big blind $0.02
*** HOLE CARDS ***
Dealt to LLregs [7s 3c]
snap604: raises $0.08 to $0.10
lapoleka: folds
ilian1111: folds
kygo19: folds
LLregs: folds
Mamirox: folds
Uncalled bet ($0.08) returned to snap604
snap604 collected $0.05 from pot
snap604: doesn't show hand
*** SUMMARY ***
Total pot $0.05 | Rake $0
Seat 1: kygo19 (button) folded before Flop (didn't bet)
Seat 2: LLregs (small blind) folded before Flop
Seat 3: Mamirox (big blind) folded before Flop
Seat 4: snap604 collected ($0.05)
Seat 5: lapoleka folded before Flop (didn't bet)
Seat 6: ilian1111 folded before Flop (didn't bet)

PokerStars Zoom Hand #247959927194:  Hold'em No Limit ($0.01/$0.02) - 2023/12/30 15:21:16 WET [2023/12/30 10:21:16 ET]
Table 'Halley' 6-max Seat #1 is the button
Seat 1: THXforFoldin ($5.67 in chips)
Seat 2: PR3SUR3 ($7.77 in chips)
Seat 3: vovan22-99 ($1.75 in chips)
Seat 4: iliyan66 ($5.42 in chips)
Seat 5: StariEger ($3.21 in chips)
Seat 6: LLregs ($2.61 in chips)
PR3SUR3: posts small blind $0.01
vovan22-99: posts big blind $0.02
*** HOLE CARDS ***
Dealt to LLregs [3h Js]
iliyan66: folds
StariEger: folds
LLregs: folds
THXforFoldin: raises $0.04 to $0.06
PR3SUR3: calls $0.05
vovan22-99: calls $0.04
*** FLOP *** [Kc 8h 6d]
PR3SUR3: checks
vovan22-99: checks
THXforFoldin: bets $0.09
PR3SUR3: calls $0.09
vovan22-99: folds
*** TURN *** [Kc 8h 6d] [8c]
PR3SUR3: checks
THXforFoldin: checks
*** RIVER *** [Kc 8h 6d 8c] [2d]
PR3SUR3: checks
THXforFoldin: checks
*** SHOW DOWN ***
PR3SUR3: shows [9h 9d] (two pair, Nines and Eights)
THXforFoldin: mucks hand
PR3SUR3 collected $0.35 from pot
*** SUMMARY ***
Total pot $0.36 | Rake $0.01
Board [Kc 8h 6d 8c 2d]
Seat 1: THXforFoldin (button) mucked [Qc As]
Seat 2: PR3SUR3 (small blind) showed [9h 9d] and won ($0.35) with two pair, Nines and Eights
Seat 3: vovan22-99 (big blind) folded on the Flop
Seat 4: iliyan66 folded before Flop (didn't bet)
Seat 5: StariEger folded before Flop (didn't bet)
Seat 6: LLregs folded before Flop (didn't bet)

PokerStars Zoom Hand #247959931655:  Hold'em No Limit ($0.01/$0.02) - 2023/12/30 15:21:32 WET [2023/12/30 10:21:32 ET]
Table 'Halley' 6-max Seat #1 is the button
Seat 1: LLregs ($2.58 in chips)
Seat 2: 888lifeIS ($2.10 in chips)
Seat 3: edhillm ($2 in chips)
Seat 4: THXforFoldin ($2.11 in chips)
Seat 5: danielito577 ($3 in chips)
Seat 6: piccolino25 ($2.20 in chips)
888lifeIS: posts small blind $0.01
edhillm: posts big blind $0.02
*** HOLE CARDS ***
Dealt to LLregs [Tc Qc]
THXforFoldin: folds
danielito577: folds
piccolino25: folds
LLregs: raises $0.04 to $0.06
888lifeIS: folds
edhillm: calls $0.04
*** FLOP *** [Kd 5h Qd]
edhillm: checks
LLregs: bets $0.06
edhillm: calls $0.06
*** TURN *** [Kd 5h Qd] [6s]
edhillm: checks
LLregs: bets $0.08
edhillm: calls $0.08
*** RIVER *** [Kd 5h Qd 6s] [9c]
edhillm: checks
LLregs: checks
*** SHOW DOWN ***
edhillm: shows [Ah Jd] (high card Ace)
LLregs: shows [Tc Qc] (a pair of Queens)
LLregs collected $0.40 from pot
*** SUMMARY ***
Total pot $0.41 | Rake $0.01
Board [Kd 5h Qd 6s 9c]
Seat 1: LLregs (button) showed [Tc Qc] and won ($0.40) with a pair of Queens
Seat 2: 888lifeIS (small blind) folded before Flop
Seat 3: edhillm (big blind) showed [Ah Jd] and lost with high card Ace
Seat 4: THXforFoldin folded before Flop (didn't bet)
Seat 5: danielito577 folded before Flop (didn't bet)
Seat 6: piccolino25 folded before Flop (didn't bet)

PokerStars Zoom Hand #247959946609:  Hold'em No Limit ($0.01/$0.02) - 2023/12/30 15:22:27 WET [2023/12/30 10:22:27 ET]
Table 'Halley' 6-max Seat #1 is the button
Seat 1: Josip1119 ($2 in chips)
Seat 2: StariEger ($3.27 in chips)
Seat 3: 888lifeIS ($2 in chips)
Seat 4: LLregs ($2.78 in chips)
Seat 5: DonVasileeee ($2 in chips)
Seat 6: M1k3B4gUnc1nh4 ($1.63 in chips)
StariEger: posts small blind $0.01
888lifeIS: posts big blind $0.02
*** HOLE CARDS ***
Dealt to LLregs [5s Ah]
LLregs: folds
DonVasileeee: raises $0.03 to $0.05
M1k3B4gUnc1nh4: folds
Josip1119: folds
StariEger: folds
888lifeIS: folds
Uncalled bet ($0.03) returned to DonVasileeee
DonVasileeee collected $0.05 from pot
DonVasileeee: doesn't show hand
*** SUMMARY ***
Total pot $0.05 | Rake $0
Seat 1: Josip1119 (button) folded before Flop (didn't bet)
Seat 2: StariEger (small blind) folded before Flop
Seat 3: 888lifeIS (big blind) folded before Flop
Seat 4: LLregs folded before Flop (didn't bet)
Seat 5: DonVasileeee collected ($0.05)
Seat 6: M1k3B4gUnc1nh4 folded before Flop (didn't bet)

PokerStars Zoom Hand #247959948026:  Hold'em No Limit ($0.01/$0.02) - 2023/12/30 15:22:32 WET [2023/12/30 10:22:32 ET]
Table 'Halley' 6-max Seat #1 is the button
Seat 1: LLregs ($2.78 in chips)
Seat 2: Tutunn ($2.35 in chips)
Seat 3: Arabescul ($2 in chips)
Seat 4: Loucomeloo ($2.03 in chips)
Seat 5: rrluis1930 ($2.19 in chips)
Seat 6: edhillm ($4.66 in chips)
Tutunn: posts small blind $0.01
Arabescul: posts big blind $0.02
*** HOLE CARDS ***
Dealt to LLregs [Ad Jd]
Loucomeloo: folds
rrluis1930: folds
edhillm: folds
LLregs: raises $0.04 to $0.06
Tutunn: calls $0.05
Arabescul: folds
*** FLOP *** [5h 7c 6c]
Tutunn: checks
LLregs: checks
*** TURN *** [5h 7c 6c] [2c]
Tutunn: bets $0.08
LLregs: calls $0.08
*** RIVER *** [5h 7c 6c 2c] [5c]
Tutunn: checks
LLregs: bets $0.14
Tutunn: folds
Uncalled bet ($0.14) returned to LLregs
LLregs collected $0.29 from pot
LLregs: doesn't show hand
*** SUMMARY ***
Total pot $0.30 | Rake $0.01
Board [5h 7c 6c 2c 5c]
Seat 1: LLregs (button) collected ($0.29)
Seat 2: Tutunn (small blind) folded on the River
Seat 3: Arabescul (big blind) folded before Flop
Seat 4: Loucomeloo folded before Flop (didn't bet)
Seat 5: rrluis1930 folded before Flop (didn't bet)
Seat 6: edhillm folded before Flop (didn't bet)

PokerStars Zoom Hand #247959956935:  Hold'em No Limit ($0.01/$0.02) - 2023/12/30 15:23:04 WET [2023/12/30 10:23:04 ET]
Table 'Halley' 6-max Seat #1 is the button
Seat 1: FEROIZ ($3.13 in chips)
Seat 2: psdgr3 ($2.02 in chips)
Seat 3: Svetlana-ck ($2.01 in chips)
Seat 4: flipjammer ($3.36 in chips)
Seat 5: Waschbär1984 ($2.04 in chips)
Seat 6: LLregs ($2.93 in chips)
psdgr3: posts small blind $0.01
Svetlana-ck: posts big blind $0.02
*** HOLE CARDS ***
Dealt to LLregs [Ks Ad]
flipjammer: folds
Waschbär1984: folds
LLregs: raises $0.04 to $0.06
FEROIZ: folds
psdgr3: folds
Svetlana-ck: calls $0.04
*** FLOP *** [Jh Ac Kc]
Svetlana-ck: checks
LLregs: bets $0.04
Svetlana-ck: calls $0.04
*** TURN *** [Jh Ac Kc] [7c]
Svetlana-ck: checks
LLregs: bets $0.05
Svetlana-ck: calls $0.05
*** RIVER *** [Jh Ac Kc 7c] [Ah]
Svetlana-ck: checks
LLregs: bets $0.23
Svetlana-ck: calls $0.23
*** SHOW DOWN ***
LLregs: shows [Ks Ad] (a full house, Aces full of Kings)
Svetlana-ck: mucks hand
LLregs collected $0.74 from pot
*** SUMMARY ***
Total pot $0.77 | Rake $0.03
Board [Jh Ac Kc 7c Ah]
Seat 1: FEROIZ (button) folded before Flop (didn't bet)
Seat 2: psdgr3 (small blind) folded before Flop
Seat 3: Svetlana-ck (big blind) mucked [6h As]
Seat 4: flipjammer folded before Flop (didn't bet)
Seat 5: Waschbär1984 folded before Flop (didn't bet)
Seat 6: LLregs showed [Ks Ad] and won ($0.74) with a full house, Aces full of Kings

PokerStars Zoom Hand #247959971425:  Hold'em No Limit ($0.01/$0.02) - 2023/12/30 15:23:57 WET [2023/12/30 10:23:57 ET]
Table 'Halley' 6-max Seat #1 is the button
Seat 1: Casinoca$h ($2.31 in chips)
Seat 2: kxetinha ($3.13 in chips)
Seat 3: dmitriy2426 ($1.88 in chips)
Seat 4: LLregs ($3.29 in chips)
Seat 5: FreeTruckerMAN ($1.59 in chips)
Seat 6: leedsrounder ($2 in chips)
kxetinha: posts small blind $0.01
dmitriy2426: posts big blind $0.02
*** HOLE CARDS ***
Dealt to LLregs [9c 8d]
LLregs: folds
FreeTruckerMAN: folds
leedsrounder: raises $0.03 to $0.05
Casinoca$h: folds
kxetinha: folds
dmitriy2426: folds
Uncalled bet ($0.03) returned to leedsrounder
leedsrounder collected $0.05 from pot
leedsrounder: doesn't show hand
*** SUMMARY ***
Total pot $0.05 | Rake $0
Seat 1: Casinoca$h (button) folded before Flop (didn't bet)
Seat 2: kxetinha (small blind) folded before Flop
Seat 3: dmitriy2426 (big blind) folded before Flop
Seat 4: LLregs folded before Flop (didn't bet)
Seat 5: FreeTruckerMAN folded before Flop (didn't bet)
Seat 6: leedsrounder collected ($0.05)

PokerStars Zoom Hand #247959972388:  Hold'em No Limit ($0.01/$0.02) - 2023/12/30 15:24:01 WET [2023/12/30 10:24:01 ET]
Table 'Halley' 6-max Seat #1 is the button
Seat 1: PR3SUR3 ($5.13 in chips)
Seat 2: DonVasileeee ($2 in chips)
Seat 3: Raymond322 ($5.23 in chips)
Seat 4: LLregs ($3.29 in chips)
Seat 5: japob ($1.77 in chips)
Seat 6: 888lifeIS ($2.37 in chips)
DonVasileeee: posts small blind $0.01
Raymond322: posts big blind $0.02
*** HOLE CARDS ***
Dealt to LLregs [9d 4s]
LLregs: folds
japob: folds
888lifeIS: raises $0.02 to $0.04
PR3SUR3: folds
DonVasileeee: folds
Raymond322: folds
Uncalled bet ($0.02) returned to 888lifeIS
888lifeIS collected $0.05 from pot
888lifeIS: doesn't show hand
*** SUMMARY ***
Total pot $0.05 | Rake $0
Seat 1: PR3SUR3 (button) folded before Flop (didn't bet)
Seat 2: DonVasileeee (small blind) folded before Flop
Seat 3: Raymond322 (big blind) folded before Flop
Seat 4: LLregs folded before Flop (didn't bet)
Seat 5: japob folded before Flop (didn't bet)
Seat 6: 888lifeIS collected ($0.05)

PokerStars Zoom Hand #247959973304:  Hold'em No Limit ($0.01/$0.02) - 2023/12/30 15:24:04 WET [2023/12/30 10:24:04 ET]
Table 'Halley' 6-max Seat #1 is the button
Seat 1: nuttymuch ($2.26 in chips)
Seat 2: M1k3B4gUnc1nh4 ($1.54 in chips)
Seat 3: LLregs ($3.29 in chips)
Seat 4: Shturakov ($4.37 in chips)
Seat 5: ZiggyBoy90 ($3.83 in chips)
Seat 6: Josip1119 ($2.97 in chips)
M1k3B4gUnc1nh4: posts small blind $0.01
LLregs: posts big blind $0.02
*** HOLE CARDS ***
Dealt to LLregs [6h 5h]
Shturakov: folds
ZiggyBoy90: raises $0.03 to $0.05
Josip1119: calls $0.05
nuttymuch: folds
M1k3B4gUnc1nh4: folds
LLregs: raises $0.11 to $0.16
ZiggyBoy90: folds
Josip1119: folds
Uncalled bet ($0.11) returned to LLregs
LLregs collected $0.16 from pot
LLregs: doesn't show hand
*** SUMMARY ***
Total pot $0.16 | Rake $0
Seat 1: nuttymuch (button) folded before Flop (didn't bet)
Seat 2: M1k3B4gUnc1nh4 (small blind) folded before Flop
Seat 3: LLregs (big blind) collected ($0.16)
Seat 4: Shturakov folded before Flop (didn't bet)
Seat 5: ZiggyBoy90 folded before Flop
Seat 6: Josip1119 folded before Flop

PokerStars Zoom Hand #247959978890:  Hold'em No Limit ($0.01/$0.02) - 2023/12/30 15:24:24 WET [2023/12/30 10:24:24 ET]
Table 'Halley' 6-max Seat #1 is the button
Seat 1: ungiwar ($1.05 in chips)
Seat 2: podrevnik2 ($3.79 in chips)
Seat 3: zoro782 ($9.78 in chips)
Seat 4: BiG whaIe ($2.51 in chips)
Seat 5: Thooorrr ($2 in chips)
Seat 6: LLregs ($3.40 in chips)
podrevnik2: posts small blind $0.01
zoro782: posts big blind $0.02
*** HOLE CARDS ***
Dealt to LLregs [3s 9d]
BiG whaIe: folds
Thooorrr: folds
LLregs: folds
ungiwar: folds
podrevnik2: calls $0.01
zoro782: raises $0.08 to $0.10
podrevnik2: folds
Uncalled bet ($0.08) returned to zoro782
zoro782 collected $0.04 from pot
zoro782: doesn't show hand
*** SUMMARY ***
Total pot $0.04 | Rake $0
Seat 1: ungiwar (button) folded before Flop (didn't bet)
Seat 2: podrevnik2 (small blind) folded before Flop
Seat 3: zoro782 (big blind) collected ($0.04)
Seat 4: BiG whaIe folded before Flop (didn't bet)
Seat 5: Thooorrr folded before Flop (didn't bet)
Seat 6: LLregs folded before Flop (didn't bet)

PokerStars Zoom Hand #247959968813:  Hold'em No Limit ($0.01/$0.02) - 2023/12/30 15:23:48 WET [2023/12/30 10:23:48 ET]
Table 'Halley' 6-max Seat #1 is the button
Seat 1: piccolino25 ($2 in chips)
Seat 2: zxczxc9999 ($2.26 in chips)
Seat 3: vitalikto ($2 in chips)
Seat 4: Donnnna ($1.97 in chips)
Seat 5: LLregs ($3.29 in chips)
Seat 6: 888lifeIS ($2.02 in chips)
zxczxc9999: posts small blind $0.01
vitalikto: posts big blind $0.02
*** HOLE CARDS ***
Dealt to LLregs [Jh 7c]
Donnnna: folds
LLregs: folds
888lifeIS: folds
piccolino25: folds
zxczxc9999: raises $0.03 to $0.05
vitalikto: raises $0.10 to $0.15
zxczxc9999: calls $0.10
*** FLOP *** [3h 8h As]
zxczxc9999: checks
vitalikto: bets $0.15
zxczxc9999: calls $0.15
*** TURN *** [3h 8h As] [Jd]
zxczxc9999: checks
vitalikto: checks
*** RIVER *** [3h 8h As Jd] [3c]
zxczxc9999: bets $0.29
vitalikto: folds
Uncalled bet ($0.29) returned to zxczxc9999
zxczxc9999 collected $0.58 from pot
zxczxc9999: doesn't show hand
*** SUMMARY ***
Total pot $0.60 | Rake $0.02
Board [3h 8h As Jd 3c]
Seat 1: piccolino25 (button) folded before Flop (didn't bet)
Seat 2: zxczxc9999 (small blind) collected ($0.58)
Seat 3: vitalikto (big blind) folded on the River
Seat 4: Donnnna folded before Flop (didn't bet)
Seat 5: LLregs folded before Flop (didn't bet)
Seat 6: 888lifeIS folded before Flop (didn't bet)

PokerStars Zoom Hand #247959987655:  Hold'em No Limit ($0.01/$0.02) - 2023/12/30 15:24:56 WET [2023/12/30 10:24:56 ET]
Table 'Halley' 6-max Seat #1 is the button
Seat 1: LLregs ($3.34 in chips)
Seat 2: FEROIZ ($3.08 in chips)
Seat 3: rafds765 ($5.83 in chips)
Seat 4: k7allinn ($2.07 in chips)
Seat 5: martimac573 ($2.01 in chips)
Seat 6: DonVasileeee ($2 in chips)
FEROIZ: posts small blind $0.01
rafds765: posts big blind $0.02
*** HOLE CARDS ***
Dealt to LLregs [2h 7s]
k7allinn: folds
martimac573: folds
DonVasileeee: folds
LLregs: folds
FEROIZ: folds
Uncalled bet ($0.01) returned to rafds765
rafds765 collected $0.02 from pot
rafds765: doesn't show hand
*** SUMMARY ***
Total pot $0.02 | Rake $0
Seat 1: LLregs (button) folded before Flop (didn't bet)
Seat 2: FEROIZ (small blind) folded before Flop
Seat 3: rafds765 (big blind) collected ($0.02)
Seat 4: k7allinn folded before Flop (didn't bet)
Seat 5: martimac573 folded before Flop (didn't bet)
Seat 6: DonVasileeee folded before Flop (didn't bet)

PokerStars Zoom Hand #247959988746:  Hold'em No Limit ($0.01/$0.02) - 2023/12/30 15:25:00 WET [2023/12/30 10:25:00 ET]
Table 'Halley' 6-max Seat #1 is the button
Seat 1: PR3SUR3 ($5.09 in chips)
Seat 2: SerberStepan ($3.70 in chips)
Seat 3: guegui.eds ($0.97 in chips)
Seat 4: martimac573 ($2.01 in chips)
Seat 5: LLregs ($3.34 in chips)
Seat 6: piccolino25 ($1.99 in chips)
SerberStepan: posts small blind $0.01
guegui.eds: posts big blind $0.02
*** HOLE CARDS ***
Dealt to LLregs [9s Js]
martimac573: folds
LLregs: raises $0.04 to $0.06
piccolino25: folds
PR3SUR3: folds
SerberStepan: calls $0.05
guegui.eds: folds
*** FLOP *** [8d 3s Kd]
SerberStepan: checks
LLregs: checks
*** TURN *** [8d 3s Kd] [Qh]
SerberStepan: checks
LLregs: bets $0.05
SerberStepan: folds
Uncalled bet ($0.05) returned to LLregs
LLregs collected $0.14 from pot
LLregs: doesn't show hand
*** SUMMARY ***
Total pot $0.14 | Rake $0
Board [8d 3s Kd Qh]
Seat 1: PR3SUR3 (button) folded before Flop (didn't bet)
Seat 2: SerberStepan (small blind) folded on the Turn
Seat 3: guegui.eds (big blind) folded before Flop
Seat 4: martimac573 folded before Flop (didn't bet)
Seat 5: LLregs collected ($0.14)
Seat 6: piccolino25 folded before Flop (didn't bet)

PokerStars Zoom Hand #247959979904:  Hold'em No Limit ($0.01/$0.02) - 2023/12/30 15:24:28 WET [2023/12/30 10:24:28 ET]
Table 'Halley' 6-max Seat #1 is the button
Seat 1: frankquanki ($1 in chips)
Seat 2: LLregs ($3.40 in chips)
Seat 3: ZiggyBoy90 ($3.78 in chips)
Seat 4: Shmatrixs ($1.69 in chips)
Seat 5: OmegaDeltaPo ($1.24 in chips)
Seat 6: therookie1008 ($1.97 in chips)
LLregs: posts small blind $0.01
ZiggyBoy90: posts big blind $0.02
*** HOLE CARDS ***
Dealt to LLregs [Qc 8c]
Shmatrixs: raises $0.04 to $0.06
OmegaDeltaPo: folds
therookie1008: folds
frankquanki: folds
LLregs: calls $0.05
ZiggyBoy90: raises $0.25 to $0.31
Shmatrixs: calls $0.25
LLregs: folds
*** FLOP *** [5s 6d Js]
ZiggyBoy90: bets $0.50
Shmatrixs: raises $0.88 to $1.38 and is all-in
ZiggyBoy90: calls $0.88
*** TURN *** [5s 6d Js] [Kd]
*** RIVER *** [5s 6d Js Kd] [Qh]
*** SHOW DOWN ***
ZiggyBoy90: shows [As Ts] (a straight, Ten to Ace)
Shmatrixs: shows [Jh 9h] (a pair of Jacks)
ZiggyBoy90 collected $3.32 from pot
*** SUMMARY ***
Total pot $3.44 | Rake $0.12
Board [5s 6d Js Kd Qh]
Seat 1: frankquanki (button) folded before Flop (didn't bet)
Seat 2: LLregs (small blind) folded before Flop
Seat 3: ZiggyBoy90 (big blind) showed [As Ts] and won ($3.32) with a straight, Ten to Ace
Seat 4: Shmatrixs showed [Jh 9h] and lost with a pair of Jacks
Seat 5: OmegaDeltaPo folded before Flop (didn't bet)
Seat 6: therookie1008 folded before Flop (didn't bet)

PokerStars Zoom Hand #247959994967:  Hold'em No Limit ($0.01/$0.02) - 2023/12/30 15:25:23 WET [2023/12/30 10:25:23 ET]
Table 'Halley' 6-max Seat #1 is the button
Seat 1: M1k3B4gUnc1nh4 ($1.46 in chips)
Seat 2: chinex_sba ($2.01 in chips)
Seat 3: LLregs ($3.42 in chips)
Seat 4: yakov-100 ($0.84 in chips)
Seat 5: psdgr3 ($2.04 in chips)
Seat 6: WolveroX ($3.44 in chips)
chinex_sba: posts small blind $0.01
LLregs: posts big blind $0.02
*** HOLE CARDS ***
Dealt to LLregs [8c Jc]
yakov-100: folds
psdgr3: folds
WolveroX: folds
M1k3B4gUnc1nh4: folds
chinex_sba: raises $0.04 to $0.06
LLregs: calls $0.04
*** FLOP *** [6d As 9h]
chinex_sba: checks
LLregs: bets $0.06
chinex_sba: folds
Uncalled bet ($0.06) returned to LLregs
LLregs collected $0.12 from pot
LLregs: doesn't show hand
*** SUMMARY ***
Total pot $0.12 | Rake $0
Board [6d As 9h]
Seat 1: M1k3B4gUnc1nh4 (button) folded before Flop (didn't bet)
Seat 2: chinex_sba (small blind) folded on the Flop
Seat 3: LLregs (big blind) collected ($0.12)
Seat 4: yakov-100 folded before Flop (didn't bet)
Seat 5: psdgr3 folded before Flop (didn't bet)
Seat 6: WolveroX folded before Flop (didn't bet)

PokerStars Zoom Hand #247960004036:  Hold'em No Limit ($0.01/$0.02) - 2023/12/30 15:25:56 WET [2023/12/30 10:25:56 ET]
Table 'Halley' 6-max Seat #1 is the button
Seat 1: BiG whaIe ($2.42 in chips)
Seat 2: zoro782 ($10.03 in chips)
Seat 3: C2DFMNLH ($3.65 in chips)
Seat 4: Nutu1313 ($2.09 in chips)
Seat 5: LLregs ($3.48 in chips)
Seat 6: flipjammer ($3.41 in chips)
zoro782: posts small blind $0.01
C2DFMNLH: posts big blind $0.02
*** HOLE CARDS ***
Dealt to LLregs [2d As]
Nutu1313: raises $0.04 to $0.06
LLregs: folds
flipjammer: folds
BiG whaIe: folds
zoro782: folds
C2DFMNLH: folds
Uncalled bet ($0.04) returned to Nutu1313
Nutu1313 collected $0.05 from pot
Nutu1313: doesn't show hand
*** SUMMARY ***
Total pot $0.05 | Rake $0
Seat 1: BiG whaIe (button) folded before Flop (didn't bet)
Seat 2: zoro782 (small blind) folded before Flop
Seat 3: C2DFMNLH (big blind) folded before Flop
Seat 4: Nutu1313 collected ($0.05)
Seat 5: LLregs folded before Flop (didn't bet)
Seat 6: flipjammer folded before Flop (didn't bet)

PokerStars Zoom Hand #247960005118:  Hold'em No Limit ($0.01/$0.02) - 2023/12/30 15:26:00 WET [2023/12/30 10:26:00 ET]
Table 'Halley' 6-max Seat #1 is the button
Seat 1: nuttymuch ($3.16 in chips)
Seat 2: ifiret68 ($2.69 in chips)
Seat 3: frankquanki ($1.85 in chips)
Seat 4: LLregs ($3.48 in chips)
Seat 5: Dance2020 ($2.60 in chips)
Seat 6: FreeTruckerMAN ($1.53 in chips)
ifiret68: posts small blind $0.01
frankquanki: posts big blind $0.02
*** HOLE CARDS ***
Dealt to LLregs [9h 3c]
LLregs: folds
Dance2020: folds
FreeTruckerMAN: raises $0.02 to $0.04
nuttymuch: folds
ifiret68: folds
frankquanki: folds
Uncalled bet ($0.02) returned to FreeTruckerMAN
FreeTruckerMAN collected $0.05 from pot
FreeTruckerMAN: doesn't show hand
*** SUMMARY ***
Total pot $0.05 | Rake $0
Seat 1: nuttymuch (button) folded before Flop (didn't bet)
Seat 2: ifiret68 (small blind) folded before Flop
Seat 3: frankquanki (big blind) folded before Flop
Seat 4: LLregs folded before Flop (didn't bet)
Seat 5: Dance2020 folded before Flop (didn't bet)
Seat 6: FreeTruckerMAN collected ($0.05)

PokerStars Zoom Hand #247960005994:  Hold'em No Limit ($0.01/$0.02) - 2023/12/30 15:26:03 WET [2023/12/30 10:26:03 ET]
Table 'Halley' 6-max Seat #1 is the button
Seat 1: Donnnna ($2.62 in chips)
Seat 2: LLregs ($3.48 in chips)
Seat 3: aricast19 ($4.43 in chips)
Seat 4: BiG whaIe ($2.42 in chips)
Seat 5: ilian1111 ($2.02 in chips)
Seat 6: flipjammer ($2.60 in chips)
LLregs: posts small blind $0.01
aricast19: posts big blind $0.02
*** HOLE CARDS ***
Dealt to LLregs [5d 5s]
BiG whaIe: folds
ilian1111: folds
flipjammer: folds
Donnnna: raises $0.04 to $0.06
LLregs: folds
aricast19: folds
Uncalled bet ($0.04) returned to Donnnna
Donnnna collected $0.05 from pot
Donnnna: doesn't show hand
*** SUMMARY ***
Total pot $0.05 | Rake $0
Seat 1: Donnnna (button) collected ($0.05)
Seat 2: LLregs (small blind) folded before Flop
Seat 3: aricast19 (big blind) folded before Flop
Seat 4: BiG whaIe folded before Flop (didn't bet)
Seat 5: ilian1111 folded before Flop (didn't bet)
Seat 6: flipjammer folded before Flop (didn't bet)

PokerStars Zoom Hand #247960007108:  Hold'em No Limit ($0.01/$0.02) - 2023/12/30 15:26:07 WET [2023/12/30 10:26:07 ET]
Table 'Halley' 6-max Seat #1 is the button
Seat 1: LLregs ($3.47 in chips)
Seat 2: BiG whaIe ($2.42 in chips)
Seat 3: zxczxc9999 ($2.41 in chips)
Seat 4: Delfinnegro2023 ($2.06 in chips)
Seat 5: paulinura ($2.42 in chips)
Seat 6: sharpedo777 ($1.97 in chips)
BiG whaIe: posts small blind $0.01
zxczxc9999: posts big blind $0.02
*** HOLE CARDS ***
Dealt to LLregs [Kc Ts]
Delfinnegro2023: folds
paulinura: folds
sharpedo777: folds
LLregs: raises $0.04 to $0.06
BiG whaIe: folds
zxczxc9999: folds
Uncalled bet ($0.04) returned to LLregs
LLregs collected $0.05 from pot
LLregs: doesn't show hand
*** SUMMARY ***
Total pot $0.05 | Rake $0
Seat 1: LLregs (button) collected ($0.05)
Seat 2: BiG whaIe (small blind) folded before Flop
Seat 3: zxczxc9999 (big blind) folded before Flop
Seat 4: Delfinnegro2023 folded before Flop (didn't bet)
Seat 5: paulinura folded before Flop (didn't bet)
Seat 6: sharpedo777 folded before Flop (didn't bet)

PokerStars Zoom Hand #247960015357:  Hold'em No Limit ($0.01/$0.02) - 2023/12/30 15:26:37 WET [2023/12/30 10:26:37 ET]
Table 'Halley' 6-max Seat #1 is the button
Seat 1: maressen ($2.05 in chips)
Seat 2: IgorFuraZoio ($2.66 in chips)
Seat 3: ilian1111 ($2 in chips)
Seat 4: McFunk78 ($3.07 in chips)
Seat 5: Oplink76 ($1.86 in chips)
Seat 6: LLregs ($3.50 in chips)
IgorFuraZoio: posts small blind $0.01
ilian1111: posts big blind $0.02
*** HOLE CARDS ***
Dealt to LLregs [Kd Kc]
McFunk78: raises $0.02 to $0.04
Oplink76: folds
LLregs: raises $0.10 to $0.14
maressen: folds
IgorFuraZoio: folds
ilian1111: folds
McFunk78: calls $0.10
*** FLOP *** [6h 4d Ah]
McFunk78: bets $0.04
LLregs: calls $0.04
*** TURN *** [6h 4d Ah] [Js]
McFunk78: bets $0.06
LLregs: calls $0.06
*** RIVER *** [6h 4d Ah Js] [Tc]
McFunk78: bets $0.06
LLregs: raises $0.29 to $0.35
McFunk78: calls $0.29
*** SHOW DOWN ***
LLregs: shows [Kd Kc] (a pair of Kings)
McFunk78: shows [Ts Ac] (two pair, Aces and Tens)
McFunk78 collected $1.16 from pot
*** SUMMARY ***
Total pot $1.21 | Rake $0.05
Board [6h 4d Ah Js Tc]
Seat 1: maressen (button) folded before Flop (didn't bet)
Seat 2: IgorFuraZoio (small blind) folded before Flop
Seat 3: ilian1111 (big blind) folded before Flop
Seat 4: McFunk78 showed [Ts Ac] and won ($1.16) with two pair, Aces and Tens
Seat 5: Oplink76 folded before Flop (didn't bet)
Seat 6: LLregs showed [Kd Kc] and lost with a pair of Kings

PokerStars Zoom Hand #247960029292:  Hold'em No Limit ($0.01/$0.02) - 2023/12/30 15:27:28 WET [2023/12/30 10:27:28 ET]
Table 'Halley' 6-max Seat #1 is the button
Seat 1: Oplink76 ($1.82 in chips)
Seat 2: JucyBits ($2.14 in chips)
Seat 3: Josip1119 ($3.20 in chips)
Seat 4: PR3SUR3 ($4.89 in chips)
Seat 5: LLregs ($2.89 in chips)
Seat 6: Jose1234584 ($3.88 in chips)
JucyBits: posts small blind $0.01
Josip1119: posts big blind $0.02
*** HOLE CARDS ***
Dealt to LLregs [Ac 4c]
PR3SUR3: folds
LLregs: folds
Jose1234584: folds
Oplink76: folds
JucyBits: folds
Uncalled bet ($0.01) returned to Josip1119
Josip1119 collected $0.02 from pot
Josip1119: doesn't show hand
*** SUMMARY ***
Total pot $0.02 | Rake $0
Seat 1: Oplink76 (button) folded before Flop (didn't bet)
Seat 2: JucyBits (small blind) folded before Flop
Seat 3: Josip1119 (big blind) collected ($0.02)
Seat 4: PR3SUR3 folded before Flop (didn't bet)
Seat 5: LLregs folded before Flop (didn't bet)
Seat 6: Jose1234584 folded before Flop (didn't bet)

PokerStars Zoom Hand #247960026353:  Hold'em No Limit ($0.01/$0.02) - 2023/12/30 15:27:17 WET [2023/12/30 10:27:17 ET]
Table 'Halley' 6-max Seat #1 is the button
Seat 1: zeroelegante ($9.89 in chips)
Seat 2: Thooorrr ($2.09 in chips)
Seat 3: LLregs ($2.91 in chips)
Seat 4: flipjammer ($1.59 in chips)
Seat 5: FreeTruckerMAN ($1.53 in chips)
Seat 6: 39REDMAN ($1.45 in chips)
Thooorrr: posts small blind $0.01
LLregs: posts big blind $0.02
*** HOLE CARDS ***
Dealt to LLregs [6s 8h]
flipjammer: folds
FreeTruckerMAN: raises $0.02 to $0.04
39REDMAN: folds
zeroelegante: folds
Thooorrr: folds
LLregs: folds
Uncalled bet ($0.02) returned to FreeTruckerMAN
FreeTruckerMAN collected $0.05 from pot
FreeTruckerMAN: doesn't show hand
*** SUMMARY ***
Total pot $0.05 | Rake $0
Seat 1: zeroelegante (button) folded before Flop (didn't bet)
Seat 2: Thooorrr (small blind) folded before Flop
Seat 3: LLregs (big blind) folded before Flop
Seat 4: flipjammer folded before Flop (didn't bet)
Seat 5: FreeTruckerMAN collected ($0.05)
Seat 6: 39REDMAN folded before Flop (didn't bet)

PokerStars Zoom Hand #247960030956:  Hold'em No Limit ($0.01/$0.02) - 2023/12/30 15:27:34 WET [2023/12/30 10:27:34 ET]
Table 'Halley' 6-max Seat #1 is the button
Seat 1: guegui.eds ($0.28 in chips)
Seat 2: AllstarCon ($2 in chips)
Seat 3: Harold_Seven ($1.52 in chips)
Seat 4: edhillm ($3.41 in chips)
Seat 5: k7allinn ($2.38 in chips)
Seat 6: LLregs ($2.89 in chips)
AllstarCon: posts small blind $0.01
Harold_Seven: posts big blind $0.02
*** HOLE CARDS ***
Dealt to LLregs [Ts 5c]
edhillm: folds
k7allinn: folds
LLregs: folds
guegui.eds: raises $0.26 to $0.28 and is all-in
AllstarCon: folds
Harold_Seven: folds
Uncalled bet ($0.26) returned to guegui.eds
guegui.eds collected $0.05 from pot
guegui.eds: doesn't show hand
*** SUMMARY ***
Total pot $0.05 | Rake $0
Seat 1: guegui.eds (button) collected ($0.05)
Seat 2: AllstarCon (small blind) folded before Flop
Seat 3: Harold_Seven (big blind) folded before Flop
Seat 4: edhillm folded before Flop (didn't bet)
Seat 5: k7allinn folded before Flop (didn't bet)
Seat 6: LLregs folded before Flop (didn't bet)

PokerStars Zoom Hand #247960032308:  Hold'em No Limit ($0.01/$0.02) - 2023/12/30 15:27:39 WET [2023/12/30 10:27:39 ET]
Table 'Halley' 6-max Seat #1 is the button
Seat 1: ZiggyBoy90 ($2 in chips)
Seat 2: LLregs ($2.89 in chips)
Seat 3: Shmatrixs ($2 in chips)
Seat 4: therookie1008 ($3.70 in chips)
Seat 5: Arabescul ($2.22 in chips)
Seat 6: chinex_sba ($2.01 in chips)
LLregs: posts small blind $0.01
Shmatrixs: posts big blind $0.02
*** HOLE CARDS ***
Dealt to LLregs [Tc 2h]
therookie1008: calls $0.02
Arabescul: folds
chinex_sba: raises $0.17 to $0.19
ZiggyBoy90: folds
LLregs: folds
Shmatrixs: folds
therookie1008: folds
Uncalled bet ($0.17) returned to chinex_sba
chinex_sba collected $0.07 from pot
chinex_sba: doesn't show hand
*** SUMMARY ***
Total pot $0.07 | Rake $0
Seat 1: ZiggyBoy90 (button) folded before Flop (didn't bet)
Seat 2: LLregs (small blind) folded before Flop
Seat 3: Shmatrixs (big blind) folded before Flop
Seat 4: therookie1008 folded before Flop
Seat 5: Arabescul folded before Flop (didn't bet)
Seat 6: chinex_sba collected ($0.07)

PokerStars Zoom Hand #247960038741:  Hold'em No Limit ($0.01/$0.02) - 2023/12/30 15:28:02 WET [2023/12/30 10:28:02 ET]
Table 'Halley' 6-max Seat #1 is the button
Seat 1: sharpedo777 ($1.94 in chips)
Seat 2: WolveroX ($3.54 in chips)
Seat 3: FEROIZ ($2.42 in chips)
Seat 4: Harold_Seven ($6.29 in chips)
Seat 5: LLregs ($2.88 in chips)
Seat 6: Sanavioga ($1.49 in chips)
WolveroX: posts small blind $0.01
FEROIZ: posts big blind $0.02
*** HOLE CARDS ***
Dealt to LLregs [Kh 3c]
Harold_Seven: folds
LLregs: folds
Sanavioga: folds
sharpedo777: folds
WolveroX: raises $0.02 to $0.04
FEROIZ: folds
Uncalled bet ($0.02) returned to WolveroX
WolveroX collected $0.04 from pot
WolveroX: doesn't show hand
*** SUMMARY ***
Total pot $0.04 | Rake $0
Seat 1: sharpedo777 (button) folded before Flop (didn't bet)
Seat 2: WolveroX (small blind) collected ($0.04)
Seat 3: FEROIZ (big blind) folded before Flop
Seat 4: Harold_Seven folded before Flop (didn't bet)
Seat 5: LLregs folded before Flop (didn't bet)
Seat 6: Sanavioga folded before Flop (didn't bet)

PokerStars Zoom Hand #247960043009:  Hold'em No Limit ($0.01/$0.02) - 2023/12/30 15:28:18 WET [2023/12/30 10:28:18 ET]
Table 'Halley' 6-max Seat #1 is the button
Seat 1: LLregs ($2.88 in chips)
Seat 2: PR3SUR3 ($4.99 in chips)
Seat 3: flipjammer ($1.52 in chips)
Seat 4: ilian1111 ($2.16 in chips)
Seat 5: snapdrago241 ($0.35 in chips)
Seat 6: Na shpilyu ($2.49 in chips)
PR3SUR3: posts small blind $0.01
flipjammer: posts big blind $0.02
*** HOLE CARDS ***
Dealt to LLregs [7s 5c]
ilian1111: folds
snapdrago241: folds
Na shpilyu: folds
LLregs: folds
PR3SUR3: folds
Uncalled bet ($0.01) returned to flipjammer
flipjammer collected $0.02 from pot
flipjammer: doesn't show hand
*** SUMMARY ***
Total pot $0.02 | Rake $0
Seat 1: LLregs (button) folded before Flop (didn't bet)
Seat 2: PR3SUR3 (small blind) folded before Flop
Seat 3: flipjammer (big blind) collected ($0.02)
Seat 4: ilian1111 folded before Flop (didn't bet)
Seat 5: snapdrago241 folded before Flop (didn't bet)
Seat 6: Na shpilyu folded before Flop (didn't bet)

PokerStars Zoom Hand #247960046615:  Hold'em No Limit ($0.01/$0.02) - 2023/12/30 15:28:31 WET [2023/12/30 10:28:31 ET]
Table 'Halley' 6-max Seat #1 is the button
Seat 1: Jandrey Mello ($1.92 in chips)
Seat 2: Dexter9922 ($2 in chips)
Seat 3: maressen ($2.11 in chips)
Seat 4: ZWEZDA126 ($2.21 in chips)
Seat 5: vitalikto ($2.14 in chips)
Seat 6: LLregs ($2.88 in chips)
Dexter9922: posts small blind $0.01
maressen: posts big blind $0.02
*** HOLE CARDS ***
Dealt to LLregs [9c 9d]
ZWEZDA126 is disconnected
ZWEZDA126 has timed out while disconnected
ZWEZDA126: folds
vitalikto: folds
LLregs: raises $0.04 to $0.06
Jandrey Mello: folds
Dexter9922: folds
maressen: calls $0.04
*** FLOP *** [9s 6s Ks]
maressen: checks
LLregs: bets $0.04
maressen: folds
Uncalled bet ($0.04) returned to LLregs
LLregs collected $0.13 from pot
LLregs: doesn't show hand
*** SUMMARY ***
Total pot $0.13 | Rake $0
Board [9s 6s Ks]
Seat 1: Jandrey Mello (button) folded before Flop (didn't bet)
Seat 2: Dexter9922 (small blind) folded before Flop
Seat 3: maressen (big blind) folded on the Flop
Seat 4: ZWEZDA126 folded before Flop (didn't bet)
Seat 5: vitalikto folded before Flop (didn't bet)
Seat 6: LLregs collected ($0.13)

PokerStars Zoom Hand #247960064897:  Hold'em No Limit ($0.01/$0.02) - 2023/12/30 15:29:38 WET [2023/12/30 10:29:38 ET]
Table 'Halley' 6-max Seat #1 is the button
Seat 1: DonVasileeee ($2.04 in chips)
Seat 2: psdgr3 ($2.05 in chips)
Seat 3: LLregs ($2.95 in chips)
Seat 4: TPB_088_PONG ($2 in chips)
Seat 5: dsousAA ($2.18 in chips)
Seat 6: JucyBits ($4.37 in chips)
psdgr3: posts small blind $0.01
LLregs: posts big blind $0.02
*** HOLE CARDS ***
Dealt to LLregs [Qd Ts]
TPB_088_PONG: folds
dsousAA: folds
JucyBits: folds
DonVasileeee: folds
psdgr3: raises $0.02 to $0.04
LLregs: raises $0.08 to $0.12
psdgr3: folds
Uncalled bet ($0.08) returned to LLregs
LLregs collected $0.08 from pot
LLregs: doesn't show hand
*** SUMMARY ***
Total pot $0.08 | Rake $0
Seat 1: DonVasileeee (button) folded before Flop (didn't bet)
Seat 2: psdgr3 (small blind) folded before Flop
Seat 3: LLregs (big blind) collected ($0.08)
Seat 4: TPB_088_PONG folded before Flop (didn't bet)
Seat 5: dsousAA folded before Flop (didn't bet)
Seat 6: JucyBits folded before Flop (didn't bet)

PokerStars Zoom Hand #247960069827:  Hold'em No Limit ($0.01/$0.02) - 2023/12/30 15:29:57 WET [2023/12/30 10:29:57 ET]
Table 'Halley' 6-max Seat #1 is the button
Seat 1: LLregs ($2.99 in chips)
Seat 2: AAAApeter ($1.39 in chips)
Seat 3: C2DFMNLH ($3.64 in chips)
Seat 4: Dexter9922 ($2 in chips)
Seat 5: kaaaaw ($5.44 in chips)
Seat 6: dersor111 ($1.94 in chips)
AAAApeter: posts small blind $0.01
C2DFMNLH: posts big blind $0.02
*** HOLE CARDS ***
Dealt to LLregs [2c 3s]
Dexter9922: raises $0.02 to $0.04
kaaaaw: folds
dersor111: folds
LLregs: folds
AAAApeter: folds
C2DFMNLH: folds
Uncalled bet ($0.02) returned to Dexter9922
Dexter9922 collected $0.05 from pot
Dexter9922: doesn't show hand
*** SUMMARY ***
Total pot $0.05 | Rake $0
Seat 1: LLregs (button) folded before Flop (didn't bet)
Seat 2: AAAApeter (small blind) folded before Flop
Seat 3: C2DFMNLH (big blind) folded before Flop
Seat 4: Dexter9922 collected ($0.05)
Seat 5: kaaaaw folded before Flop (didn't bet)
Seat 6: dersor111 folded before Flop (didn't bet)

PokerStars Zoom Hand #247960070730:  Hold'em No Limit ($0.01/$0.02) - 2023/12/30 15:30:00 WET [2023/12/30 10:30:00 ET]
Table 'Halley' 6-max Seat #1 is the button
Seat 1: Thooorrr ($2.15 in chips)
Seat 2: LLregs ($2.99 in chips)
Seat 3: podrevnik2 ($4.06 in chips)
Seat 4: One Day Big Win ($1.62 in chips)
Seat 5: High Fumph ($2.16 in chips)
Seat 6: Arabescul ($2.30 in chips)
LLregs: posts small blind $0.01
podrevnik2: posts big blind $0.02
*** HOLE CARDS ***
Dealt to LLregs [Td 2h]
One Day Big Win: folds
High Fumph: folds
Arabescul: folds
Thooorrr: folds
LLregs: folds
Uncalled bet ($0.01) returned to podrevnik2
podrevnik2 collected $0.02 from pot
podrevnik2: doesn't show hand
*** SUMMARY ***
Total pot $0.02 | Rake $0
Seat 1: Thooorrr (button) folded before Flop (didn't bet)
Seat 2: LLregs (small blind) folded before Flop
Seat 3: podrevnik2 (big blind) collected ($0.02)
Seat 4: One Day Big Win folded before Flop (didn't bet)
Seat 5: High Fumph folded before Flop (didn't bet)
Seat 6: Arabescul folded before Flop (didn't bet)

PokerStars Zoom Hand #247960072021:  Hold'em No Limit ($0.01/$0.02) - 2023/12/30 15:30:04 WET [2023/12/30 10:30:04 ET]
Table 'Halley' 6-max Seat #1 is the button
Seat 1: piccolino25 ($1.95 in chips)
Seat 2: paulinura ($1.76 in chips)
Seat 3: chinex_sba ($2 in chips)
Seat 4: PovilasX ($2.56 in chips)
Seat 5: LLregs ($2.98 in chips)
Seat 6: avilaC73 ($2.96 in chips)
paulinura: posts small blind $0.01
chinex_sba: posts big blind $0.02
*** HOLE CARDS ***
Dealt to LLregs [6c 4d]
PovilasX: folds
LLregs: folds
avilaC73: folds
piccolino25: folds
paulinura: folds
Uncalled bet ($0.01) returned to chinex_sba
chinex_sba collected $0.02 from pot
chinex_sba: doesn't show hand
*** SUMMARY ***
Total pot $0.02 | Rake $0
Seat 1: piccolino25 (button) folded before Flop (didn't bet)
Seat 2: paulinura (small blind) folded before Flop
Seat 3: chinex_sba (big blind) collected ($0.02)
Seat 4: PovilasX folded before Flop (didn't bet)
Seat 5: LLregs folded before Flop (didn't bet)
Seat 6: avilaC73 folded before Flop (didn't bet)

PokerStars Zoom Hand #247960073095:  Hold'em No Limit ($0.01/$0.02) - 2023/12/30 15:30:07 WET [2023/12/30 10:30:07 ET]
Table 'Halley' 6-max Seat #1 is the button
Seat 1: japob ($2 in chips)
Seat 2: MXLVI ($2.06 in chips)
Seat 3: Pedrowilso ($1.78 in chips)
Seat 4: SerberStepan ($3.32 in chips)
Seat 5: laoban888 ($2.70 in chips)
Seat 6: LLregs ($2.98 in chips)
MXLVI: posts small blind $0.01
Pedrowilso: posts big blind $0.02
*** HOLE CARDS ***
Dealt to LLregs [5c 3d]
SerberStepan: folds
laoban888: folds
LLregs: folds
japob: folds
MXLVI: folds
Uncalled bet ($0.01) returned to Pedrowilso
Pedrowilso collected $0.02 from pot
Pedrowilso: doesn't show hand
*** SUMMARY ***
Total pot $0.02 | Rake $0
Seat 1: japob (button) folded before Flop (didn't bet)
Seat 2: MXLVI (small blind) folded before Flop
Seat 3: Pedrowilso (big blind) collected ($0.02)
Seat 4: SerberStepan folded before Flop (didn't bet)
Seat 5: laoban888 folded before Flop (didn't bet)
Seat 6: LLregs folded before Flop (didn't bet)

PokerStars Zoom Hand #247960074484:  Hold'em No Limit ($0.01/$0.02) - 2023/12/30 15:30:13 WET [2023/12/30 10:30:13 ET]
Table 'Halley' 6-max Seat #1 is the button
Seat 1: Nutu1313 ($2 in chips)
Seat 2: edhillm ($2.37 in chips)
Seat 3: LLregs ($2.98 in chips)
Seat 4: VIDOPRO23 ($4.61 in chips)
Seat 5: maressen ($2.85 in chips)
Seat 6: Delfinnegro2023 ($2.48 in chips)
edhillm: posts small blind $0.01
LLregs: posts big blind $0.02
*** HOLE CARDS ***
Dealt to LLregs [Kh Qd]
VIDOPRO23: folds
maressen: folds
Delfinnegro2023: folds
Nutu1313: folds
edhillm: folds
Uncalled bet ($0.01) returned to LLregs
LLregs collected $0.02 from pot
LLregs: doesn't show hand
*** SUMMARY ***
Total pot $0.02 | Rake $0
Seat 1: Nutu1313 (button) folded before Flop (didn't bet)
Seat 2: edhillm (small blind) folded before Flop
Seat 3: LLregs (big blind) collected ($0.02)
Seat 4: VIDOPRO23 folded before Flop (didn't bet)
Seat 5: maressen folded before Flop (didn't bet)
Seat 6: Delfinnegro2023 folded before Flop (didn't bet)

PokerStars Zoom Hand #247960077229:  Hold'em No Limit ($0.01/$0.02) - 2023/12/30 15:30:23 WET [2023/12/30 10:30:23 ET]
Table 'Halley' 6-max Seat #1 is the button
Seat 1: One Day Big Win ($1.62 in chips)
Seat 2: Jhon Rambo.CL ($2.28 in chips)
Seat 3: Johnstefk ($2 in chips)
Seat 4: LLregs ($2.99 in chips)
Seat 5: Mikeloko182 ($2 in chips)
Seat 6: rafds765 ($6.32 in chips)
Jhon Rambo.CL: posts small blind $0.01
Johnstefk: posts big blind $0.02
*** HOLE CARDS ***
Dealt to LLregs [2d Jc]
LLregs: folds
Mikeloko182: folds
rafds765: folds
One Day Big Win: folds
Jhon Rambo.CL: folds
Uncalled bet ($0.01) returned to Johnstefk
Johnstefk collected $0.02 from pot
Johnstefk: doesn't show hand
*** SUMMARY ***
Total pot $0.02 | Rake $0
Seat 1: One Day Big Win (button) folded before Flop (didn't bet)
Seat 2: Jhon Rambo.CL (small blind) folded before Flop
Seat 3: Johnstefk (big blind) collected ($0.02)
Seat 4: LLregs folded before Flop (didn't bet)
Seat 5: Mikeloko182 folded before Flop (didn't bet)
Seat 6: rafds765 folded before Flop (didn't bet)

PokerStars Zoom Hand #247960078351:  Hold'em No Limit ($0.01/$0.02) - 2023/12/30 15:30:27 WET [2023/12/30 10:30:27 ET]
Table 'Halley' 6-max Seat #1 is the button
Seat 1: Waschbär1984 ($1.26 in chips)
Seat 2: PovilasX ($3.12 in chips)
Seat 3: frankquanki ($1.20 in chips)
Seat 4: LLregs ($2.99 in chips)
Seat 5: karprinic ($0.92 in chips)
Seat 6: One Day Big Win ($1.62 in chips)
PovilasX: posts small blind $0.01
frankquanki: posts big blind $0.02
*** HOLE CARDS ***
Dealt to LLregs [Kh 3s]
LLregs: folds
karprinic: folds
One Day Big Win: folds
Waschbär1984: folds
PovilasX: raises $0.03 to $0.05
frankquanki: raises $0.10 to $0.15
PovilasX: folds
Uncalled bet ($0.10) returned to frankquanki
frankquanki collected $0.10 from pot
frankquanki: doesn't show hand
*** SUMMARY ***
Total pot $0.10 | Rake $0
Seat 1: Waschbär1984 (button) folded before Flop (didn't bet)
Seat 2: PovilasX (small blind) folded before Flop
Seat 3: frankquanki (big blind) collected ($0.10)
Seat 4: LLregs folded before Flop (didn't bet)
Seat 5: karprinic folded before Flop (didn't bet)
Seat 6: One Day Big Win folded before Flop (didn't bet)

PokerStars Zoom Hand #247960079982:  Hold'em No Limit ($0.01/$0.02) - 2023/12/30 15:30:33 WET [2023/12/30 10:30:33 ET]
Table 'Halley' 6-max Seat #1 is the button
Seat 1: Nutu1313 ($3.65 in chips)
Seat 2: LLregs ($2.99 in chips)
Seat 3: dsousAA ($2.20 in chips)
Seat 4: PR3SUR3 ($4.78 in chips)
Seat 5: k7allinn ($2.74 in chips)
Seat 6: Anthony2027 ($3.43 in chips)
LLregs: posts small blind $0.01
dsousAA: posts big blind $0.02
*** HOLE CARDS ***
Dealt to LLregs [Qd 9s]
PR3SUR3: folds
k7allinn: folds
Anthony2027: raises $0.02 to $0.04
Nutu1313: calls $0.04
LLregs: folds
dsousAA: raises $0.16 to $0.20
Anthony2027: calls $0.16
Nutu1313: folds
*** FLOP *** [Kc 8d Th]
dsousAA: bets $0.20
Anthony2027: folds
Uncalled bet ($0.20) returned to dsousAA
dsousAA collected $0.43 from pot
dsousAA: doesn't show hand
*** SUMMARY ***
Total pot $0.45 | Rake $0.02
Board [Kc 8d Th]
Seat 1: Nutu1313 (button) folded before Flop
Seat 2: LLregs (small blind) folded before Flop
Seat 3: dsousAA (big blind) collected ($0.43)
Seat 4: PR3SUR3 folded before Flop (didn't bet)
Seat 5: k7allinn folded before Flop (didn't bet)
Seat 6: Anthony2027 folded on the Flop

PokerStars Zoom Hand #247960082783:  Hold'em No Limit ($0.01/$0.02) - 2023/12/30 15:30:43 WET [2023/12/30 10:30:43 ET]
Table 'Halley' 6-max Seat #1 is the button
Seat 1: LLregs ($2.98 in chips)
Seat 2: Tutunn ($2.53 in chips)
Seat 3: snapdrago241 ($0.74 in chips)
Seat 4: sverduu ($1.09 in chips)
Seat 5: FEROIZ ($2.83 in chips)
Seat 6: Antoine5112 ($1.79 in chips)
Tutunn: posts small blind $0.01
snapdrago241: posts big blind $0.02
*** HOLE CARDS ***
Dealt to LLregs [Ks 8s]
sverduu: folds
FEROIZ: folds
Antoine5112: calls $0.02
LLregs: calls $0.02
Tutunn: folds
snapdrago241: checks
*** FLOP *** [Js 6d Kh]
snapdrago241: checks
Antoine5112: checks
LLregs: bets $0.02
snapdrago241: calls $0.02
Antoine5112: calls $0.02
*** TURN *** [Js 6d Kh] [8d]
snapdrago241: checks
Antoine5112: checks
LLregs: bets $0.03
snapdrago241: calls $0.03
Antoine5112: calls $0.03
*** RIVER *** [Js 6d Kh 8d] [Qc]
snapdrago241: checks
Antoine5112: checks
LLregs: bets $0.10
snapdrago241: folds
Antoine5112: folds
Uncalled bet ($0.10) returned to LLregs
LLregs collected $0.21 from pot
LLregs: doesn't show hand
*** SUMMARY ***
Total pot $0.22 | Rake $0.01
Board [Js 6d Kh 8d Qc]
Seat 1: LLregs (button) collected ($0.21)
Seat 2: Tutunn (small blind) folded before Flop
Seat 3: snapdrago241 (big blind) folded on the River
Seat 4: sverduu folded before Flop (didn't bet)
Seat 5: FEROIZ folded before Flop (didn't bet)
Seat 6: Antoine5112 folded on the River

PokerStars Zoom Hand #247960099865:  Hold'em No Limit ($0.01/$0.02) - 2023/12/30 15:31:45 WET [2023/12/30 10:31:45 ET]
Table 'Halley' 6-max Seat #1 is the button
Seat 1: k7allinn ($2.82 in chips)
Seat 2: Angel2480 ($2.22 in chips)
Seat 3: theprince188 ($6.97 in chips)
Seat 4: LLregs ($3.12 in chips)
Seat 5: frankquanki ($1.03 in chips)
Seat 6: despot17 ($2.51 in chips)
Angel2480: posts small blind $0.01
theprince188: posts big blind $0.02
*** HOLE CARDS ***
Dealt to LLregs [6c 4h]
LLregs: folds
frankquanki: folds
despot17: folds
k7allinn: folds
Angel2480: calls $0.01
theprince188: checks
*** FLOP *** [As Js 7h]
Angel2480: bets $0.03
theprince188: folds
Uncalled bet ($0.03) returned to Angel2480
Angel2480 collected $0.04 from pot
Angel2480: doesn't show hand
*** SUMMARY ***
Total pot $0.04 | Rake $0
Board [As Js 7h]
Seat 1: k7allinn (button) folded before Flop (didn't bet)
Seat 2: Angel2480 (small blind) collected ($0.04)
Seat 3: theprince188 (big blind) folded on the Flop
Seat 4: LLregs folded before Flop (didn't bet)
Seat 5: frankquanki folded before Flop (didn't bet)
Seat 6: despot17 folded before Flop (didn't bet)

PokerStars Zoom Hand #247960101864:  Hold'em No Limit ($0.01/$0.02) - 2023/12/30 15:31:52 WET [2023/12/30 10:31:52 ET]
Table 'Halley' 6-max Seat #1 is the button
Seat 1: DKD34 ($2.25 in chips)
Seat 2: Akgül84 ($1 in chips)
Seat 3: maressen ($2 in chips)
Seat 4: fa1kon ($2.17 in chips)
Seat 5: LLregs ($3.12 in chips)
Seat 6: cawi1963 ($2.46 in chips)
Akgül84: posts small blind $0.01
maressen: posts big blind $0.02
*** HOLE CARDS ***
Dealt to LLregs [5d 8s]
fa1kon: raises $0.06 to $0.08
LLregs: folds
cawi1963: folds
DKD34: folds
Akgül84: folds
maressen: folds
Uncalled bet ($0.06) returned to fa1kon
fa1kon collected $0.05 from pot
fa1kon: doesn't show hand
*** SUMMARY ***
Total pot $0.05 | Rake $0
Seat 1: DKD34 (button) folded before Flop (didn't bet)
Seat 2: Akgül84 (small blind) folded before Flop
Seat 3: maressen (big blind) folded before Flop
Seat 4: fa1kon collected ($0.05)
Seat 5: LLregs folded before Flop (didn't bet)
Seat 6: cawi1963 folded before Flop (didn't bet)

PokerStars Zoom Hand #247960103229:  Hold'em No Limit ($0.01/$0.02) - 2023/12/30 15:31:57 WET [2023/12/30 10:31:57 ET]
Table 'Halley' 6-max Seat #1 is the button
Seat 1: WEBOO1 ($6.79 in chips)
Seat 2: HeartOfGold ($0.78 in chips)
Seat 3: LLregs ($3.12 in chips)
Seat 4: Akgül84 ($0.99 in chips)
Seat 5: Shmatrixs ($7.62 in chips)
Seat 6: sexynurseama ($2 in chips)
HeartOfGold: posts small blind $0.01
LLregs: posts big blind $0.02
*** HOLE CARDS ***
Dealt to LLregs [7s 5d]
Akgül84: folds
Shmatrixs: folds
sexynurseama: folds
WEBOO1: folds
HeartOfGold: raises $0.04 to $0.06
LLregs: folds
Uncalled bet ($0.04) returned to HeartOfGold
HeartOfGold collected $0.04 from pot
HeartOfGold: doesn't show hand
*** SUMMARY ***
Total pot $0.04 | Rake $0
Seat 1: WEBOO1 (button) folded before Flop (didn't bet)
Seat 2: HeartOfGold (small blind) collected ($0.04)
Seat 3: LLregs (big blind) folded before Flop
Seat 4: Akgül84 folded before Flop (didn't bet)
Seat 5: Shmatrixs folded before Flop (didn't bet)
Seat 6: sexynurseama folded before Flop (didn't bet)

PokerStars Zoom Hand #247960108761:  Hold'em No Limit ($0.01/$0.02) - 2023/12/30 15:32:17 WET [2023/12/30 10:32:17 ET]
Table 'Halley' 6-max Seat #1 is the button
Seat 1: Angel2480 ($2.22 in chips)
Seat 2: LLregs ($3.10 in chips)
Seat 3: nadd399 ($2 in chips)
Seat 4: FERNANDO R01997 ($2.51 in chips)
Seat 5: sverduu ($1.14 in chips)
Seat 6: avilaC73 ($1.94 in chips)
LLregs: posts small blind $0.01
nadd399: posts big blind $0.02
*** HOLE CARDS ***
Dealt to LLregs [9c 8s]
FERNANDO R01997: folds
sverduu: folds
avilaC73: folds
Angel2480: folds
LLregs: raises $0.04 to $0.06
nadd399: calls $0.04
*** FLOP *** [3c 9d 3d]
LLregs: bets $0.06
nadd399: folds
Uncalled bet ($0.06) returned to LLregs
LLregs collected $0.12 from pot
LLregs: doesn't show hand
*** SUMMARY ***
Total pot $0.12 | Rake $0
Board [3c 9d 3d]
Seat 1: Angel2480 (button) folded before Flop (didn't bet)
Seat 2: LLregs (small blind) collected ($0.12)
Seat 3: nadd399 (big blind) folded on the Flop
Seat 4: FERNANDO R01997 folded before Flop (didn't bet)
Seat 5: sverduu folded before Flop (didn't bet)
Seat 6: avilaC73 folded before Flop (didn't bet)

PokerStars Zoom Hand #247960107670:  Hold'em No Limit ($0.01/$0.02) - 2023/12/30 15:32:13 WET [2023/12/30 10:32:13 ET]
Table 'Halley' 6-max Seat #1 is the button
Seat 1: vitalikto ($2.26 in chips)
Seat 2: popparallo ($2.15 in chips)
Seat 3: sharpedo777 ($2.12 in chips)
Seat 4: LLregs ($3.10 in chips)
Seat 5: ivciks74lv ($4.88 in chips)
Seat 6: DonVasileeee ($2 in chips)
popparallo: posts small blind $0.01
sharpedo777: posts big blind $0.02
*** HOLE CARDS ***
Dealt to LLregs [Kd 6d]
LLregs: folds
ivciks74lv: calls $0.02
DonVasileeee: folds
vitalikto: folds
popparallo: folds
sharpedo777: checks
*** FLOP *** [Tc 2s 3d]
sharpedo777: checks
ivciks74lv: checks
*** TURN *** [Tc 2s 3d] [Jc]
sharpedo777: bets $0.03
ivciks74lv: calls $0.03
*** RIVER *** [Tc 2s 3d Jc] [9c]
sharpedo777: checks
ivciks74lv: checks
*** SHOW DOWN ***
sharpedo777: shows [7s 8s] (a straight, Seven to Jack)
ivciks74lv: mucks hand
sharpedo777 collected $0.11 from pot
*** SUMMARY ***
Total pot $0.11 | Rake $0
Board [Tc 2s 3d Jc 9c]
Seat 1: vitalikto (button) folded before Flop (didn't bet)
Seat 2: popparallo (small blind) folded before Flop
Seat 3: sharpedo777 (big blind) showed [7s 8s] and won ($0.11) with a straight, Seven to Jack
Seat 4: LLregs folded before Flop (didn't bet)
Seat 5: ivciks74lv mucked [9h Qh]
Seat 6: DonVasileeee folded before Flop (didn't bet)

PokerStars Zoom Hand #247960116738:  Hold'em No Limit ($0.01/$0.02) - 2023/12/30 15:32:46 WET [2023/12/30 10:32:46 ET]
Table 'Halley' 6-max Seat #1 is the button
Seat 1: LLregs ($3.16 in chips)
Seat 2: PovilasX ($2.57 in chips)
Seat 3: MXLVI ($2 in chips)
Seat 4: ducks4quads ($3.21 in chips)
Seat 5: chinex_sba ($2.01 in chips)
Seat 6: One Day Big Win ($1.74 in chips)
PovilasX: posts small blind $0.01
MXLVI: posts big blind $0.02
*** HOLE CARDS ***
Dealt to LLregs [8c Jd]
ducks4quads: raises $0.04 to $0.06
chinex_sba: folds
One Day Big Win: folds
LLregs: folds
PovilasX: folds
MXLVI: folds
Uncalled bet ($0.04) returned to ducks4quads
ducks4quads collected $0.05 from pot
ducks4quads: doesn't show hand
*** SUMMARY ***
Total pot $0.05 | Rake $0
Seat 1: LLregs (button) folded before Flop (didn't bet)
Seat 2: PovilasX (small blind) folded before Flop
Seat 3: MXLVI (big blind) folded before Flop
Seat 4: ducks4quads collected ($0.05)
Seat 5: chinex_sba folded before Flop (didn't bet)
Seat 6: One Day Big Win folded before Flop (didn't bet)

PokerStars Zoom Hand #247960118943:  Hold'em No Limit ($0.01/$0.02) - 2023/12/30 15:32:53 WET [2023/12/30 10:32:53 ET]
Table 'Halley' 6-max Seat #1 is the button
Seat 1: jameshutch00 ($2.46 in chips)
Seat 2: Mikeloko182 ($2.19 in chips)
Seat 3: LLregs ($3.16 in chips)
Seat 4: ungiwar ($1.28 in chips)
Seat 5: bartovskii ($5.36 in chips)
Seat 6: zxczxc9999 ($1.80 in chips)
Mikeloko182: posts small blind $0.01
LLregs: posts big blind $0.02
*** HOLE CARDS ***
Dealt to LLregs [Qs 3c]
ungiwar: folds
bartovskii: folds
zxczxc9999: raises $0.03 to $0.05
jameshutch00: folds
Mikeloko182: calls $0.04
LLregs: folds
*** FLOP *** [Kd 8h 7s]
Mikeloko182: checks
zxczxc9999: bets $0.04
Mikeloko182: folds
Uncalled bet ($0.04) returned to zxczxc9999
zxczxc9999 collected $0.12 from pot
zxczxc9999: doesn't show hand
*** SUMMARY ***
Total pot $0.12 | Rake $0
Board [Kd 8h 7s]
Seat 1: jameshutch00 (button) folded before Flop (didn't bet)
Seat 2: Mikeloko182 (small blind) folded on the Flop
Seat 3: LLregs (big blind) folded before Flop
Seat 4: ungiwar folded before Flop (didn't bet)
Seat 5: bartovskii folded before Flop (didn't bet)
Seat 6: zxczxc9999 collected ($0.12)

PokerStars Zoom Hand #247960106830:  Hold'em No Limit ($0.01/$0.02) - 2023/12/30 15:32:10 WET [2023/12/30 10:32:10 ET]
Table 'Halley' 6-max Seat #1 is the button
Seat 1: Harold_Seven ($6.38 in chips)
Seat 2: Anthony2027 ($3.21 in chips)
Seat 3: Antoine5112 ($1.72 in chips)
Seat 4: Mamirox ($2.53 in chips)
Seat 5: Jhon Rambo.CL ($2.30 in chips)
Seat 6: LLregs ($3.10 in chips)
Anthony2027: posts small blind $0.01
Antoine5112: posts big blind $0.02
*** HOLE CARDS ***
Dealt to LLregs [6c 8h]
Mamirox: folds
Jhon Rambo.CL: raises $0.03 to $0.05
LLregs: folds
Harold_Seven: folds
Anthony2027: calls $0.04
Antoine5112: calls $0.03
*** FLOP *** [5d 7c 4d]
Anthony2027: checks
Antoine5112: bets $0.14
Jhon Rambo.CL: raises $0.29 to $0.43
Anthony2027: folds
Antoine5112: calls $0.29
*** TURN *** [5d 7c 4d] [3c]
Antoine5112: checks
Jhon Rambo.CL: bets $1.82 and is all-in
Antoine5112: calls $1.24 and is all-in
Uncalled bet ($0.58) returned to Jhon Rambo.CL
*** RIVER *** [5d 7c 4d 3c] [4s]
*** SHOW DOWN ***
Antoine5112: shows [3d 7d] (two pair, Sevens and Fours)
Jhon Rambo.CL: shows [7h 7s] (a full house, Sevens full of Fours)
Jhon Rambo.CL collected $3.37 from pot
*** SUMMARY ***
Total pot $3.49 | Rake $0.12
Board [5d 7c 4d 3c 4s]
Seat 1: Harold_Seven (button) folded before Flop (didn't bet)
Seat 2: Anthony2027 (small blind) folded on the Flop
Seat 3: Antoine5112 (big blind) showed [3d 7d] and lost with two pair, Sevens and Fours
Seat 4: Mamirox folded before Flop (didn't bet)
Seat 5: Jhon Rambo.CL showed [7h 7s] and won ($3.37) with a full house, Sevens full of Fours
Seat 6: LLregs folded before Flop (didn't bet)

PokerStars Zoom Hand #247960117809:  Hold'em No Limit ($0.01/$0.02) - 2023/12/30 15:32:49 WET [2023/12/30 10:32:49 ET]
Table 'Halley' 6-max Seat #1 is the button
Seat 1: C2DFMNLH ($1.86 in chips)
Seat 2: ilian1111 ($2.54 in chips)
Seat 3: obsidian5665 ($2.03 in chips)
Seat 4: LLregs ($3.16 in chips)
Seat 5: nikkem971 ($4.05 in chips)
Seat 6: SerberStepan ($3.30 in chips)
ilian1111: posts small blind $0.01
obsidian5665: posts big blind $0.02
*** HOLE CARDS ***
Dealt to LLregs [Qs 8c]
LLregs: folds
nikkem971: raises $0.03 to $0.05
SerberStepan: calls $0.05
C2DFMNLH: folds
ilian1111: folds
obsidian5665: folds
*** FLOP *** [5d 9d Jd]
nikkem971: bets $0.07
SerberStepan: folds
Uncalled bet ($0.07) returned to nikkem971
nikkem971 collected $0.13 from pot
nikkem971: doesn't show hand
*** SUMMARY ***
Total pot $0.13 | Rake $0
Board [5d 9d Jd]
Seat 1: C2DFMNLH (button) folded before Flop (didn't bet)
Seat 2: ilian1111 (small blind) folded before Flop
Seat 3: obsidian5665 (big blind) folded before Flop
Seat 4: LLregs folded before Flop (didn't bet)
Seat 5: nikkem971 collected ($0.13)
Seat 6: SerberStepan folded on the Flop

PokerStars Zoom Hand #247960254938:  Hold'em No Limit ($0.01/$0.02) - 2023/12/30 15:40:53 WET [2023/12/30 10:40:53 ET]
Table 'Halley' 6-max Seat #1 is the button
Seat 1: ilian1111 ($1.93 in chips)
Seat 2: PR3SUR3 ($6.81 in chips)
Seat 3: LeDim0s ($3.65 in chips)
Seat 4: Sperick ($4.83 in chips)
Seat 5: Harold_Seven ($2.53 in chips)
Seat 6: LLregs ($3.14 in chips)
PR3SUR3: posts small blind $0.01
LeDim0s: posts big blind $0.02
*** HOLE CARDS ***
Dealt to LLregs [Jd 7s]
Sperick: folds
Harold_Seven: folds
LLregs: folds
ilian1111: folds
PR3SUR3: folds
Uncalled bet ($0.01) returned to LeDim0s
LeDim0s collected $0.02 from pot
LeDim0s: doesn't show hand
*** SUMMARY ***
Total pot $0.02 | Rake $0
Seat 1: ilian1111 (button) folded before Flop (didn't bet)
Seat 2: PR3SUR3 (small blind) folded before Flop
Seat 3: LeDim0s (big blind) collected ($0.02)
Seat 4: Sperick folded before Flop (didn't bet)
Seat 5: Harold_Seven folded before Flop (didn't bet)
Seat 6: LLregs folded before Flop (didn't bet)

PokerStars Zoom Hand #247960256010:  Hold'em No Limit ($0.01/$0.02) - 2023/12/30 15:40:57 WET [2023/12/30 10:40:57 ET]
Table 'Halley' 6-max Seat #1 is the button
Seat 1: nerijus3000 ($4.23 in chips)
Seat 2: Thooorrr ($2.76 in chips)
Seat 3: PovilasX ($2.39 in chips)
Seat 4: nadd399 ($2.17 in chips)
Seat 5: LLregs ($3.14 in chips)
Seat 6: avilaC73 ($2.53 in chips)
Thooorrr: posts small blind $0.01
PovilasX: posts big blind $0.02
*** HOLE CARDS ***
Dealt to LLregs [5d 8d]
nadd399: folds
LLregs: folds
avilaC73: raises $0.04 to $0.06
nerijus3000: folds
Thooorrr: folds
PovilasX: folds
Uncalled bet ($0.04) returned to avilaC73
avilaC73 collected $0.05 from pot
avilaC73: doesn't show hand
*** SUMMARY ***
Total pot $0.05 | Rake $0
Seat 1: nerijus3000 (button) folded before Flop (didn't bet)
Seat 2: Thooorrr (small blind) folded before Flop
Seat 3: PovilasX (big blind) folded before Flop
Seat 4: nadd399 folded before Flop (didn't bet)
Seat 5: LLregs folded before Flop (didn't bet)
Seat 6: avilaC73 collected ($0.05)

PokerStars Zoom Hand #247960257183:  Hold'em No Limit ($0.01/$0.02) - 2023/12/30 15:41:01 WET [2023/12/30 10:41:01 ET]
Table 'Halley' 6-max Seat #1 is the button
Seat 1: LLregs ($3.14 in chips)
Seat 2: Thooorrr ($2 in chips)
Seat 3: 888lifeIS ($2.07 in chips)
Seat 4: Makedonskiyy ($0.83 in chips)
Seat 5: MirianAraujo ($1.04 in chips)
Seat 6: gorgio1973 ($1.62 in chips)
Thooorrr: posts small blind $0.01
888lifeIS: posts big blind $0.02
*** HOLE CARDS ***
Dealt to LLregs [7h 6d]
Makedonskiyy: folds
MirianAraujo: raises $0.02 to $0.04
gorgio1973: folds
LLregs: folds
Thooorrr: folds
888lifeIS: calls $0.02
*** FLOP *** [Ks Ts Ah]
888lifeIS: checks
MirianAraujo: bets $0.05
888lifeIS: calls $0.05
*** TURN *** [Ks Ts Ah] [8s]
888lifeIS: checks
MirianAraujo: bets $0.09
888lifeIS: calls $0.09
*** RIVER *** [Ks Ts Ah 8s] [5d]
888lifeIS: checks
MirianAraujo: bets $0.14
888lifeIS: folds
Uncalled bet ($0.14) returned to MirianAraujo
MirianAraujo collected $0.36 from pot
MirianAraujo: doesn't show hand
*** SUMMARY ***
Total pot $0.37 | Rake $0.01
Board [Ks Ts Ah 8s 5d]
Seat 1: LLregs (button) folded before Flop (didn't bet)
Seat 2: Thooorrr (small blind) folded before Flop
Seat 3: 888lifeIS (big blind) folded on the River
Seat 4: Makedonskiyy folded before Flop (didn't bet)
Seat 5: MirianAraujo collected ($0.36)
Seat 6: gorgio1973 folded before Flop (didn't bet)

PokerStars Zoom Hand #247960258245:  Hold'em No Limit ($0.01/$0.02) - 2023/12/30 15:41:05 WET [2023/12/30 10:41:05 ET]
Table 'Halley' 6-max Seat #1 is the button
Seat 1: Kimurarer ($1.98 in chips)
Seat 2: LLregs ($3.14 in chips)
Seat 3: Mamirox ($2.53 in chips)
Seat 4: Mikeloko182 ($2.30 in chips)
Seat 5: Sparrooww ($3.75 in chips)
Seat 6: ifiret68 ($2.21 in chips)
LLregs: posts small blind $0.01
Mamirox: posts big blind $0.02
*** HOLE CARDS ***
Dealt to LLregs [3s 4s]
Mikeloko182: folds
Sparrooww: folds
ifiret68: folds
Kimurarer: raises $0.02 to $0.04
LLregs: folds
Mamirox: calls $0.02
*** FLOP *** [4d 6c Ts]
Mamirox: checks
Kimurarer: bets $0.04
Mamirox: calls $0.04
*** TURN *** [4d 6c Ts] [Ac]
Mamirox: checks
Kimurarer: bets $0.08
Mamirox: calls $0.08
*** RIVER *** [4d 6c Ts Ac] [Ad]
Mamirox: checks
Kimurarer: checks
*** SHOW DOWN ***
Mamirox: shows [7c 9c] (a pair of Aces)
Kimurarer: shows [Qs 8c] (a pair of Aces - Queen kicker)
Kimurarer collected $0.32 from pot
*** SUMMARY ***
Total pot $0.33 | Rake $0.01
Board [4d 6c Ts Ac Ad]
Seat 1: Kimurarer (button) showed [Qs 8c] and won ($0.32) with a pair of Aces
Seat 2: LLregs (small blind) folded before Flop
Seat 3: Mamirox (big blind) showed [7c 9c] and lost with a pair of Aces
Seat 4: Mikeloko182 folded before Flop (didn't bet)
Seat 5: Sparrooww folded before Flop (didn't bet)
Seat 6: ifiret68 folded before Flop (didn't bet)

PokerStars Zoom Hand #247960259078:  Hold'em No Limit ($0.01/$0.02) - 2023/12/30 15:41:08 WET [2023/12/30 10:41:08 ET]
Table 'Halley' 6-max Seat #1 is the button
Seat 1: lordz1 ($4.75 in chips)
Seat 2: Papito187 ($2.90 in chips)
Seat 3: nadd399 ($2.17 in chips)
Seat 4: jwoww56 ($1.62 in chips)
Seat 5: Thooorrr ($2.13 in chips)
Seat 6: LLregs ($3.13 in chips)
Papito187: posts small blind $0.01
nadd399: posts big blind $0.02
*** HOLE CARDS ***
Dealt to LLregs [2h Ah]
jwoww56: calls $0.02
Thooorrr: folds
LLregs: raises $0.04 to $0.06
lordz1: folds
Papito187: folds
nadd399: calls $0.04
jwoww56: calls $0.04
*** FLOP *** [4c Ks Jc]
nadd399: checks
jwoww56: bets $0.02
LLregs: calls $0.02
nadd399: calls $0.02
*** TURN *** [4c Ks Jc] [8c]
nadd399: checks
jwoww56: checks
LLregs: bets $0.05
nadd399: folds
jwoww56: calls $0.05
*** RIVER *** [4c Ks Jc 8c] [3s]
jwoww56: bets $0.06
LLregs: raises $0.16 to $0.22
jwoww56: folds
Uncalled bet ($0.16) returned to LLregs
LLregs collected $0.45 from pot
LLregs: doesn't show hand
*** SUMMARY ***
Total pot $0.47 | Rake $0.02
Board [4c Ks Jc 8c 3s]
Seat 1: lordz1 (button) folded before Flop (didn't bet)
Seat 2: Papito187 (small blind) folded before Flop
Seat 3: nadd399 (big blind) folded on the Turn
Seat 4: jwoww56 folded on the River
Seat 5: Thooorrr folded before Flop (didn't bet)
Seat 6: LLregs collected ($0.45)

PokerStars Zoom Hand #247960275605:  Hold'em No Limit ($0.01/$0.02) - 2023/12/30 15:42:06 WET [2023/12/30 10:42:06 ET]
Table 'Halley' 6-max Seat #1 is the button
Seat 1: LLregs ($3.39 in chips)
Seat 2: boyacky66 ($7.30 in chips)
Seat 3: Mikeloko182 ($2 in chips)
Seat 4: dsousAA ($2.07 in chips)
Seat 5: tttognon24 ($1.95 in chips)
Seat 6: Jhon Rambo.CL ($2.03 in chips)
boyacky66: posts small blind $0.01
Mikeloko182: posts big blind $0.02
*** HOLE CARDS ***
Dealt to LLregs [Jd Qs]
dsousAA: folds
tttognon24: raises $0.16 to $0.18
Jhon Rambo.CL: folds
LLregs: folds
boyacky66: folds
Mikeloko182: folds
Uncalled bet ($0.16) returned to tttognon24
tttognon24 collected $0.05 from pot
tttognon24: doesn't show hand
*** SUMMARY ***
Total pot $0.05 | Rake $0
Seat 1: LLregs (button) folded before Flop (didn't bet)
Seat 2: boyacky66 (small blind) folded before Flop
Seat 3: Mikeloko182 (big blind) folded before Flop
Seat 4: dsousAA folded before Flop (didn't bet)
Seat 5: tttognon24 collected ($0.05)
Seat 6: Jhon Rambo.CL folded before Flop (didn't bet)

PokerStars Zoom Hand #247960282628:  Hold'em No Limit ($0.01/$0.02) - 2023/12/30 15:42:31 WET [2023/12/30 10:42:31 ET]
Table 'Halley' 6-max Seat #1 is the button
Seat 1: mihai_s1984 ($0.90 in chips)
Seat 2: jackstrap ($2.07 in chips)
Seat 3: FishAndFurious ($2.11 in chips)
Seat 4: zxczxc9999 ($2.07 in chips)
Seat 5: LLregs ($3.37 in chips)
Seat 6: Harold_Seven ($1.18 in chips)
jackstrap: posts small blind $0.01
FishAndFurious: posts big blind $0.02
*** HOLE CARDS ***
Dealt to LLregs [9s 5d]
zxczxc9999: folds
LLregs: folds
Harold_Seven: folds
mihai_s1984: folds
jackstrap: folds
Uncalled bet ($0.01) returned to FishAndFurious
FishAndFurious collected $0.02 from pot
FishAndFurious: doesn't show hand
*** SUMMARY ***
Total pot $0.02 | Rake $0
Seat 1: mihai_s1984 (button) folded before Flop (didn't bet)
Seat 2: jackstrap (small blind) folded before Flop
Seat 3: FishAndFurious (big blind) collected ($0.02)
Seat 4: zxczxc9999 folded before Flop (didn't bet)
Seat 5: LLregs folded before Flop (didn't bet)
Seat 6: Harold_Seven folded before Flop (didn't bet)

PokerStars Zoom Hand #247960280879:  Hold'em No Limit ($0.01/$0.02) - 2023/12/30 15:42:25 WET [2023/12/30 10:42:25 ET]
Table 'Halley' 6-max Seat #1 is the button
Seat 1: Mantaray68 ($1.48 in chips)
Seat 2: Makedonskiyy ($0.98 in chips)
Seat 3: LLregs ($3.39 in chips)
Seat 4: FERNANDO R01997 ($1.36 in chips)
Seat 5: 888lifeIS ($2.02 in chips)
Seat 6: MXLVI ($2 in chips)
Makedonskiyy: posts small blind $0.01
LLregs: posts big blind $0.02
*** HOLE CARDS ***
Dealt to LLregs [6h 4d]
FERNANDO R01997: raises $0.03 to $0.05
888lifeIS: folds
MXLVI: folds
Mantaray68: folds
Makedonskiyy: calls $0.04
LLregs: folds
*** FLOP *** [Jc 4h 7s]
Makedonskiyy: checks
FERNANDO R01997: checks
*** TURN *** [Jc 4h 7s] [7d]
Makedonskiyy: bets $0.06
FERNANDO R01997: calls $0.06
*** RIVER *** [Jc 4h 7s 7d] [Js]
Makedonskiyy: bets $0.12
FERNANDO R01997: calls $0.12
*** SHOW DOWN ***
Makedonskiyy: shows [Ts Tc] (two pair, Jacks and Tens)
FERNANDO R01997: mucks hand
Makedonskiyy collected $0.46 from pot
*** SUMMARY ***
Total pot $0.48 | Rake $0.02
Board [Jc 4h 7s 7d Js]
Seat 1: Mantaray68 (button) folded before Flop (didn't bet)
Seat 2: Makedonskiyy (small blind) showed [Ts Tc] and won ($0.46) with two pair, Jacks and Tens
Seat 3: LLregs (big blind) folded before Flop
Seat 4: FERNANDO R01997 mucked [9s Ad]
Seat 5: 888lifeIS folded before Flop (didn't bet)
Seat 6: MXLVI folded before Flop (didn't bet)

PokerStars Zoom Hand #247960283719:  Hold'em No Limit ($0.01/$0.02) - 2023/12/30 15:42:35 WET [2023/12/30 10:42:35 ET]
Table 'Halley' 6-max Seat #1 is the button
Seat 1: Angel2480 ($2.79 in chips)
Seat 2: LLregs ($3.37 in chips)
Seat 3: obsidian5665 ($2.38 in chips)
Seat 4: RTedeschi19 ($0.85 in chips)
Seat 5: Harold_Seven ($5.37 in chips)
Seat 6: Marcus579 ($5.35 in chips)
LLregs: posts small blind $0.01
obsidian5665: posts big blind $0.02
*** HOLE CARDS ***
Dealt to LLregs [Jh 8d]
RTedeschi19: folds
Harold_Seven: folds
Marcus579: folds
Angel2480: folds
LLregs: folds
Uncalled bet ($0.01) returned to obsidian5665
obsidian5665 collected $0.02 from pot
obsidian5665: doesn't show hand
*** SUMMARY ***
Total pot $0.02 | Rake $0
Seat 1: Angel2480 (button) folded before Flop (didn't bet)
Seat 2: LLregs (small blind) folded before Flop
Seat 3: obsidian5665 (big blind) collected ($0.02)
Seat 4: RTedeschi19 folded before Flop (didn't bet)
Seat 5: Harold_Seven folded before Flop (didn't bet)
Seat 6: Marcus579 folded before Flop (didn't bet)

PokerStars Zoom Hand #247960290497:  Hold'em No Limit ($0.01/$0.02) - 2023/12/30 15:42:59 WET [2023/12/30 10:42:59 ET]
Table 'Halley' 6-max Seat #1 is the button
Seat 1: Arabescul ($2.24 in chips)
Seat 2: ungiwar ($1.07 in chips)
Seat 3: jandsonpower ($2.11 in chips)
Seat 4: cawi1963 ($4.91 in chips)
Seat 5: LLregs ($3.36 in chips)
Seat 6: Eumi10 ($1.06 in chips)
ungiwar: posts small blind $0.01
jandsonpower: posts big blind $0.02
*** HOLE CARDS ***
Dealt to LLregs [Tc 9h]
cawi1963: calls $0.02
LLregs: folds
Eumi10: raises $0.05 to $0.07
Arabescul: folds
ungiwar: raises $0.16 to $0.23
jandsonpower: folds
cawi1963: folds
Eumi10: calls $0.16
*** FLOP *** [6s 9d 3s]
ungiwar: checks
Eumi10: bets $0.18
ungiwar: folds
Uncalled bet ($0.18) returned to Eumi10
Eumi10 collected $0.48 from pot
Eumi10: doesn't show hand
*** SUMMARY ***
Total pot $0.50 | Rake $0.02
Board [6s 9d 3s]
Seat 1: Arabescul (button) folded before Flop (didn't bet)
Seat 2: ungiwar (small blind) folded on the Flop
Seat 3: jandsonpower (big blind) folded before Flop
Seat 4: cawi1963 folded before Flop
Seat 5: LLregs folded before Flop (didn't bet)
Seat 6: Eumi10 collected ($0.48)

PokerStars Zoom Hand #247960307151:  Hold'em No Limit ($0.01/$0.02) - 2023/12/30 15:43:59 WET [2023/12/30 10:43:59 ET]
Table 'Halley' 6-max Seat #1 is the button
Seat 1: cr@sh test ($2.26 in chips)
Seat 2: nestor-ruso ($2.32 in chips)
Seat 3: chri_zockt ($2.07 in chips)
Seat 4: bartovskii ($7.66 in chips)
Seat 5: lordz1 ($4.67 in chips)
Seat 6: LLregs ($3.36 in chips)
nestor-ruso: posts small blind $0.01
chri_zockt: posts big blind $0.02
*** HOLE CARDS ***
Dealt to LLregs [Tc 7s]
bartovskii: folds
lordz1: folds
LLregs: folds
cr@sh test: folds
nestor-ruso: folds
Uncalled bet ($0.01) returned to chri_zockt
chri_zockt collected $0.02 from pot
chri_zockt: doesn't show hand
*** SUMMARY ***
Total pot $0.02 | Rake $0
Seat 1: cr@sh test (button) folded before Flop (didn't bet)
Seat 2: nestor-ruso (small blind) folded before Flop
Seat 3: chri_zockt (big blind) collected ($0.02)
Seat 4: bartovskii folded before Flop (didn't bet)
Seat 5: lordz1 folded before Flop (didn't bet)
Seat 6: LLregs folded before Flop (didn't bet)

PokerStars Zoom Hand #247960309660:  Hold'em No Limit ($0.01/$0.02) - 2023/12/30 15:44:08 WET [2023/12/30 10:44:08 ET]
Table 'Halley' 6-max Seat #1 is the button
Seat 1: FERNANDO R01997 ($2 in chips)
Seat 2: ARES_312 ($1.86 in chips)
Seat 3: LLregs ($3.36 in chips)
Seat 4: Wahnsinn24 ($1.85 in chips)
Seat 5: MSB1155 ($1.99 in chips)
Seat 6: Mikeloko182 ($3.33 in chips)
ARES_312: posts small blind $0.01
LLregs: posts big blind $0.02
*** HOLE CARDS ***
Dealt to LLregs [Tc Ad]
Wahnsinn24: folds
MSB1155: folds
Mikeloko182: raises $0.04 to $0.06
FERNANDO R01997: folds
ARES_312: folds
LLregs: calls $0.04
*** FLOP *** [9h Kd 6s]
LLregs: checks
Mikeloko182: checks
*** TURN *** [9h Kd 6s] [7h]
LLregs: checks
Mikeloko182: checks
*** RIVER *** [9h Kd 6s 7h] [5s]
LLregs: bets $0.03
Mikeloko182: folds
Uncalled bet ($0.03) returned to LLregs
LLregs collected $0.13 from pot
LLregs: doesn't show hand
*** SUMMARY ***
Total pot $0.13 | Rake $0
Board [9h Kd 6s 7h 5s]
Seat 1: FERNANDO R01997 (button) folded before Flop (didn't bet)
Seat 2: ARES_312 (small blind) folded before Flop
Seat 3: LLregs (big blind) collected ($0.13)
Seat 4: Wahnsinn24 folded before Flop (didn't bet)
Seat 5: MSB1155 folded before Flop (didn't bet)
Seat 6: Mikeloko182 folded on the River

PokerStars Zoom Hand #247960308605:  Hold'em No Limit ($0.01/$0.02) - 2023/12/30 15:44:04 WET [2023/12/30 10:44:04 ET]
Table 'Halley' 6-max Seat #1 is the button
Seat 1: chri_zockt ($3.02 in chips)
Seat 2: maressen ($3.19 in chips)
Seat 3: zoran445 ($1 in chips)
Seat 4: LLregs ($3.36 in chips)
Seat 5: portcounty ($0.74 in chips)
Seat 6: Jinkar131313 ($1.22 in chips)
maressen: posts small blind $0.01
zoran445: posts big blind $0.02
*** HOLE CARDS ***
Dealt to LLregs [3c 2h]
LLregs: folds
portcounty: raises $0.02 to $0.04
Jinkar131313: calls $0.04
chri_zockt: calls $0.04
maressen: folds
zoran445: calls $0.02
*** FLOP *** [7d 6d 8d]
zoran445: bets $0.02
portcounty: calls $0.02
Jinkar131313: calls $0.02
chri_zockt: calls $0.02
*** TURN *** [7d 6d 8d] [2d]
zoran445: checks
portcounty: checks
Jinkar131313: bets $0.12
chri_zockt: folds
zoran445: folds
portcounty: folds
Uncalled bet ($0.12) returned to Jinkar131313
Jinkar131313 collected $0.24 from pot
Jinkar131313: doesn't show hand
*** SUMMARY ***
Total pot $0.25 | Rake $0.01
Board [7d 6d 8d 2d]
Seat 1: chri_zockt (button) folded on the Turn
Seat 2: maressen (small blind) folded before Flop
Seat 3: zoran445 (big blind) folded on the Turn
Seat 4: LLregs folded before Flop (didn't bet)
Seat 5: portcounty folded on the Turn
Seat 6: Jinkar131313 collected ($0.24)

PokerStars Zoom Hand #247960319259:  Hold'em No Limit ($0.01/$0.02) - 2023/12/30 15:44:42 WET [2023/12/30 10:44:42 ET]
Table 'Halley' 6-max Seat #1 is the button
Seat 1: FEROIZ ($2.16 in chips)
Seat 2: PozzzitiF ($1.02 in chips)
Seat 3: jandsonpower ($2.09 in chips)
Seat 4: marcegring ($2.21 in chips)
Seat 5: LLregs ($3.43 in chips)
Seat 6: arika00 ($1.33 in chips)
PozzzitiF: posts small blind $0.01
jandsonpower: posts big blind $0.02
*** HOLE CARDS ***
Dealt to LLregs [4c Td]
marcegring: folds
LLregs: folds
arika00: folds
FEROIZ: folds
PozzzitiF: folds
Uncalled bet ($0.01) returned to jandsonpower
jandsonpower collected $0.02 from pot
jandsonpower: doesn't show hand
*** SUMMARY ***
Total pot $0.02 | Rake $0
Seat 1: FEROIZ (button) folded before Flop (didn't bet)
Seat 2: PozzzitiF (small blind) folded before Flop
Seat 3: jandsonpower (big blind) collected ($0.02)
Seat 4: marcegring folded before Flop (didn't bet)
Seat 5: LLregs folded before Flop (didn't bet)
Seat 6: arika00 folded before Flop (didn't bet)

PokerStars Zoom Hand #247960332983:  Hold'em No Limit ($0.01/$0.02) - 2023/12/30 15:45:31 WET [2023/12/30 10:45:31 ET]
Table 'Halley' 6-max Seat #1 is the button
Seat 1: FishAndFurious ($2.11 in chips)
Seat 2: LLregs ($3.35 in chips)
Seat 3: ifiret68 ($2.03 in chips)
Seat 4: Papito187 ($2.70 in chips)
Seat 5: Floggy73 ($3.56 in chips)
Seat 6: Jenly1234 ($2.17 in chips)
LLregs: posts small blind $0.01
ifiret68: posts big blind $0.02
*** HOLE CARDS ***
Dealt to LLregs [8s Ks]
Papito187: folds
Floggy73: folds
Jenly1234: folds
FishAndFurious: folds
LLregs: raises $0.04 to $0.06
ifiret68: folds
Uncalled bet ($0.04) returned to LLregs
LLregs collected $0.04 from pot
LLregs: doesn't show hand
*** SUMMARY ***
Total pot $0.04 | Rake $0
Seat 1: FishAndFurious (button) folded before Flop (didn't bet)
Seat 2: LLregs (small blind) collected ($0.04)
Seat 3: ifiret68 (big blind) folded before Flop
Seat 4: Papito187 folded before Flop (didn't bet)
Seat 5: Floggy73 folded before Flop (didn't bet)
Seat 6: Jenly1234 folded before Flop (didn't bet)

PokerStars Zoom Hand #247960320432:  Hold'em No Limit ($0.01/$0.02) - 2023/12/30 15:44:46 WET [2023/12/30 10:44:46 ET]
Table 'Halley' 6-max Seat #1 is the button
Seat 1: LLregs ($3.43 in chips)
Seat 2: zoran445 ($0.94 in chips)
Seat 3: gnom1977 ($2.16 in chips)
Seat 4: El Vheyn ($3.33 in chips)
Seat 5: theprince188 ($2.67 in chips)
Seat 6: 888lifeIS ($2 in chips)
zoran445: posts small blind $0.01
gnom1977: posts big blind $0.02
*** HOLE CARDS ***
Dealt to LLregs [9h 7h]
El Vheyn: calls $0.02
theprince188: raises $0.06 to $0.08
888lifeIS: folds
LLregs: calls $0.08
zoran445: folds
gnom1977: calls $0.06
El Vheyn: calls $0.06
*** FLOP *** [3d 6h 7d]
gnom1977: checks
El Vheyn: checks
theprince188: checks
LLregs: checks
*** TURN *** [3d 6h 7d] [4s]
gnom1977: checks
El Vheyn: bets $0.10
theprince188: raises $0.39 to $0.49
LLregs: folds
gnom1977 is disconnected
gnom1977: folds
El Vheyn: folds
Uncalled bet ($0.39) returned to theprince188
theprince188 collected $0.51 from pot
theprince188: doesn't show hand
*** SUMMARY ***
Total pot $0.53 | Rake $0.02
Board [3d 6h 7d 4s]
Seat 1: LLregs (button) folded on the Turn
Seat 2: zoran445 (small blind) folded before Flop
Seat 3: gnom1977 (big blind) folded on the Turn
Seat 4: El Vheyn folded on the Turn
Seat 5: theprince188 collected ($0.51)
Seat 6: 888lifeIS folded before Flop (didn't bet)

PokerStars Zoom Hand #247960337798:  Hold'em No Limit ($0.01/$0.02) - 2023/12/30 15:45:48 WET [2023/12/30 10:45:48 ET]
Table 'Halley' 6-max Seat #1 is the button
Seat 1: FishAndFurious ($2 in chips)
Seat 2: AndGPR ($2 in chips)
Seat 3: Nee82 ($2.66 in chips)
Seat 4: Wahnsinn24 ($1.84 in chips)
Seat 5: Arabescul ($2.51 in chips)
Seat 6: LLregs ($3.37 in chips)
AndGPR: posts small blind $0.01
Nee82: posts big blind $0.02
*** HOLE CARDS ***
Dealt to LLregs [9c 7c]
Wahnsinn24: folds
Arabescul: folds
LLregs: raises $0.04 to $0.06
FishAndFurious: folds
AndGPR: folds
Nee82: folds
Uncalled bet ($0.04) returned to LLregs
LLregs collected $0.05 from pot
LLregs: doesn't show hand
*** SUMMARY ***
Total pot $0.05 | Rake $0
Seat 1: FishAndFurious (button) folded before Flop (didn't bet)
Seat 2: AndGPR (small blind) folded before Flop
Seat 3: Nee82 (big blind) folded before Flop
Seat 4: Wahnsinn24 folded before Flop (didn't bet)
Seat 5: Arabescul folded before Flop (didn't bet)
Seat 6: LLregs collected ($0.05)

PokerStars Zoom Hand #247960349469:  Hold'em No Limit ($0.01/$0.02) - 2023/12/30 15:46:29 WET [2023/12/30 10:46:29 ET]
Table 'Halley' 6-max Seat #1 is the button
Seat 1: Kimurarer ($2.79 in chips)
Seat 2: napoli222 ($2.17 in chips)
Seat 3: Nutu1313 ($4.17 in chips)
Seat 4: LLregs ($3.40 in chips)
Seat 5: karprinic ($2.07 in chips)
Seat 6: cr@sh test ($2.18 in chips)
napoli222: posts small blind $0.01
Nutu1313: posts big blind $0.02
*** HOLE CARDS ***
Dealt to LLregs [Th Td]
LLregs: raises $0.04 to $0.06
karprinic: folds
cr@sh test: folds
Kimurarer: folds
napoli222: folds
Nutu1313: folds
Uncalled bet ($0.04) returned to LLregs
LLregs collected $0.05 from pot
LLregs: doesn't show hand
*** SUMMARY ***
Total pot $0.05 | Rake $0
Seat 1: Kimurarer (button) folded before Flop (didn't bet)
Seat 2: napoli222 (small blind) folded before Flop
Seat 3: Nutu1313 (big blind) folded before Flop
Seat 4: LLregs collected ($0.05)
Seat 5: karprinic folded before Flop (didn't bet)
Seat 6: cr@sh test folded before Flop (didn't bet)

PokerStars Zoom Hand #247960343164:  Hold'em No Limit ($0.01/$0.02) - 2023/12/30 15:46:07 WET [2023/12/30 10:46:07 ET]
Table 'Halley' 6-max Seat #1 is the button
Seat 1: LLregs ($3.40 in chips)
Seat 2: Mikeloko182 ($2 in chips)
Seat 3: jackassjack ($1.20 in chips)
Seat 4: AndGPR ($2.05 in chips)
Seat 5: TanzeArango ($2.04 in chips)
Seat 6: Nutu1313 ($2.89 in chips)
Mikeloko182: posts small blind $0.01
jackassjack: posts big blind $0.02
*** HOLE CARDS ***
Dealt to LLregs [3d Ah]
AndGPR: folds
TanzeArango: raises $0.04 to $0.06
Nutu1313: folds
LLregs: folds
Mikeloko182: calls $0.05
jackassjack: calls $0.04
*** FLOP *** [8d 6s Jh]
Mikeloko182: checks
jackassjack: checks
TanzeArango: bets $0.09
Mikeloko182: calls $0.09
jackassjack: folds
*** TURN *** [8d 6s Jh] [9d]
Mikeloko182: checks
TanzeArango: checks
*** RIVER *** [8d 6s Jh 9d] [9c]
Mikeloko182: checks
TanzeArango: checks
*** SHOW DOWN ***
Mikeloko182: shows [Kd Td] (a pair of Nines)
TanzeArango: shows [Qd Kc] (a pair of Nines - King+Queen kicker)
TanzeArango collected $0.35 from pot
*** SUMMARY ***
Total pot $0.36 | Rake $0.01
Board [8d 6s Jh 9d 9c]
Seat 1: LLregs (button) folded before Flop (didn't bet)
Seat 2: Mikeloko182 (small blind) showed [Kd Td] and lost with a pair of Nines
Seat 3: jackassjack (big blind) folded on the Flop
Seat 4: AndGPR folded before Flop (didn't bet)
Seat 5: TanzeArango showed [Qd Kc] and won ($0.35) with a pair of Nines
Seat 6: Nutu1313 folded before Flop (didn't bet)

PokerStars Zoom Hand #247960352963:  Hold'em No Limit ($0.01/$0.02) - 2023/12/30 15:46:41 WET [2023/12/30 10:46:41 ET]
Table 'Halley' 6-max Seat #1 is the button
Seat 1: Akhee93 ($2.20 in chips)
Seat 2: Sperick ($5.34 in chips)
Seat 3: LLregs ($3.43 in chips)
Seat 4: RazvanBabanu ($1.44 in chips)
Seat 5: GoldeN0330 ($2.09 in chips)
Seat 6: sexynurseama ($2.26 in chips)
Sperick: posts small blind $0.01
LLregs: posts big blind $0.02
*** HOLE CARDS ***
Dealt to LLregs [Ts Js]
RazvanBabanu: folds
GoldeN0330: folds
sexynurseama: folds
Akhee93: raises $0.04 to $0.06
Sperick: folds
LLregs: raises $0.12 to $0.18
Akhee93: folds
Uncalled bet ($0.12) returned to LLregs
LLregs collected $0.13 from pot
LLregs: doesn't show hand
*** SUMMARY ***
Total pot $0.13 | Rake $0
Seat 1: Akhee93 (button) folded before Flop
Seat 2: Sperick (small blind) folded before Flop
Seat 3: LLregs (big blind) collected ($0.13)
Seat 4: RazvanBabanu folded before Flop (didn't bet)
Seat 5: GoldeN0330 folded before Flop (didn't bet)
Seat 6: sexynurseama folded before Flop (didn't bet)

PokerStars Zoom Hand #247960358933:  Hold'em No Limit ($0.01/$0.02) - 2023/12/30 15:47:02 WET [2023/12/30 10:47:02 ET]
Table 'Halley' 6-max Seat #1 is the button
Seat 1: MSerik ($2.08 in chips)
Seat 2: LLregs ($3.50 in chips)
Seat 3: piccolino25 ($3.63 in chips)
Seat 4: laoban888 ($2.21 in chips)
Seat 5: jackassjack ($1.13 in chips)
Seat 6: IgorFuraZoio ($1.87 in chips)
LLregs: posts small blind $0.01
piccolino25: posts big blind $0.02
*** HOLE CARDS ***
Dealt to LLregs [8d Jd]
laoban888: raises $0.04 to $0.06
jackassjack: folds
IgorFuraZoio: folds
MSerik: folds
LLregs: calls $0.05
piccolino25: folds
*** FLOP *** [Jh 2h Qd]
LLregs: bets $0.05
laoban888: calls $0.05
*** TURN *** [Jh 2h Qd] [Ac]
LLregs: bets $0.08
laoban888: folds
Uncalled bet ($0.08) returned to LLregs
LLregs collected $0.23 from pot
LLregs: doesn't show hand
*** SUMMARY ***
Total pot $0.24 | Rake $0.01
Board [Jh 2h Qd Ac]
Seat 1: MSerik (button) folded before Flop (didn't bet)
Seat 2: LLregs (small blind) collected ($0.23)
Seat 3: piccolino25 (big blind) folded before Flop
Seat 4: laoban888 folded on the Turn
Seat 5: jackassjack folded before Flop (didn't bet)
Seat 6: IgorFuraZoio folded before Flop (didn't bet)

PokerStars Zoom Hand #247960368320:  Hold'em No Limit ($0.01/$0.02) - 2023/12/30 15:47:35 WET [2023/12/30 10:47:35 ET]
Table 'Halley' 6-max Seat #1 is the button
Seat 1: nuttymuch ($7.76 in chips)
Seat 2: PozzzitiF ($1.01 in chips)
Seat 3: laoban888 ($2.58 in chips)
Seat 4: sherryzin ($2.04 in chips)
Seat 5: ilian1111 ($4.45 in chips)
Seat 6: LLregs ($3.62 in chips)
PozzzitiF: posts small blind $0.01
laoban888: posts big blind $0.02
*** HOLE CARDS ***
Dealt to LLregs [Ts Ac]
sherryzin: calls $0.02
ilian1111: folds
LLregs: raises $0.04 to $0.06
nuttymuch: folds
PozzzitiF: folds
laoban888: folds
sherryzin: calls $0.04
*** FLOP *** [9h 5c Jh]
sherryzin: bets $0.10
LLregs: folds
Uncalled bet ($0.10) returned to sherryzin
sherryzin collected $0.14 from pot
sherryzin: doesn't show hand
*** SUMMARY ***
Total pot $0.15 | Rake $0.01
Board [9h 5c Jh]
Seat 1: nuttymuch (button) folded before Flop (didn't bet)
Seat 2: PozzzitiF (small blind) folded before Flop
Seat 3: laoban888 (big blind) folded before Flop
Seat 4: sherryzin collected ($0.14)
Seat 5: ilian1111 folded before Flop (didn't bet)
Seat 6: LLregs folded on the Flop

PokerStars Zoom Hand #247960375773:  Hold'em No Limit ($0.01/$0.02) - 2023/12/30 15:48:02 WET [2023/12/30 10:48:02 ET]
Table 'Halley' 6-max Seat #1 is the button
Seat 1: Makedonskiyy ($0.69 in chips)
Seat 2: Nutu1313 ($4.02 in chips)
Seat 3: C2DFMNLH ($4.04 in chips)
Seat 4: karprinic ($0.91 in chips)
Seat 5: LLregs ($3.56 in chips)
Seat 6: Marcus579 ($5 in chips)
Nutu1313: posts small blind $0.01
C2DFMNLH: posts big blind $0.02
*** HOLE CARDS ***
Dealt to LLregs [Tc Kc]
karprinic: folds
LLregs: raises $0.04 to $0.06
Marcus579: folds
Makedonskiyy: folds
Nutu1313: folds
C2DFMNLH: folds
Uncalled bet ($0.04) returned to LLregs
LLregs collected $0.05 from pot
LLregs: doesn't show hand
*** SUMMARY ***
Total pot $0.05 | Rake $0
Seat 1: Makedonskiyy (button) folded before Flop (didn't bet)
Seat 2: Nutu1313 (small blind) folded before Flop
Seat 3: C2DFMNLH (big blind) folded before Flop
Seat 4: karprinic folded before Flop (didn't bet)
Seat 5: LLregs collected ($0.05)
Seat 6: Marcus579 folded before Flop (didn't bet)

PokerStars Zoom Hand #247960382759:  Hold'em No Limit ($0.01/$0.02) - 2023/12/30 15:48:26 WET [2023/12/30 10:48:26 ET]
Table 'Halley' 6-max Seat #1 is the button
Seat 1: inhonestus ($2.09 in chips)
Seat 2: iliyan66 ($4.36 in chips)
Seat 3: LLregs ($3.59 in chips)
Seat 4: baastiii29 ($2.26 in chips)
Seat 5: akasku54 ($1.81 in chips)
Seat 6: nikkem971 ($4.48 in chips)
iliyan66: posts small blind $0.01
LLregs: posts big blind $0.02
*** HOLE CARDS ***
Dealt to LLregs [Td 7c]
baastiii29: folds
akasku54: folds
nikkem971: folds
inhonestus: folds
iliyan66: folds
Uncalled bet ($0.01) returned to LLregs
LLregs collected $0.02 from pot
LLregs: doesn't show hand
*** SUMMARY ***
Total pot $0.02 | Rake $0
Seat 1: inhonestus (button) folded before Flop (didn't bet)
Seat 2: iliyan66 (small blind) folded before Flop
Seat 3: LLregs (big blind) collected ($0.02)
Seat 4: baastiii29 folded before Flop (didn't bet)
Seat 5: akasku54 folded before Flop (didn't bet)
Seat 6: nikkem971 folded before Flop (didn't bet)

PokerStars Zoom Hand #247960385443:  Hold'em No Limit ($0.01/$0.02) - 2023/12/30 15:48:36 WET [2023/12/30 10:48:36 ET]
Table 'Halley' 6-max Seat #1 is the button
Seat 1: chj9213326 ($2.56 in chips)
Seat 2: LLregs ($3.60 in chips)
Seat 3: Setsko_V ($1.93 in chips)
Seat 4: rafds765 ($10.06 in chips)
Seat 5: Mantaray68 ($1.18 in chips)
Seat 6: ZiggyBoy90 ($2.24 in chips)
LLregs: posts small blind $0.01
Setsko_V: posts big blind $0.02
*** HOLE CARDS ***
Dealt to LLregs [9h 5d]
rafds765: folds
Mantaray68: folds
ZiggyBoy90: folds
chj9213326: raises $0.05 to $0.07
LLregs: folds
Setsko_V: folds
Uncalled bet ($0.05) returned to chj9213326
chj9213326 collected $0.05 from pot
chj9213326: doesn't show hand
*** SUMMARY ***
Total pot $0.05 | Rake $0
Seat 1: chj9213326 (button) collected ($0.05)
Seat 2: LLregs (small blind) folded before Flop
Seat 3: Setsko_V (big blind) folded before Flop
Seat 4: rafds765 folded before Flop (didn't bet)
Seat 5: Mantaray68 folded before Flop (didn't bet)
Seat 6: ZiggyBoy90 folded before Flop (didn't bet)

PokerStars Zoom Hand #247960386819:  Hold'em No Limit ($0.01/$0.02) - 2023/12/30 15:48:41 WET [2023/12/30 10:48:41 ET]
Table 'Halley' 6-max Seat #1 is the button
Seat 1: LLregs ($3.59 in chips)
Seat 2: OskyP ($2 in chips)
Seat 3: BiG whaIe ($0.91 in chips)
Seat 4: Makedonskiyy ($0.89 in chips)
Seat 5: drchilled ($2.46 in chips)
Seat 6: jandsonpower ($2 in chips)
OskyP: posts small blind $0.01
BiG whaIe: posts big blind $0.02
*** HOLE CARDS ***
Dealt to LLregs [3h 5h]
Makedonskiyy: folds
drchilled: folds
jandsonpower: raises $0.03 to $0.05
LLregs: folds
OskyP: folds
BiG whaIe: raises $0.86 to $0.91 and is all-in
jandsonpower: folds
Uncalled bet ($0.86) returned to BiG whaIe
BiG whaIe collected $0.11 from pot
BiG whaIe: doesn't show hand
*** SUMMARY ***
Total pot $0.11 | Rake $0
Seat 1: LLregs (button) folded before Flop (didn't bet)
Seat 2: OskyP (small blind) folded before Flop
Seat 3: BiG whaIe (big blind) collected ($0.11)
Seat 4: Makedonskiyy folded before Flop (didn't bet)
Seat 5: drchilled folded before Flop (didn't bet)
Seat 6: jandsonpower folded before Flop

PokerStars Zoom Hand #247960381190:  Hold'em No Limit ($0.01/$0.02) - 2023/12/30 15:48:21 WET [2023/12/30 10:48:21 ET]
Table 'Halley' 6-max Seat #1 is the button
Seat 1: keolis443 ($4.13 in chips)
Seat 2: MSB1155 ($1.53 in chips)
Seat 3: GoldeN0330 ($2.06 in chips)
Seat 4: LLregs ($3.59 in chips)
Seat 5: MXLVI ($2 in chips)
Seat 6: MSerik ($2.08 in chips)
MSB1155: posts small blind $0.01
GoldeN0330: posts big blind $0.02
*** HOLE CARDS ***
Dealt to LLregs [2h 6h]
LLregs: folds
MXLVI: raises $0.06 to $0.08
MSerik: folds
keolis443: folds
MSB1155 is disconnected
MSB1155 has timed out while disconnected
MSB1155: folds
GoldeN0330: folds
Uncalled bet ($0.06) returned to MXLVI
MXLVI collected $0.05 from pot
MXLVI: doesn't show hand
*** SUMMARY ***
Total pot $0.05 | Rake $0
Seat 1: keolis443 (button) folded before Flop (didn't bet)
Seat 2: MSB1155 (small blind) folded before Flop
Seat 3: GoldeN0330 (big blind) folded before Flop
Seat 4: LLregs folded before Flop (didn't bet)
Seat 5: MXLVI collected ($0.05)
Seat 6: MSerik folded before Flop (didn't bet)

PokerStars Zoom Hand #247960391412:  Hold'em No Limit ($0.01/$0.02) - 2023/12/30 15:48:57 WET [2023/12/30 10:48:57 ET]
Table 'Halley' 6-max Seat #1 is the button
Seat 1: Hollyweed_DOPE ($1.97 in chips)
Seat 2: laoban888 ($2 in chips)
Seat 3: LLregs ($3.59 in chips)
Seat 4: inhonestus ($2.10 in chips)
Seat 5: OskyP ($2 in chips)
Seat 6: zoran445 ($1 in chips)
laoban888: posts small blind $0.01
LLregs: posts big blind $0.02
*** HOLE CARDS ***
Dealt to LLregs [4d Th]
inhonestus: folds
OskyP: folds
zoran445: raises $0.98 to $1 and is all-in
Hollyweed_DOPE: folds
laoban888: folds
LLregs: folds
Uncalled bet ($0.98) returned to zoran445
zoran445 collected $0.05 from pot
zoran445: doesn't show hand
*** SUMMARY ***
Total pot $0.05 | Rake $0
Seat 1: Hollyweed_DOPE (button) folded before Flop (didn't bet)
Seat 2: laoban888 (small blind) folded before Flop
Seat 3: LLregs (big blind) folded before Flop
Seat 4: inhonestus folded before Flop (didn't bet)
Seat 5: OskyP folded before Flop (didn't bet)
Seat 6: zoran445 collected ($0.05)

PokerStars Zoom Hand #247960388826:  Hold'em No Limit ($0.01/$0.02) - 2023/12/30 15:48:48 WET [2023/12/30 10:48:48 ET]
Table 'Halley' 6-max Seat #1 is the button
Seat 1: sexynurseama ($2.65 in chips)
Seat 2: Svetlana-ck ($1.13 in chips)
Seat 3: inhonestus ($2.12 in chips)
Seat 4: RodrigoNC340 ($2.97 in chips)
Seat 5: LLregs ($3.59 in chips)
Seat 6: Svartbäcken ($1.99 in chips)
Svetlana-ck: posts small blind $0.01
inhonestus: posts big blind $0.02
*** HOLE CARDS ***
Dealt to LLregs [Ts 9s]
RodrigoNC340: raises $0.04 to $0.06
LLregs: folds
Svartbäcken: folds
sexynurseama: folds
Svetlana-ck: calls $0.05
inhonestus: folds
*** FLOP *** [Qd 8c Ah]
Svetlana-ck: checks
RodrigoNC340: bets $0.07
Svetlana-ck: calls $0.07
*** TURN *** [Qd 8c Ah] [6s]
Svetlana-ck: checks
RodrigoNC340: bets $0.14
Svetlana-ck: folds
Uncalled bet ($0.14) returned to RodrigoNC340
RodrigoNC340 collected $0.27 from pot
RodrigoNC340: doesn't show hand
*** SUMMARY ***
Total pot $0.28 | Rake $0.01
Board [Qd 8c Ah 6s]
Seat 1: sexynurseama (button) folded before Flop (didn't bet)
Seat 2: Svetlana-ck (small blind) folded on the Turn
Seat 3: inhonestus (big blind) folded before Flop
Seat 4: RodrigoNC340 collected ($0.27)
Seat 5: LLregs folded before Flop (didn't bet)
Seat 6: Svartbäcken folded before Flop (didn't bet)

PokerStars Zoom Hand #247960398053:  Hold'em No Limit ($0.01/$0.02) - 2023/12/30 15:49:20 WET [2023/12/30 10:49:20 ET]
Table 'Halley' 6-max Seat #1 is the button
Seat 1: LLregs ($3.56 in chips)
Seat 2: btbass ($2.59 in chips)
Seat 3: ZWEZDA126 ($2 in chips)
Seat 4: OskyP ($3.79 in chips)
Seat 5: PozzzitiF ($0.92 in chips)
Seat 6: Xablau00 ($2.05 in chips)
btbass: posts small blind $0.01
ZWEZDA126: posts big blind $0.02
*** HOLE CARDS ***
Dealt to LLregs [5h Kc]
OskyP: folds
PozzzitiF: folds
Xablau00: folds
LLregs: folds
btbass: folds
Uncalled bet ($0.01) returned to ZWEZDA126
ZWEZDA126 collected $0.02 from pot
ZWEZDA126: doesn't show hand
*** SUMMARY ***
Total pot $0.02 | Rake $0
Seat 1: LLregs (button) folded before Flop (didn't bet)
Seat 2: btbass (small blind) folded before Flop
Seat 3: ZWEZDA126 (big blind) collected ($0.02)
Seat 4: OskyP folded before Flop (didn't bet)
Seat 5: PozzzitiF folded before Flop (didn't bet)
Seat 6: Xablau00 folded before Flop (didn't bet)

PokerStars Zoom Hand #247960400212:  Hold'em No Limit ($0.01/$0.02) - 2023/12/30 15:49:28 WET [2023/12/30 10:49:28 ET]
Table 'Halley' 6-max Seat #1 is the button
Seat 1: EricksonWendel ($5.06 in chips)
Seat 2: cr@sh test ($2.20 in chips)
Seat 3: theprince188 ($2.20 in chips)
Seat 4: LLregs ($3.56 in chips)
Seat 5: anatoliw ($5.85 in chips)
Seat 6: GoldeN0330 ($2.16 in chips)
cr@sh test: posts small blind $0.01
theprince188: posts big blind $0.02
*** HOLE CARDS ***
Dealt to LLregs [8d 9s]
LLregs: folds
anatoliw: folds
GoldeN0330: folds
EricksonWendel: folds
cr@sh test: folds
Uncalled bet ($0.01) returned to theprince188
theprince188 collected $0.02 from pot
theprince188: doesn't show hand
*** SUMMARY ***
Total pot $0.02 | Rake $0
Seat 1: EricksonWendel (button) folded before Flop (didn't bet)
Seat 2: cr@sh test (small blind) folded before Flop
Seat 3: theprince188 (big blind) collected ($0.02)
Seat 4: LLregs folded before Flop (didn't bet)
Seat 5: anatoliw folded before Flop (didn't bet)
Seat 6: GoldeN0330 folded before Flop (didn't bet)

PokerStars Zoom Hand #247960387701:  Hold'em No Limit ($0.01/$0.02) - 2023/12/30 15:48:44 WET [2023/12/30 10:48:44 ET]
Table 'Halley' 6-max Seat #1 is the button
Seat 1: 888lifeIS ($2.15 in chips)
Seat 2: theprince188 ($3.91 in chips)
Seat 3: cawi1963 ($4.50 in chips)
Seat 4: LLregs ($3.59 in chips)
Seat 5: One Day Big Win ($3.22 in chips)
Seat 6: Johnstefk ($2.59 in chips)
theprince188: posts small blind $0.01
cawi1963: posts big blind $0.02
*** HOLE CARDS ***
Dealt to LLregs [4h Kh]
LLregs: folds
One Day Big Win: raises $0.04 to $0.06
Johnstefk: folds
888lifeIS: folds
theprince188: raises $0.18 to $0.24
cawi1963: folds
One Day Big Win: calls $0.18
*** FLOP *** [2c 2d 8s]
theprince188: checks
One Day Big Win: checks
*** TURN *** [2c 2d 8s] [Qc]
theprince188: bets $0.36
One Day Big Win: calls $0.36
*** RIVER *** [2c 2d 8s Qc] [9d]
theprince188: bets $3.31 and is all-in
One Day Big Win: folds
Uncalled bet ($3.31) returned to theprince188
theprince188 collected $1.18 from pot
theprince188: doesn't show hand
*** SUMMARY ***
Total pot $1.22 | Rake $0.04
Board [2c 2d 8s Qc 9d]
Seat 1: 888lifeIS (button) folded before Flop (didn't bet)
Seat 2: theprince188 (small blind) collected ($1.18)
Seat 3: cawi1963 (big blind) folded before Flop
Seat 4: LLregs folded before Flop (didn't bet)
Seat 5: One Day Big Win folded on the River
Seat 6: Johnstefk folded before Flop (didn't bet)

PokerStars Zoom Hand #247960399170:  Hold'em No Limit ($0.01/$0.02) - 2023/12/30 15:49:24 WET [2023/12/30 10:49:24 ET]
Table 'Halley' 6-max Seat #1 is the button
Seat 1: chucho82 ($2.26 in chips)
Seat 2: Shmatrixs ($2.45 in chips)
Seat 3: inhonestus ($2.13 in chips)
Seat 4: El Vheyn ($8.64 in chips)
Seat 5: cr@sh test ($2.20 in chips)
Seat 6: LLregs ($3.56 in chips)
Shmatrixs: posts small blind $0.01
inhonestus: posts big blind $0.02
*** HOLE CARDS ***
Dealt to LLregs [Jc 6c]
El Vheyn: folds
cr@sh test: folds
LLregs: folds
chucho82: raises $0.02 to $0.04
Shmatrixs: folds
inhonestus: folds
Uncalled bet ($0.02) returned to chucho82
chucho82 collected $0.05 from pot
chucho82: doesn't show hand
*** SUMMARY ***
Total pot $0.05 | Rake $0
Seat 1: chucho82 (button) collected ($0.05)
Seat 2: Shmatrixs (small blind) folded before Flop
Seat 3: inhonestus (big blind) folded before Flop
Seat 4: El Vheyn folded before Flop (didn't bet)
Seat 5: cr@sh test folded before Flop (didn't bet)
Seat 6: LLregs folded before Flop (didn't bet)

PokerStars Zoom Hand #247960395571:  Hold'em No Limit ($0.01/$0.02) - 2023/12/30 15:49:11 WET [2023/12/30 10:49:11 ET]
Table 'Halley' 6-max Seat #1 is the button
Seat 1: P.K.45677 ($1.66 in chips)
Seat 2: LLregs ($3.57 in chips)
Seat 3: Dimoni797979 ($2.94 in chips)
Seat 4: 888lifeIS ($2.04 in chips)
Seat 5: Arabescul ($2.03 in chips)
Seat 6: MSerik ($2 in chips)
LLregs: posts small blind $0.01
Dimoni797979: posts big blind $0.02
*** HOLE CARDS ***
Dealt to LLregs [4d 5h]
888lifeIS: folds
Arabescul: folds
MSerik: raises $0.04 to $0.06
P.K.45677: folds
LLregs: folds
Dimoni797979: calls $0.04
*** FLOP *** [6d 7h 6s]
Dimoni797979: checks
MSerik: bets $0.05
Dimoni797979: folds
Uncalled bet ($0.05) returned to MSerik
MSerik collected $0.13 from pot
MSerik: doesn't show hand
*** SUMMARY ***
Total pot $0.13 | Rake $0
Board [6d 7h 6s]
Seat 1: P.K.45677 (button) folded before Flop (didn't bet)
Seat 2: LLregs (small blind) folded before Flop
Seat 3: Dimoni797979 (big blind) folded on the Flop
Seat 4: 888lifeIS folded before Flop (didn't bet)
Seat 5: Arabescul folded before Flop (didn't bet)
Seat 6: MSerik collected ($0.13)

PokerStars Zoom Hand #247960401155:  Hold'em No Limit ($0.01/$0.02) - 2023/12/30 15:49:31 WET [2023/12/30 10:49:31 ET]
Table 'Halley' 6-max Seat #1 is the button
Seat 1: manoblack51 ($2 in chips)
Seat 2: GoldeN0330 ($2.36 in chips)
Seat 3: LLregs ($3.56 in chips)
Seat 4: nuttymuch ($7.75 in chips)
Seat 5: Lysy1979 ($2.49 in chips)
Seat 6: Ira Duchenko ($0.22 in chips)
GoldeN0330: posts small blind $0.01
LLregs: posts big blind $0.02
*** HOLE CARDS ***
Dealt to LLregs [Kc 9c]
nuttymuch: folds
Lysy1979: folds
Ira Duchenko: raises $0.20 to $0.22 and is all-in
manoblack51: folds
GoldeN0330: folds
LLregs: calls $0.20
*** FLOP *** [Ts 7d 7h]
*** TURN *** [Ts 7d 7h] [9h]
*** RIVER *** [Ts 7d 7h 9h] [Jh]
*** SHOW DOWN ***
LLregs: shows [Kc 9c] (two pair, Nines and Sevens)
Ira Duchenko: shows [Th Kh] (a flush, King high)
Ira Duchenko collected $0.43 from pot
*** SUMMARY ***
Total pot $0.45 | Rake $0.02
Board [Ts 7d 7h 9h Jh]
Seat 1: manoblack51 (button) folded before Flop (didn't bet)
Seat 2: GoldeN0330 (small blind) folded before Flop
Seat 3: LLregs (big blind) showed [Kc 9c] and lost with two pair, Nines and Sevens
Seat 4: nuttymuch folded before Flop (didn't bet)
Seat 5: Lysy1979 folded before Flop (didn't bet)
Seat 6: Ira Duchenko showed [Th Kh] and won ($0.43) with a flush, King high

PokerStars Zoom Hand #247960407781:  Hold'em No Limit ($0.01/$0.02) - 2023/12/30 15:49:54 WET [2023/12/30 10:49:54 ET]
Table 'Halley' 6-max Seat #1 is the button
Seat 1: TPB_088_PONG ($2.11 in chips)
Seat 2: Lysy1979 ($2.50 in chips)
Seat 3: JORDYLEON ($3.93 in chips)
Seat 4: graves80 ($2 in chips)
Seat 5: Ira Duchenko ($0.43 in chips)
Seat 6: LLregs ($3.34 in chips)
Lysy1979: posts small blind $0.01
JORDYLEON: posts big blind $0.02
*** HOLE CARDS ***
Dealt to LLregs [5s 2c]
graves80: folds
Ira Duchenko: folds
LLregs: folds
TPB_088_PONG: raises $0.03 to $0.05
Lysy1979: folds
JORDYLEON: folds
Uncalled bet ($0.03) returned to TPB_088_PONG
TPB_088_PONG collected $0.05 from pot
TPB_088_PONG: doesn't show hand
*** SUMMARY ***
Total pot $0.05 | Rake $0
Seat 1: TPB_088_PONG (button) collected ($0.05)
Seat 2: Lysy1979 (small blind) folded before Flop
Seat 3: JORDYLEON (big blind) folded before Flop
Seat 4: graves80 folded before Flop (didn't bet)
Seat 5: Ira Duchenko folded before Flop (didn't bet)
Seat 6: LLregs folded before Flop (didn't bet)

PokerStars Zoom Hand #247960408721:  Hold'em No Limit ($0.01/$0.02) - 2023/12/30 15:49:57 WET [2023/12/30 10:49:57 ET]
Table 'Halley' 6-max Seat #1 is the button
Seat 1: Shmatrixs ($3.23 in chips)
Seat 2: cawi1963 ($4.44 in chips)
Seat 3: 888lifeIS ($2 in chips)
Seat 4: One Day Big Win ($1.46 in chips)
Seat 5: LLregs ($3.34 in chips)
Seat 6: EU Legacy ($4.56 in chips)
cawi1963: posts small blind $0.01
888lifeIS: posts big blind $0.02
*** HOLE CARDS ***
Dealt to LLregs [2c 7h]
One Day Big Win: raises $0.03 to $0.05
LLregs: folds
EU Legacy: folds
Shmatrixs: folds
cawi1963: folds
888lifeIS: folds
Uncalled bet ($0.03) returned to One Day Big Win
One Day Big Win collected $0.05 from pot
One Day Big Win: doesn't show hand
*** SUMMARY ***
Total pot $0.05 | Rake $0
Seat 1: Shmatrixs (button) folded before Flop (didn't bet)
Seat 2: cawi1963 (small blind) folded before Flop
Seat 3: 888lifeIS (big blind) folded before Flop
Seat 4: One Day Big Win collected ($0.05)
Seat 5: LLregs folded before Flop (didn't bet)
Seat 6: EU Legacy folded before Flop (didn't bet)

PokerStars Zoom Hand #247960409919:  Hold'em No Limit ($0.01/$0.02) - 2023/12/30 15:50:01 WET [2023/12/30 10:50:01 ET]
Table 'Halley' 6-max Seat #1 is the button
Seat 1: LLregs ($3.34 in chips)
Seat 2: gaidzys gieda ($2.12 in chips)
Seat 3: Stariy_Iga ($2.15 in chips)
Seat 4: Arabescul ($2 in chips)
Seat 5: Shmatrixs ($3.23 in chips)
Seat 6: Lilikos60 ($1.53 in chips)
gaidzys gieda: posts small blind $0.01
Stariy_Iga: posts big blind $0.02
*** HOLE CARDS ***
Dealt to LLregs [Ks 7c]
Arabescul: folds
Shmatrixs: folds
Lilikos60: raises $0.02 to $0.04
LLregs: folds
gaidzys gieda: folds
Stariy_Iga: folds
Uncalled bet ($0.02) returned to Lilikos60
Lilikos60 collected $0.05 from pot
Lilikos60: doesn't show hand
*** SUMMARY ***
Total pot $0.05 | Rake $0
Seat 1: LLregs (button) folded before Flop (didn't bet)
Seat 2: gaidzys gieda (small blind) folded before Flop
Seat 3: Stariy_Iga (big blind) folded before Flop
Seat 4: Arabescul folded before Flop (didn't bet)
Seat 5: Shmatrixs folded before Flop (didn't bet)
Seat 6: Lilikos60 collected ($0.05)

PokerStars Zoom Hand #247960411155:  Hold'em No Limit ($0.01/$0.02) - 2023/12/30 15:50:06 WET [2023/12/30 10:50:06 ET]
Table 'Halley' 6-max Seat #1 is the button
Seat 1: BilugaMaster ($2.23 in chips)
Seat 2: LLregs ($3.34 in chips)
Seat 3: GEODO666 ($2.12 in chips)
Seat 4: TPB_088_PONG ($2.14 in chips)
Seat 5: 39REDMAN ($2.98 in chips)
Seat 6: Sperick ($5.55 in chips)
LLregs: posts small blind $0.01
GEODO666: posts big blind $0.02
*** HOLE CARDS ***
Dealt to LLregs [8s 3s]
TPB_088_PONG: raises $0.02 to $0.04
39REDMAN: folds
Sperick: folds
BilugaMaster: folds
LLregs: folds
GEODO666: folds
Uncalled bet ($0.02) returned to TPB_088_PONG
TPB_088_PONG collected $0.05 from pot
TPB_088_PONG: doesn't show hand
*** SUMMARY ***
Total pot $0.05 | Rake $0
Seat 1: BilugaMaster (button) folded before Flop (didn't bet)
Seat 2: LLregs (small blind) folded before Flop
Seat 3: GEODO666 (big blind) folded before Flop
Seat 4: TPB_088_PONG collected ($0.05)
Seat 5: 39REDMAN folded before Flop (didn't bet)
Seat 6: Sperick folded before Flop (didn't bet)

PokerStars Zoom Hand #247960413949:  Hold'em No Limit ($0.01/$0.02) - 2023/12/30 15:50:16 WET [2023/12/30 10:50:16 ET]
Table 'Halley' 6-max Seat #1 is the button
Seat 1: yuyupAAn ($2 in chips)
Seat 2: DeXxTroza ($2.52 in chips)
Seat 3: ZiggyBoy90 ($2.55 in chips)
Seat 4: Svartbäcken ($1.68 in chips)
Seat 5: LLregs ($3.33 in chips)
Seat 6: Lysy1979 ($2.49 in chips)
DeXxTroza: posts small blind $0.01
ZiggyBoy90: posts big blind $0.02
*** HOLE CARDS ***
Dealt to LLregs [3c 4h]
Svartbäcken: raises $0.04 to $0.06
LLregs: folds
Lysy1979: folds
yuyupAAn: folds
DeXxTroza: folds
ZiggyBoy90: folds
Uncalled bet ($0.04) returned to Svartbäcken
Svartbäcken collected $0.05 from pot
Svartbäcken: doesn't show hand
*** SUMMARY ***
Total pot $0.05 | Rake $0
Seat 1: yuyupAAn (button) folded before Flop (didn't bet)
Seat 2: DeXxTroza (small blind) folded before Flop
Seat 3: ZiggyBoy90 (big blind) folded before Flop
Seat 4: Svartbäcken collected ($0.05)
Seat 5: LLregs folded before Flop (didn't bet)
Seat 6: Lysy1979 folded before Flop (didn't bet)

PokerStars Zoom Hand #247960415352:  Hold'em No Limit ($0.01/$0.02) - 2023/12/30 15:50:21 WET [2023/12/30 10:50:21 ET]
Table 'Halley' 6-max Seat #1 is the button
Seat 1: Southview71 ($2.16 in chips)
Seat 2: akasku54 ($1.90 in chips)
Seat 3: LLregs ($3.33 in chips)
Seat 4: Gazz_Bax ($1.04 in chips)
Seat 5: Nutu1313 ($6.44 in chips)
Seat 6: Mamirox ($2 in chips)
akasku54: posts small blind $0.01
LLregs: posts big blind $0.02
*** HOLE CARDS ***
Dealt to LLregs [8c 4s]
Gazz_Bax: folds
Nutu1313: folds
Mamirox: raises $0.04 to $0.06
Southview71: folds
akasku54: folds
LLregs: folds
Uncalled bet ($0.04) returned to Mamirox
Mamirox collected $0.05 from pot
Mamirox: doesn't show hand
*** SUMMARY ***
Total pot $0.05 | Rake $0
Seat 1: Southview71 (button) folded before Flop (didn't bet)
Seat 2: akasku54 (small blind) folded before Flop
Seat 3: LLregs (big blind) folded before Flop
Seat 4: Gazz_Bax folded before Flop (didn't bet)
Seat 5: Nutu1313 folded before Flop (didn't bet)
Seat 6: Mamirox collected ($0.05)

PokerStars Zoom Hand #247960418755:  Hold'em No Limit ($0.01/$0.02) - 2023/12/30 15:50:33 WET [2023/12/30 10:50:33 ET]
Table 'Halley' 6-max Seat #1 is the button
Seat 1: DeadKiriyama ($5.03 in chips)
Seat 2: RodrigoNC340 ($3.21 in chips)
Seat 3: Playmaker_SA ($1.97 in chips)
Seat 4: karintou8888 ($2.92 in chips)
Seat 5: DeXxTroza ($2 in chips)
Seat 6: LLregs ($3.31 in chips)
RodrigoNC340: posts small blind $0.01
Playmaker_SA: posts big blind $0.02
*** HOLE CARDS ***
Dealt to LLregs [6d Qs]
karintou8888: folds
DeXxTroza: folds
LLregs: folds
DeadKiriyama: folds
RodrigoNC340: folds
Uncalled bet ($0.01) returned to Playmaker_SA
Playmaker_SA collected $0.02 from pot
Playmaker_SA: doesn't show hand
*** SUMMARY ***
Total pot $0.02 | Rake $0
Seat 1: DeadKiriyama (button) folded before Flop (didn't bet)
Seat 2: RodrigoNC340 (small blind) folded before Flop
Seat 3: Playmaker_SA (big blind) collected ($0.02)
Seat 4: karintou8888 folded before Flop (didn't bet)
Seat 5: DeXxTroza folded before Flop (didn't bet)
Seat 6: LLregs folded before Flop (didn't bet)

PokerStars Zoom Hand #247960421029:  Hold'em No Limit ($0.01/$0.02) - 2023/12/30 15:50:41 WET [2023/12/30 10:50:41 ET]
Table 'Halley' 6-max Seat #1 is the button
Seat 1: jandsonpower ($5.71 in chips)
Seat 2: 7zudluy7 ($1 in chips)
Seat 3: Mikeloko182 ($3.35 in chips)
Seat 4: LLregs ($3.31 in chips)
Seat 5: napoli222 ($2.56 in chips)
Seat 6: Gazz_Bax ($1.03 in chips)
7zudluy7: posts small blind $0.01
Mikeloko182: posts big blind $0.02
*** HOLE CARDS ***
Dealt to LLregs [2d 6c]
LLregs: folds
napoli222: folds
Gazz_Bax: folds
jandsonpower: raises $0.03 to $0.05
7zudluy7: folds
Mikeloko182: folds
Uncalled bet ($0.03) returned to jandsonpower
jandsonpower collected $0.05 from pot
jandsonpower: doesn't show hand
*** SUMMARY ***
Total pot $0.05 | Rake $0
Seat 1: jandsonpower (button) collected ($0.05)
Seat 2: 7zudluy7 (small blind) folded before Flop
Seat 3: Mikeloko182 (big blind) folded before Flop
Seat 4: LLregs folded before Flop (didn't bet)
Seat 5: napoli222 folded before Flop (didn't bet)
Seat 6: Gazz_Bax folded before Flop (didn't bet)

PokerStars Zoom Hand #247960423775:  Hold'em No Limit ($0.01/$0.02) - 2023/12/30 15:50:51 WET [2023/12/30 10:50:51 ET]
Table 'Halley' 6-max Seat #1 is the button
Seat 1: LLregs ($3.30 in chips)
Seat 2: Jenly1234 ($2.04 in chips)
Seat 3: Dexter9922 ($3.17 in chips)
Seat 4: magnus59 ($1.63 in chips)
Seat 5: ARES_312 ($1.87 in chips)
Seat 6: FEROIZ ($3.31 in chips)
Jenly1234: posts small blind $0.01
Dexter9922: posts big blind $0.02
*** HOLE CARDS ***
Dealt to LLregs [Jh 7c]
magnus59: folds
ARES_312: folds
FEROIZ: raises $0.03 to $0.05
LLregs: folds
Jenly1234: folds
Dexter9922: raises $0.20 to $0.25
FEROIZ: folds
Uncalled bet ($0.20) returned to Dexter9922
Dexter9922 collected $0.11 from pot
Dexter9922: doesn't show hand
*** SUMMARY ***
Total pot $0.11 | Rake $0
Seat 1: LLregs (button) folded before Flop (didn't bet)
Seat 2: Jenly1234 (small blind) folded before Flop
Seat 3: Dexter9922 (big blind) collected ($0.11)
Seat 4: magnus59 folded before Flop (didn't bet)
Seat 5: ARES_312 folded before Flop (didn't bet)
Seat 6: FEROIZ folded before Flop

PokerStars Zoom Hand #247960422426:  Hold'em No Limit ($0.01/$0.02) - 2023/12/30 15:50:46 WET [2023/12/30 10:50:46 ET]
Table 'Halley' 6-max Seat #1 is the button
Seat 1: BluffConquest ($1.07 in chips)
Seat 2: LLregs ($3.31 in chips)
Seat 3: nuttymuch ($7.29 in chips)
Seat 4: sexynurseama ($2.31 in chips)
Seat 5: Kalle_2509 ($1.51 in chips)
Seat 6: Makedonskiyy ($0.96 in chips)
LLregs: posts small blind $0.01
nuttymuch: posts big blind $0.02
*** HOLE CARDS ***
Dealt to LLregs [8d Ac]
sexynurseama: folds
Kalle_2509: folds
Makedonskiyy: raises $0.04 to $0.06
BluffConquest: calls $0.06
LLregs: folds
nuttymuch: calls $0.04
*** FLOP *** [Th 5h Ad]
nuttymuch: checks
Makedonskiyy: bets $0.09
BluffConquest: calls $0.09
nuttymuch: folds
*** TURN *** [Th 5h Ad] [5s]
Makedonskiyy: bets $0.27
BluffConquest: calls $0.27
*** RIVER *** [Th 5h Ad 5s] [7c]
Makedonskiyy: bets $0.54 and is all-in
BluffConquest: folds
Uncalled bet ($0.54) returned to Makedonskiyy
Makedonskiyy collected $0.88 from pot
Makedonskiyy: doesn't show hand
*** SUMMARY ***
Total pot $0.91 | Rake $0.03
Board [Th 5h Ad 5s 7c]
Seat 1: BluffConquest (button) folded on the River
Seat 2: LLregs (small blind) folded before Flop
Seat 3: nuttymuch (big blind) folded on the Flop
Seat 4: sexynurseama folded before Flop (didn't bet)
Seat 5: Kalle_2509 folded before Flop (didn't bet)
Seat 6: Makedonskiyy collected ($0.88)

PokerStars Zoom Hand #247960428587:  Hold'em No Limit ($0.01/$0.02) - 2023/12/30 15:51:08 WET [2023/12/30 10:51:08 ET]
Table 'Halley' 6-max Seat #1 is the button
Seat 1: Nutu1313 ($2 in chips)
Seat 2: 888lifeIS ($2.27 in chips)
Seat 3: LLregs ($3.30 in chips)
Seat 4: PozzzitiF ($0.85 in chips)
Seat 5: Dexter9922 ($3.23 in chips)
Seat 6: TanzeArango ($1.92 in chips)
888lifeIS: posts small blind $0.01
LLregs: posts big blind $0.02
*** HOLE CARDS ***
Dealt to LLregs [4c 7s]
PozzzitiF: folds
Dexter9922: folds
TanzeArango: folds
Nutu1313: raises $0.03 to $0.05
888lifeIS: folds
LLregs: folds
Uncalled bet ($0.03) returned to Nutu1313
Nutu1313 collected $0.05 from pot
Nutu1313: doesn't show hand
*** SUMMARY ***
Total pot $0.05 | Rake $0
Seat 1: Nutu1313 (button) collected ($0.05)
Seat 2: 888lifeIS (small blind) folded before Flop
Seat 3: LLregs (big blind) folded before Flop
Seat 4: PozzzitiF folded before Flop (didn't bet)
Seat 5: Dexter9922 folded before Flop (didn't bet)
Seat 6: TanzeArango folded before Flop (didn't bet)

PokerStars Zoom Hand #247960433380:  Hold'em No Limit ($0.01/$0.02) - 2023/12/30 15:51:25 WET [2023/12/30 10:51:25 ET]
Table 'Halley' 6-max Seat #1 is the button
Seat 1: Thooorrr ($2.29 in chips)
Seat 2: LLregs ($3.28 in chips)
Seat 3: Kimurarer ($1.44 in chips)
Seat 4: TanzeArango ($1.91 in chips)
Seat 5: Hollyweed_DOPE ($1.85 in chips)
Seat 6: FishAndFurious ($2 in chips)
LLregs: posts small blind $0.01
Kimurarer: posts big blind $0.02
*** HOLE CARDS ***
Dealt to LLregs [Kd 3c]
TanzeArango: folds
Hollyweed_DOPE: folds
FishAndFurious: raises $0.04 to $0.06
Thooorrr: raises $0.12 to $0.18
LLregs: folds
Kimurarer: folds
FishAndFurious: folds
Uncalled bet ($0.12) returned to Thooorrr
Thooorrr collected $0.15 from pot
Thooorrr: doesn't show hand
*** SUMMARY ***
Total pot $0.15 | Rake $0
Seat 1: Thooorrr (button) collected ($0.15)
Seat 2: LLregs (small blind) folded before Flop
Seat 3: Kimurarer (big blind) folded before Flop
Seat 4: TanzeArango folded before Flop (didn't bet)
Seat 5: Hollyweed_DOPE folded before Flop (didn't bet)
Seat 6: FishAndFurious folded before Flop

PokerStars Zoom Hand #247960427193:  Hold'em No Limit ($0.01/$0.02) - 2023/12/30 15:51:03 WET [2023/12/30 10:51:03 ET]
Table 'Halley' 6-max Seat #1 is the button
Seat 1: cc_midel ($1.49 in chips)
Seat 2: nikkem971 ($4.74 in chips)
Seat 3: ZiggyBoy90 ($2.34 in chips)
Seat 4: LLregs ($3.30 in chips)
Seat 5: OskyP ($3.95 in chips)
Seat 6: Loucomeloo ($2.11 in chips)
nikkem971: posts small blind $0.01
ZiggyBoy90: posts big blind $0.02
*** HOLE CARDS ***
Dealt to LLregs [Qs 6c]
LLregs: folds
OskyP: folds
Loucomeloo: folds
cc_midel: raises $0.03 to $0.05
nikkem971: calls $0.04
ZiggyBoy90: folds
*** FLOP *** [7c 6s Tc]
nikkem971: checks
cc_midel: bets $0.04
nikkem971: raises $0.10 to $0.14
cc_midel: calls $0.10
*** TURN *** [7c 6s Tc] [9h]
nikkem971: checks
cc_midel: checks
*** RIVER *** [7c 6s Tc 9h] [Ks]
nikkem971: checks
cc_midel: checks
*** SHOW DOWN ***
nikkem971: shows [Ac 3c] (high card Ace)
cc_midel: shows [Ad 7h] (a pair of Sevens)
cc_midel collected $0.39 from pot
*** SUMMARY ***
Total pot $0.40 | Rake $0.01
Board [7c 6s Tc 9h Ks]
Seat 1: cc_midel (button) showed [Ad 7h] and won ($0.39) with a pair of Sevens
Seat 2: nikkem971 (small blind) showed [Ac 3c] and lost with high card Ace
Seat 3: ZiggyBoy90 (big blind) folded before Flop
Seat 4: LLregs folded before Flop (didn't bet)
Seat 5: OskyP folded before Flop (didn't bet)
Seat 6: Loucomeloo folded before Flop (didn't bet)

PokerStars Zoom Hand #247960439173:  Hold'em No Limit ($0.01/$0.02) - 2023/12/30 15:51:45 WET [2023/12/30 10:51:45 ET]
Table 'Halley' 6-max Seat #1 is the button
Seat 1: PozzzitiF ($0.85 in chips)
Seat 2: Mamirox ($2.33 in chips)
Seat 3: devloper42 ($1.45 in chips)
Seat 4: praznina ($1.97 in chips)
Seat 5: LLregs ($3.27 in chips)
Seat 6: Ukr Troll ($5.69 in chips)
Mamirox: posts small blind $0.01
devloper42: posts big blind $0.02
*** HOLE CARDS ***
Dealt to LLregs [2h 8d]
praznina has timed out
praznina: folds
LLregs: folds
Ukr Troll: folds
PozzzitiF: folds
Mamirox: folds
Uncalled bet ($0.01) returned to devloper42
devloper42 collected $0.02 from pot
devloper42: doesn't show hand
*** SUMMARY ***
Total pot $0.02 | Rake $0
Seat 1: PozzzitiF (button) folded before Flop (didn't bet)
Seat 2: Mamirox (small blind) folded before Flop
Seat 3: devloper42 (big blind) collected ($0.02)
Seat 4: praznina folded before Flop (didn't bet)
Seat 5: LLregs folded before Flop (didn't bet)
Seat 6: Ukr Troll folded before Flop (didn't bet)

PokerStars Zoom Hand #247960425872:  Hold'em No Limit ($0.01/$0.02) - 2023/12/30 15:50:58 WET [2023/12/30 10:50:58 ET]
Table 'Halley' 6-max Seat #1 is the button
Seat 1: nerijus3000 ($1.49 in chips)
Seat 2: GEODO666 ($2.18 in chips)
Seat 3: praznina ($2 in chips)
Seat 4: napoli222 ($2.55 in chips)
Seat 5: Freyasdad333 ($2.24 in chips)
Seat 6: LLregs ($3.30 in chips)
GEODO666: posts small blind $0.01
praznina: posts big blind $0.02
*** HOLE CARDS ***
Dealt to LLregs [5h 9c]
napoli222: folds
Freyasdad333: raises $0.02 to $0.04
LLregs: folds
nerijus3000: folds
GEODO666: calls $0.03
praznina: folds
*** FLOP *** [Jc 9d 5s]
GEODO666: checks
Freyasdad333: bets $0.02
GEODO666: calls $0.02
*** TURN *** [Jc 9d 5s] [Ts]
GEODO666: bets $0.04
Freyasdad333: calls $0.04
*** RIVER *** [Jc 9d 5s Ts] [7c]
GEODO666: checks
Freyasdad333: checks
*** SHOW DOWN ***
GEODO666: shows [As 6s] (high card Ace)
Freyasdad333: shows [Jd Ad] (a pair of Jacks)
Freyasdad333 collected $0.21 from pot
*** SUMMARY ***
Total pot $0.22 | Rake $0.01
Board [Jc 9d 5s Ts 7c]
Seat 1: nerijus3000 (button) folded before Flop (didn't bet)
Seat 2: GEODO666 (small blind) showed [As 6s] and lost with high card Ace
Seat 3: praznina (big blind) folded before Flop
Seat 4: napoli222 folded before Flop (didn't bet)
Seat 5: Freyasdad333 showed [Jd Ad] and won ($0.21) with a pair of Jacks
Seat 6: LLregs folded before Flop (didn't bet)

PokerStars Zoom Hand #247960440609:  Hold'em No Limit ($0.01/$0.02) - 2023/12/30 15:51:51 WET [2023/12/30 10:51:51 ET]
Table 'Halley' 6-max Seat #1 is the button
Seat 1: LLregs ($3.27 in chips)
Seat 2: sexynurseama ($3.14 in chips)
Seat 3: marcegring ($3.57 in chips)
Seat 4: Makedonskiyy ($0.74 in chips)
Seat 5: chinex_sba ($2.61 in chips)
Seat 6: iliyan66 ($10.46 in chips)
sexynurseama: posts small blind $0.01
marcegring: posts big blind $0.02
*** HOLE CARDS ***
Dealt to LLregs [Ah Kh]
Makedonskiyy: folds
chinex_sba: folds
iliyan66: folds
LLregs: raises $0.04 to $0.06
sexynurseama: folds
marcegring: folds
Uncalled bet ($0.04) returned to LLregs
LLregs collected $0.05 from pot
LLregs: doesn't show hand
*** SUMMARY ***
Total pot $0.05 | Rake $0
Seat 1: LLregs (button) collected ($0.05)
Seat 2: sexynurseama (small blind) folded before Flop
Seat 3: marcegring (big blind) folded before Flop
Seat 4: Makedonskiyy folded before Flop (didn't bet)
Seat 5: chinex_sba folded before Flop (didn't bet)
Seat 6: iliyan66 folded before Flop (didn't bet)

PokerStars Zoom Hand #247960445736:  Hold'em No Limit ($0.01/$0.02) - 2023/12/30 15:52:09 WET [2023/12/30 10:52:09 ET]
Table 'Halley' 6-max Seat #1 is the button
Seat 1: PozzzitiF ($0.95 in chips)
Seat 2: kyriarxoss ($2.41 in chips)
Seat 3: inhonestus ($2.04 in chips)
Seat 4: ivciks74lv ($6.50 in chips)
Seat 5: LLregs ($3.30 in chips)
Seat 6: Alehan124 ($0.97 in chips)
kyriarxoss: posts small blind $0.01
inhonestus: posts big blind $0.02
*** HOLE CARDS ***
Dealt to LLregs [9d 2d]
ivciks74lv: folds
LLregs: folds
Alehan124: folds
PozzzitiF: folds
kyriarxoss: folds
Uncalled bet ($0.01) returned to inhonestus
inhonestus collected $0.02 from pot
inhonestus: doesn't show hand
*** SUMMARY ***
Total pot $0.02 | Rake $0
Seat 1: PozzzitiF (button) folded before Flop (didn't bet)
Seat 2: kyriarxoss (small blind) folded before Flop
Seat 3: inhonestus (big blind) collected ($0.02)
Seat 4: ivciks74lv folded before Flop (didn't bet)
Seat 5: LLregs folded before Flop (didn't bet)
Seat 6: Alehan124 folded before Flop (didn't bet)

PokerStars Zoom Hand #247960448156:  Hold'em No Limit ($0.01/$0.02) - 2023/12/30 15:52:17 WET [2023/12/30 10:52:17 ET]
Table 'Halley' 6-max Seat #1 is the button
Seat 1: Jose1234584 ($2.42 in chips)
Seat 2: Thooorrr ($2 in chips)
Seat 3: LLregs ($3.30 in chips)
Seat 4: kuelas ($1.85 in chips)
Seat 5: nuttymuch ($7.25 in chips)
Seat 6: AllstarCon ($2.43 in chips)
Thooorrr: posts small blind $0.01
LLregs: posts big blind $0.02
*** HOLE CARDS ***
Dealt to LLregs [6h 5c]
kuelas: folds
nuttymuch: folds
AllstarCon: raises $0.03 to $0.05
Jose1234584: folds
Thooorrr: folds
LLregs: folds
Uncalled bet ($0.03) returned to AllstarCon
AllstarCon collected $0.05 from pot
AllstarCon: doesn't show hand
*** SUMMARY ***
Total pot $0.05 | Rake $0
Seat 1: Jose1234584 (button) folded before Flop (didn't bet)
Seat 2: Thooorrr (small blind) folded before Flop
Seat 3: LLregs (big blind) folded before Flop
Seat 4: kuelas folded before Flop (didn't bet)
Seat 5: nuttymuch folded before Flop (didn't bet)
Seat 6: AllstarCon collected ($0.05)

PokerStars Zoom Hand #247960450104:  Hold'em No Limit ($0.01/$0.02) - 2023/12/30 15:52:24 WET [2023/12/30 10:52:24 ET]
Table 'Halley' 6-max Seat #1 is the button
Seat 1: ungiwar ($0.87 in chips)
Seat 2: LLregs ($3.28 in chips)
Seat 3: magnus59 ($1.52 in chips)
Seat 4: karintou8888 ($5.41 in chips)
Seat 5: Jose1234584 ($2.42 in chips)
Seat 6: voathur ($2 in chips)
LLregs: posts small blind $0.01
magnus59: posts big blind $0.02
*** HOLE CARDS ***
Dealt to LLregs [Jd 8h]
karintou8888: folds
Jose1234584: folds
voathur: folds
ungiwar: folds
LLregs: folds
Uncalled bet ($0.01) returned to magnus59
magnus59 collected $0.02 from pot
magnus59: doesn't show hand
*** SUMMARY ***
Total pot $0.02 | Rake $0
Seat 1: ungiwar (button) folded before Flop (didn't bet)
Seat 2: LLregs (small blind) folded before Flop
Seat 3: magnus59 (big blind) collected ($0.02)
Seat 4: karintou8888 folded before Flop (didn't bet)
Seat 5: Jose1234584 folded before Flop (didn't bet)
Seat 6: voathur folded before Flop (didn't bet)

PokerStars Zoom Hand #247960446913:  Hold'em No Limit ($0.01/$0.02) - 2023/12/30 15:52:12 WET [2023/12/30 10:52:12 ET]
Table 'Halley' 6-max Seat #1 is the button
Seat 1: zoran445 ($0.95 in chips)
Seat 2: MXLVI ($2.04 in chips)
Seat 3: Dexter9922 ($3.15 in chips)
Seat 4: Makedonskiyy ($0.64 in chips)
Seat 5: leedsrounder ($2.57 in chips)
Seat 6: LLregs ($3.30 in chips)
MXLVI: posts small blind $0.01
Dexter9922: posts big blind $0.02
*** HOLE CARDS ***
Dealt to LLregs [2s Ah]
Makedonskiyy: raises $0.02 to $0.04
leedsrounder: folds
LLregs: folds
zoran445: folds
MXLVI: folds
Dexter9922: folds
Uncalled bet ($0.02) returned to Makedonskiyy
Makedonskiyy collected $0.05 from pot
Makedonskiyy: doesn't show hand
*** SUMMARY ***
Total pot $0.05 | Rake $0
Seat 1: zoran445 (button) folded before Flop (didn't bet)
Seat 2: MXLVI (small blind) folded before Flop
Seat 3: Dexter9922 (big blind) folded before Flop
Seat 4: Makedonskiyy collected ($0.05)
Seat 5: leedsrounder folded before Flop (didn't bet)
Seat 6: LLregs folded before Flop (didn't bet)

PokerStars Zoom Hand #247960452376:  Hold'em No Limit ($0.01/$0.02) - 2023/12/30 15:52:32 WET [2023/12/30 10:52:32 ET]
Table 'Halley' 6-max Seat #1 is the button
Seat 1: FishAndFurious ($3.87 in chips)
Seat 2: NeckCarp ($0.98 in chips)
Seat 3: Loucomeloo ($2 in chips)
Seat 4: fa1kon ($4.64 in chips)
Seat 5: LLregs ($3.27 in chips)
Seat 6: ImpEdGard ($2.35 in chips)
NeckCarp: posts small blind $0.01
Loucomeloo: posts big blind $0.02
*** HOLE CARDS ***
Dealt to LLregs [Ts 4s]
fa1kon: folds
LLregs: folds
ImpEdGard: folds
FishAndFurious: folds
NeckCarp: raises $0.02 to $0.04
Loucomeloo: raises $0.08 to $0.12
NeckCarp: folds
Uncalled bet ($0.08) returned to Loucomeloo
Loucomeloo collected $0.08 from pot
Loucomeloo: doesn't show hand
*** SUMMARY ***
Total pot $0.08 | Rake $0
Seat 1: FishAndFurious (button) folded before Flop (didn't bet)
Seat 2: NeckCarp (small blind) folded before Flop
Seat 3: Loucomeloo (big blind) collected ($0.08)
Seat 4: fa1kon folded before Flop (didn't bet)
Seat 5: LLregs folded before Flop (didn't bet)
Seat 6: ImpEdGard folded before Flop (didn't bet)

PokerStars Zoom Hand #247960453757:  Hold'em No Limit ($0.01/$0.02) - 2023/12/30 15:52:37 WET [2023/12/30 10:52:37 ET]
Table 'Halley' 6-max Seat #1 is the button
Seat 1: LLregs ($3.27 in chips)
Seat 2: Fearedhel ($2.99 in chips)
Seat 3: Floggy73 ($3.66 in chips)
Seat 4: MirianAraujo ($1.15 in chips)
Seat 5: Shmatrixs ($3.33 in chips)
Seat 6: ARES_312 ($1.97 in chips)
Fearedhel: posts small blind $0.01
Floggy73: posts big blind $0.02
*** HOLE CARDS ***
Dealt to LLregs [5s Qs]
MirianAraujo: folds
Shmatrixs: folds
ARES_312: raises $0.03 to $0.05
LLregs: folds
Fearedhel: calls $0.04
Floggy73: folds
*** FLOP *** [9s 5h Kc]
Fearedhel: checks
ARES_312: checks
*** TURN *** [9s 5h Kc] [Kh]
Fearedhel: bets $0.06
ARES_312: folds
Uncalled bet ($0.06) returned to Fearedhel
Fearedhel collected $0.12 from pot
Fearedhel: doesn't show hand
*** SUMMARY ***
Total pot $0.12 | Rake $0
Board [9s 5h Kc Kh]
Seat 1: LLregs (button) folded before Flop (didn't bet)
Seat 2: Fearedhel (small blind) collected ($0.12)
Seat 3: Floggy73 (big blind) folded before Flop
Seat 4: MirianAraujo folded before Flop (didn't bet)
Seat 5: Shmatrixs folded before Flop (didn't bet)
Seat 6: ARES_312 folded on the Turn

PokerStars Zoom Hand #247960459980:  Hold'em No Limit ($0.01/$0.02) - 2023/12/30 15:52:59 WET [2023/12/30 10:52:59 ET]
Table 'Halley' 6-max Seat #1 is the button
Seat 1: Vimpex ($1.25 in chips)
Seat 2: giantmonkey36 ($2 in chips)
Seat 3: Makedonskiyy ($0.31 in chips)
Seat 4: LLregs ($3.27 in chips)
Seat 5: Ukr Troll ($10.76 in chips)
Seat 6: iliyan66 ($5.04 in chips)
giantmonkey36: posts small blind $0.01
Makedonskiyy: posts big blind $0.02
*** HOLE CARDS ***
Dealt to LLregs [Jd Kc]
LLregs: raises $0.04 to $0.06
Ukr Troll: folds
iliyan66: folds
Vimpex: calls $0.06
giantmonkey36: folds
Makedonskiyy: folds
*** FLOP *** [5h Ks 3h]
LLregs: bets $0.07
Vimpex: calls $0.07
*** TURN *** [5h Ks 3h] [8s]
LLregs: checks
Vimpex: bets $0.14
LLregs: calls $0.14
*** RIVER *** [5h Ks 3h 8s] [Ts]
LLregs: checks
Vimpex: checks
*** SHOW DOWN ***
LLregs: shows [Jd Kc] (a pair of Kings)
Vimpex: mucks hand
LLregs collected $0.55 from pot
*** SUMMARY ***
Total pot $0.57 | Rake $0.02
Board [5h Ks 3h 8s Ts]
Seat 1: Vimpex (button) mucked [9s 9h]
Seat 2: giantmonkey36 (small blind) folded before Flop
Seat 3: Makedonskiyy (big blind) folded before Flop
Seat 4: LLregs showed [Jd Kc] and won ($0.55) with a pair of Kings
Seat 5: Ukr Troll folded before Flop (didn't bet)
Seat 6: iliyan66 folded before Flop (didn't bet)

PokerStars Zoom Hand #247960470908:  Hold'em No Limit ($0.01/$0.02) - 2023/12/30 15:53:37 WET [2023/12/30 10:53:37 ET]
Table 'Halley' 6-max Seat #1 is the button
Seat 1: V. Nikon ($0.91 in chips)
Seat 2: LLregs ($3.55 in chips)
Seat 3: MXLVI ($2 in chips)
Seat 4: cr@sh test ($2 in chips)
Seat 5: sexynurseama ($2.06 in chips)
Seat 6: rdp86 ($2.33 in chips)
LLregs: posts small blind $0.01
MXLVI: posts big blind $0.02
*** HOLE CARDS ***
Dealt to LLregs [8s 7d]
cr@sh test: raises $0.02 to $0.04
sexynurseama: raises $0.06 to $0.10
rdp86: folds
V. Nikon: folds
LLregs: folds
MXLVI: folds
cr@sh test: calls $0.06
*** FLOP *** [Kh 2s 3d]
cr@sh test: checks
sexynurseama: bets $0.11
cr@sh test: folds
Uncalled bet ($0.11) returned to sexynurseama
sexynurseama collected $0.22 from pot
sexynurseama: doesn't show hand
*** SUMMARY ***
Total pot $0.23 | Rake $0.01
Board [Kh 2s 3d]
Seat 1: V. Nikon (button) folded before Flop (didn't bet)
Seat 2: LLregs (small blind) folded before Flop
Seat 3: MXLVI (big blind) folded before Flop
Seat 4: cr@sh test folded on the Flop
Seat 5: sexynurseama collected ($0.22)
Seat 6: rdp86 folded before Flop (didn't bet)

PokerStars Zoom Hand #247960471908:  Hold'em No Limit ($0.01/$0.02) - 2023/12/30 15:53:41 WET [2023/12/30 10:53:41 ET]
Table 'Halley' 6-max Seat #1 is the button
Seat 1: leon69heart ($1.99 in chips)
Seat 2: TPB_088_PONG ($2.34 in chips)
Seat 3: LLregs ($3.54 in chips)
Seat 4: 888lifeIS ($2 in chips)
Seat 5: Floggy73 ($3.61 in chips)
Seat 6: M1k3B4gUnc1nh4 ($2.04 in chips)
TPB_088_PONG: posts small blind $0.01
LLregs: posts big blind $0.02
*** HOLE CARDS ***
Dealt to LLregs [Qh Qc]
888lifeIS: folds
Floggy73: folds
M1k3B4gUnc1nh4: raises $0.02 to $0.04
leon69heart: calls $0.04
TPB_088_PONG: folds
LLregs: raises $0.14 to $0.18
M1k3B4gUnc1nh4: calls $0.14
leon69heart: calls $0.14
*** FLOP *** [Js 3d 6d]
LLregs: bets $0.25
M1k3B4gUnc1nh4: folds
leon69heart: calls $0.25
*** TURN *** [Js 3d 6d] [Qd]
LLregs: checks
leon69heart: checks
*** RIVER *** [Js 3d 6d Qd] [Ad]
LLregs: bets $0.33
leon69heart: folds
Uncalled bet ($0.33) returned to LLregs
LLregs collected $1.01 from pot
LLregs: doesn't show hand
*** SUMMARY ***
Total pot $1.05 | Rake $0.04
Board [Js 3d 6d Qd Ad]
Seat 1: leon69heart (button) folded on the River
Seat 2: TPB_088_PONG (small blind) folded before Flop
Seat 3: LLregs (big blind) collected ($1.01)
Seat 4: 888lifeIS folded before Flop (didn't bet)
Seat 5: Floggy73 folded before Flop (didn't bet)
Seat 6: M1k3B4gUnc1nh4 folded on the Flop

PokerStars Zoom Hand #247960489107:  Hold'em No Limit ($0.01/$0.02) - 2023/12/30 15:54:41 WET [2023/12/30 10:54:41 ET]
Table 'Halley' 6-max Seat #1 is the button
Seat 1: Thooorrr ($2.44 in chips)
Seat 2: EU Legacy ($4.32 in chips)
Seat 3: japob ($2.46 in chips)
Seat 4: theprince188 ($2 in chips)
Seat 5: magnus59 ($1.53 in chips)
Seat 6: LLregs ($4.12 in chips)
EU Legacy: posts small blind $0.01
japob: posts big blind $0.02
*** HOLE CARDS ***
Dealt to LLregs [Jd 3h]
theprince188: folds
magnus59: folds
LLregs has timed out
LLregs: folds
Thooorrr: raises $0.03 to $0.05
EU Legacy: folds
japob: folds
Uncalled bet ($0.03) returned to Thooorrr
Thooorrr collected $0.05 from pot
Thooorrr: doesn't show hand
*** SUMMARY ***
Total pot $0.05 | Rake $0
Seat 1: Thooorrr (button) collected ($0.05)
Seat 2: EU Legacy (small blind) folded before Flop
Seat 3: japob (big blind) folded before Flop
Seat 4: theprince188 folded before Flop (didn't bet)
Seat 5: magnus59 folded before Flop (didn't bet)
Seat 6: LLregs folded before Flop (didn't bet)

PokerStars Zoom Hand #247960495387:  Hold'em No Limit ($0.01/$0.02) - 2023/12/30 15:55:03 WET [2023/12/30 10:55:03 ET]
Table 'Halley' 6-max Seat #1 is the button
Seat 1: Dimoni797979 ($1.55 in chips)
Seat 2: Playmaker_SA ($1.59 in chips)
Seat 3: Jhon Rambo.CL ($6.37 in chips)
Seat 4: LLregs ($4.12 in chips)
Seat 5: MXLVI ($2 in chips)
Seat 6: kuelas ($1.69 in chips)
Playmaker_SA: posts small blind $0.01
Jhon Rambo.CL: posts big blind $0.02
*** HOLE CARDS ***
Dealt to LLregs [7d Ts]
LLregs: folds
MXLVI: folds
kuelas: folds
Dimoni797979: folds
Playmaker_SA: folds
Uncalled bet ($0.01) returned to Jhon Rambo.CL
Jhon Rambo.CL collected $0.02 from pot
Jhon Rambo.CL: doesn't show hand
*** SUMMARY ***
Total pot $0.02 | Rake $0
Seat 1: Dimoni797979 (button) folded before Flop (didn't bet)
Seat 2: Playmaker_SA (small blind) folded before Flop
Seat 3: Jhon Rambo.CL (big blind) collected ($0.02)
Seat 4: LLregs folded before Flop (didn't bet)
Seat 5: MXLVI folded before Flop (didn't bet)
Seat 6: kuelas folded before Flop (didn't bet)

PokerStars Zoom Hand #247960496341:  Hold'em No Limit ($0.01/$0.02) - 2023/12/30 15:55:07 WET [2023/12/30 10:55:07 ET]
Table 'Halley' 6-max Seat #1 is the button
Seat 1: Thooorrr ($2.47 in chips)
Seat 2: Gazz_Bax ($2.57 in chips)
Seat 3: V. Nikon ($0.82 in chips)
Seat 4: LLregs ($4.12 in chips)
Seat 5: DonChone ($1.47 in chips)
Seat 6: ifiret68 ($2 in chips)
Gazz_Bax: posts small blind $0.01
V. Nikon: posts big blind $0.02
*** HOLE CARDS ***
Dealt to LLregs [5c Td]
LLregs: folds
DonChone: folds
ifiret68: folds
Thooorrr: folds
Gazz_Bax: folds
Uncalled bet ($0.01) returned to V. Nikon
V. Nikon collected $0.02 from pot
V. Nikon: doesn't show hand
*** SUMMARY ***
Total pot $0.02 | Rake $0
Seat 1: Thooorrr (button) folded before Flop (didn't bet)
Seat 2: Gazz_Bax (small blind) folded before Flop
Seat 3: V. Nikon (big blind) collected ($0.02)
Seat 4: LLregs folded before Flop (didn't bet)
Seat 5: DonChone folded before Flop (didn't bet)
Seat 6: ifiret68 folded before Flop (didn't bet)

PokerStars Zoom Hand #247960497068:  Hold'em No Limit ($0.01/$0.02) - 2023/12/30 15:55:10 WET [2023/12/30 10:55:10 ET]
Table 'Halley' 6-max Seat #1 is the button
Seat 1: Jonupoi ($1.48 in chips)
Seat 2: sexynurseama ($2.94 in chips)
Seat 3: praznina ($2.71 in chips)
Seat 4: nuttymuch ($7.24 in chips)
Seat 5: LLregs ($4.12 in chips)
Seat 6: VIDOPRO23 ($2.80 in chips)
sexynurseama: posts small blind $0.01
praznina: posts big blind $0.02
*** HOLE CARDS ***
Dealt to LLregs [2h Js]
nuttymuch: folds
LLregs: folds
VIDOPRO23: folds
Jonupoi: folds
sexynurseama: folds
Uncalled bet ($0.01) returned to praznina
praznina collected $0.02 from pot
praznina: doesn't show hand
*** SUMMARY ***
Total pot $0.02 | Rake $0
Seat 1: Jonupoi (button) folded before Flop (didn't bet)
Seat 2: sexynurseama (small blind) folded before Flop
Seat 3: praznina (big blind) collected ($0.02)
Seat 4: nuttymuch folded before Flop (didn't bet)
Seat 5: LLregs folded before Flop (didn't bet)
Seat 6: VIDOPRO23 folded before Flop (didn't bet)

PokerStars Zoom Hand #247960498532:  Hold'em No Limit ($0.01/$0.02) - 2023/12/30 15:55:17 WET [2023/12/30 10:55:17 ET]
Table 'Halley' 6-max Seat #1 is the button
Seat 1: Castiel_Ivy ($2.04 in chips)
Seat 2: LLregs ($4.12 in chips)
Seat 3: FishAndFurious ($3.86 in chips)
Seat 4: Jose1234584 ($1.97 in chips)
Seat 5: Jonupoi ($1.48 in chips)
Seat 6: gaidzys gieda ($1.95 in chips)
LLregs: posts small blind $0.01
FishAndFurious: posts big blind $0.02
*** HOLE CARDS ***
Dealt to LLregs [3s Kd]
Jose1234584: raises $0.02 to $0.04
Jonupoi: folds
gaidzys gieda has timed out
gaidzys gieda: folds
Castiel_Ivy: folds
LLregs: folds
FishAndFurious: folds
Uncalled bet ($0.02) returned to Jose1234584
Jose1234584 collected $0.05 from pot
Jose1234584: doesn't show hand
*** SUMMARY ***
Total pot $0.05 | Rake $0
Seat 1: Castiel_Ivy (button) folded before Flop (didn't bet)
Seat 2: LLregs (small blind) folded before Flop
Seat 3: FishAndFurious (big blind) folded before Flop
Seat 4: Jose1234584 collected ($0.05)
Seat 5: Jonupoi folded before Flop (didn't bet)
Seat 6: gaidzys gieda folded before Flop (didn't bet)

PokerStars Zoom Hand #247960500429:  Hold'em No Limit ($0.01/$0.02) - 2023/12/30 15:55:26 WET [2023/12/30 10:55:26 ET]
Table 'Halley' 6-max Seat #1 is the button
Seat 1: PozzzitiF ($0.88 in chips)
Seat 2: FEROIZ ($1.90 in chips)
Seat 3: LLregs ($4.11 in chips)
Seat 4: lottokahe2 ($1.67 in chips)
Seat 5: cr@sh test ($2 in chips)
Seat 6: PR3SUR3 ($5.53 in chips)
FEROIZ: posts small blind $0.01
LLregs: posts big blind $0.02
*** HOLE CARDS ***
Dealt to LLregs [9d 6c]
lottokahe2: folds
cr@sh test: folds
PR3SUR3: raises $0.03 to $0.05
PozzzitiF: folds
FEROIZ: folds
LLregs: folds
Uncalled bet ($0.03) returned to PR3SUR3
PR3SUR3 collected $0.05 from pot
PR3SUR3: doesn't show hand
*** SUMMARY ***
Total pot $0.05 | Rake $0
Seat 1: PozzzitiF (button) folded before Flop (didn't bet)
Seat 2: FEROIZ (small blind) folded before Flop
Seat 3: LLregs (big blind) folded before Flop
Seat 4: lottokahe2 folded before Flop (didn't bet)
Seat 5: cr@sh test folded before Flop (didn't bet)
Seat 6: PR3SUR3 collected ($0.05)

PokerStars Zoom Hand #247960494007:  Hold'em No Limit ($0.01/$0.02) - 2023/12/30 15:54:58 WET [2023/12/30 10:54:58 ET]
Table 'Halley' 6-max Seat #1 is the button
Seat 1: LLregs ($4.12 in chips)
Seat 2: manuelaiulia ($1.24 in chips)
Seat 3: Sperick ($4.99 in chips)
Seat 4: rdp86 ($2.39 in chips)
Seat 5: Kimurarer ($1.90 in chips)
Seat 6: Fearedhel ($5.45 in chips)
manuelaiulia: posts small blind $0.01
Sperick: posts big blind $0.02
*** HOLE CARDS ***
Dealt to LLregs [3s 9h]
rdp86: folds
Kimurarer: folds
Fearedhel: calls $0.02
LLregs: folds
manuelaiulia: calls $0.01
Sperick: checks
*** FLOP *** [Qc 2h 8h]
manuelaiulia: checks
Sperick: checks
Fearedhel: bets $0.02
manuelaiulia: calls $0.02
Sperick: folds
*** TURN *** [Qc 2h 8h] [5c]
manuelaiulia: checks
Fearedhel: checks
*** RIVER *** [Qc 2h 8h 5c] [8s]
manuelaiulia: checks
Fearedhel: checks
*** SHOW DOWN ***
manuelaiulia: shows [2d 7h] (two pair, Eights and Deuces)
Fearedhel: mucks hand
manuelaiulia collected $0.10 from pot
*** SUMMARY ***
Total pot $0.10 | Rake $0
Board [Qc 2h 8h 5c 8s]
Seat 1: LLregs (button) folded before Flop (didn't bet)
Seat 2: manuelaiulia (small blind) showed [2d 7h] and won ($0.10) with two pair, Eights and Deuces
Seat 3: Sperick (big blind) folded on the Flop
Seat 4: rdp86 folded before Flop (didn't bet)
Seat 5: Kimurarer folded before Flop (didn't bet)
Seat 6: Fearedhel mucked [Td 9c]

PokerStars Zoom Hand #247960505453:  Hold'em No Limit ($0.01/$0.02) - 2023/12/30 15:55:49 WET [2023/12/30 10:55:49 ET]
Table 'Halley' 6-max Seat #1 is the button
Seat 1: nerijus3000 ($2.30 in chips)
Seat 2: Dimoni797979 ($1.45 in chips)
Seat 3: napoli222 ($2.03 in chips)
Seat 4: LLregs ($4.09 in chips)
Seat 5: voathur ($1.98 in chips)
Seat 6: manoblack51 ($2 in chips)
Dimoni797979: posts small blind $0.01
napoli222: posts big blind $0.02
*** HOLE CARDS ***
Dealt to LLregs [6h 2s]
LLregs: folds
voathur: folds
manoblack51: folds
nerijus3000: folds
Dimoni797979: folds
Uncalled bet ($0.01) returned to napoli222
napoli222 collected $0.02 from pot
napoli222: doesn't show hand
*** SUMMARY ***
Total pot $0.02 | Rake $0
Seat 1: nerijus3000 (button) folded before Flop (didn't bet)
Seat 2: Dimoni797979 (small blind) folded before Flop
Seat 3: napoli222 (big blind) collected ($0.02)
Seat 4: LLregs folded before Flop (didn't bet)
Seat 5: voathur folded before Flop (didn't bet)
Seat 6: manoblack51 folded before Flop (didn't bet)

PokerStars Zoom Hand #247960502853:  Hold'em No Limit ($0.01/$0.02) - 2023/12/30 15:55:37 WET [2023/12/30 10:55:37 ET]
Table 'Halley' 6-max Seat #1 is the button
Seat 1: Playmaker_SA ($1.61 in chips)
Seat 2: cc_midel ($2.16 in chips)
Seat 3: PozzzitiF ($0.88 in chips)
Seat 4: Castiel_Ivy ($2.03 in chips)
Seat 5: sexynurseama ($2.90 in chips)
Seat 6: LLregs ($4.09 in chips)
cc_midel: posts small blind $0.01
PozzzitiF: posts big blind $0.02
*** HOLE CARDS ***
Dealt to LLregs [9s Jd]
Castiel_Ivy: calls $0.02
sexynurseama: raises $0.04 to $0.06
LLregs: folds
Playmaker_SA: folds
cc_midel: folds
PozzzitiF: folds
Castiel_Ivy: folds
Uncalled bet ($0.04) returned to sexynurseama
sexynurseama collected $0.07 from pot
sexynurseama: doesn't show hand
*** SUMMARY ***
Total pot $0.07 | Rake $0
Seat 1: Playmaker_SA (button) folded before Flop (didn't bet)
Seat 2: cc_midel (small blind) folded before Flop
Seat 3: PozzzitiF (big blind) folded before Flop
Seat 4: Castiel_Ivy folded before Flop
Seat 5: sexynurseama collected ($0.07)
Seat 6: LLregs folded before Flop (didn't bet)

PokerStars Zoom Hand #247960506355:  Hold'em No Limit ($0.01/$0.02) - 2023/12/30 15:55:53 WET [2023/12/30 10:55:53 ET]
Table 'Halley' 6-max Seat #1 is the button
Seat 1: LLregs ($4.09 in chips)
Seat 2: Kimurarer ($1.85 in chips)
Seat 3: Shmatrixs ($2.25 in chips)
Seat 4: theprince188 ($9.36 in chips)
Seat 5: tyzlit ($2.29 in chips)
Seat 6: nerijus3000 ($2.30 in chips)
Kimurarer: posts small blind $0.01
Shmatrixs: posts big blind $0.02
*** HOLE CARDS ***
Dealt to LLregs [Qd Kd]
theprince188: raises $0.03 to $0.05
tyzlit: folds
nerijus3000: folds
LLregs: raises $0.11 to $0.16
Kimurarer: folds
Shmatrixs: calls $0.14
theprince188: folds
*** FLOP *** [5d 2s 4h]
Shmatrixs: checks
LLregs: checks
*** TURN *** [5d 2s 4h] [Qh]
Shmatrixs: checks
LLregs: bets $0.08
Shmatrixs: calls $0.08
*** RIVER *** [5d 2s 4h Qh] [Jc]
Shmatrixs: checks
LLregs: bets $0.23
Shmatrixs: folds
Uncalled bet ($0.23) returned to LLregs
LLregs collected $0.52 from pot
LLregs: doesn't show hand
*** SUMMARY ***
Total pot $0.54 | Rake $0.02
Board [5d 2s 4h Qh Jc]
Seat 1: LLregs (button) collected ($0.52)
Seat 2: Kimurarer (small blind) folded before Flop
Seat 3: Shmatrixs (big blind) folded on the River
Seat 4: theprince188 folded before Flop
Seat 5: tyzlit folded before Flop (didn't bet)
Seat 6: nerijus3000 folded before Flop (didn't bet)

PokerStars Zoom Hand #247960521942:  Hold'em No Limit ($0.01/$0.02) - 2023/12/30 15:57:04 WET [2023/12/30 10:57:04 ET]
Table 'Halley' 6-max Seat #1 is the button
Seat 1: DonChone ($1.57 in chips)
Seat 2: LLregs ($4.37 in chips)
Seat 3: marcegring ($2.36 in chips)
Seat 4: WarriorM7 ($2.78 in chips)
Seat 5: NeckCarp ($0.66 in chips)
Seat 6: FishAndFurious ($2.08 in chips)
LLregs: posts small blind $0.01
marcegring: posts big blind $0.02
*** HOLE CARDS ***
Dealt to LLregs [8d As]
WarriorM7: folds
NeckCarp: folds
FishAndFurious: folds
DonChone: raises $0.02 to $0.04
LLregs: raises $0.08 to $0.12
marcegring: folds
DonChone: folds
Uncalled bet ($0.08) returned to LLregs
LLregs collected $0.10 from pot
LLregs: doesn't show hand
*** SUMMARY ***
Total pot $0.10 | Rake $0
Seat 1: DonChone (button) folded before Flop
Seat 2: LLregs (small blind) collected ($0.10)
Seat 3: marcegring (big blind) folded before Flop
Seat 4: WarriorM7 folded before Flop (didn't bet)
Seat 5: NeckCarp folded before Flop (didn't bet)
Seat 6: FishAndFurious folded before Flop (didn't bet)

PokerStars Zoom Hand #247960521096:  Hold'em No Limit ($0.01/$0.02) - 2023/12/30 15:57:00 WET [2023/12/30 10:57:00 ET]
Table 'Halley' 6-max Seat #1 is the button
Seat 1: ungiwar ($0.75 in chips)
Seat 2: Nutu1313 ($6.40 in chips)
Seat 3: AwesomeKick ($1.95 in chips)
Seat 4: gaidzys gieda ($1.88 in chips)
Seat 5: Mumbeer1978 ($1.71 in chips)
Seat 6: LLregs ($4.37 in chips)
Nutu1313: posts small blind $0.01
AwesomeKick: posts big blind $0.02
*** HOLE CARDS ***
Dealt to LLregs [6s Ad]
gaidzys gieda: folds
Mumbeer1978: raises $0.02 to $0.04
LLregs: folds
ungiwar: folds
Nutu1313: folds
AwesomeKick: calls $0.02
*** FLOP *** [4c 7h 3s]
AwesomeKick: checks
Mumbeer1978: checks
*** TURN *** [4c 7h 3s] [Ks]
AwesomeKick: checks
Mumbeer1978: checks
*** RIVER *** [4c 7h 3s Ks] [Qs]
AwesomeKick: checks
Mumbeer1978: bets $0.05
AwesomeKick: folds
Uncalled bet ($0.05) returned to Mumbeer1978
Mumbeer1978 collected $0.09 from pot
Mumbeer1978: doesn't show hand
*** SUMMARY ***
Total pot $0.09 | Rake $0
Board [4c 7h 3s Ks Qs]
Seat 1: ungiwar (button) folded before Flop (didn't bet)
Seat 2: Nutu1313 (small blind) folded before Flop
Seat 3: AwesomeKick (big blind) folded on the River
Seat 4: gaidzys gieda folded before Flop (didn't bet)
Seat 5: Mumbeer1978 collected ($0.09)
Seat 6: LLregs folded before Flop (didn't bet)

PokerStars Zoom Hand #247960530815:  Hold'em No Limit ($0.01/$0.02) - 2023/12/30 15:57:44 WET [2023/12/30 10:57:44 ET]
Table 'Halley' 6-max Seat #1 is the button
Seat 1: IrishPheonix ($2 in chips)
Seat 2: 07ijmando ($2.08 in chips)
Seat 3: P.K.45677 ($1.82 in chips)
Seat 4: kaaaaw ($4.92 in chips)
Seat 5: LLregs ($4.41 in chips)
Seat 6: jandsonpower ($2.01 in chips)
07ijmando: posts small blind $0.01
P.K.45677: posts big blind $0.02
*** HOLE CARDS ***
Dealt to LLregs [8s 2h]
kaaaaw: folds
LLregs: folds
jandsonpower: folds
IrishPheonix: raises $0.02 to $0.04
07ijmando: folds
P.K.45677: folds
Uncalled bet ($0.02) returned to IrishPheonix
IrishPheonix collected $0.05 from pot
IrishPheonix: doesn't show hand
*** SUMMARY ***
Total pot $0.05 | Rake $0
Seat 1: IrishPheonix (button) collected ($0.05)
Seat 2: 07ijmando (small blind) folded before Flop
Seat 3: P.K.45677 (big blind) folded before Flop
Seat 4: kaaaaw folded before Flop (didn't bet)
Seat 5: LLregs folded before Flop (didn't bet)
Seat 6: jandsonpower folded before Flop (didn't bet)

PokerStars Zoom Hand #247960532828:  Hold'em No Limit ($0.01/$0.02) - 2023/12/30 15:57:53 WET [2023/12/30 10:57:53 ET]
Table 'Halley' 6-max Seat #1 is the button
Seat 1: Catadromus ($3.65 in chips)
Seat 2: LLregs ($4.41 in chips)
Seat 3: avilaC73 ($2.49 in chips)
Seat 4: nerijus3000 ($2.33 in chips)
Seat 5: September 022 ($2 in chips)
Seat 6: MassterD21 ($2.89 in chips)
LLregs: posts small blind $0.01
avilaC73: posts big blind $0.02
*** HOLE CARDS ***
Dealt to LLregs [5s 7h]
nerijus3000: folds
September 022: folds
MassterD21: folds
Catadromus: folds
LLregs: folds
Uncalled bet ($0.01) returned to avilaC73
avilaC73 collected $0.02 from pot
avilaC73: doesn't show hand
*** SUMMARY ***
Total pot $0.02 | Rake $0
Seat 1: Catadromus (button) folded before Flop (didn't bet)
Seat 2: LLregs (small blind) folded before Flop
Seat 3: avilaC73 (big blind) collected ($0.02)
Seat 4: nerijus3000 folded before Flop (didn't bet)
Seat 5: September 022 folded before Flop (didn't bet)
Seat 6: MassterD21 folded before Flop (didn't bet)

PokerStars Zoom Hand #247960531916:  Hold'em No Limit ($0.01/$0.02) - 2023/12/30 15:57:49 WET [2023/12/30 10:57:49 ET]
Table 'Halley' 6-max Seat #1 is the button
Seat 1: tyzlit ($2.47 in chips)
Seat 2: MXLVI ($2 in chips)
Seat 3: DeadKiriyama ($5.16 in chips)
Seat 4: MassterD21 ($2.89 in chips)
Seat 5: LLregs ($4.41 in chips)
Seat 6: zoran445 ($0.82 in chips)
MXLVI: posts small blind $0.01
DeadKiriyama: posts big blind $0.02
*** HOLE CARDS ***
Dealt to LLregs [Ah 4c]
MassterD21: folds
LLregs: folds
zoran445: raises $0.02 to $0.04
tyzlit: folds
MXLVI: calls $0.03
DeadKiriyama: folds
*** FLOP *** [5c 4d Qc]
MXLVI: checks
zoran445: checks
*** TURN *** [5c 4d Qc] [7h]
MXLVI: checks
zoran445: bets $0.78 and is all-in
MXLVI: folds
Uncalled bet ($0.78) returned to zoran445
zoran445 collected $0.10 from pot
zoran445: doesn't show hand
*** SUMMARY ***
Total pot $0.10 | Rake $0
Board [5c 4d Qc 7h]
Seat 1: tyzlit (button) folded before Flop (didn't bet)
Seat 2: MXLVI (small blind) folded on the Turn
Seat 3: DeadKiriyama (big blind) folded before Flop
Seat 4: MassterD21 folded before Flop (didn't bet)
Seat 5: LLregs folded before Flop (didn't bet)
Seat 6: zoran445 collected ($0.10)

PokerStars Zoom Hand #247960527287:  Hold'em No Limit ($0.01/$0.02) - 2023/12/30 15:57:28 WET [2023/12/30 10:57:28 ET]
Table 'Halley' 6-max Seat #1 is the button
Seat 1: Fabs944 ($4.31 in chips)
Seat 2: theprince188 ($2.16 in chips)
Seat 3: LLregs ($4.43 in chips)
Seat 4: Kalifuchs ($5.57 in chips)
Seat 5: laoban888 ($2.12 in chips)
Seat 6: Xablau00 ($2 in chips)
theprince188: posts small blind $0.01
LLregs: posts big blind $0.02
*** HOLE CARDS ***
Dealt to LLregs [9h 2c]
Kalifuchs: folds
laoban888: folds
Xablau00: raises $0.03 to $0.05
Fabs944: calls $0.05
theprince188: folds
LLregs: folds
*** FLOP *** [6h 7c Qs]
Xablau00: bets $0.04
Fabs944: calls $0.04
*** TURN *** [6h 7c Qs] [7h]
Xablau00: bets $0.08
Fabs944: calls $0.08
*** RIVER *** [6h 7c Qs 7h] [Jc]
Xablau00: checks
Fabs944: bets $0.12
Xablau00: folds
Uncalled bet ($0.12) returned to Fabs944
Fabs944 collected $0.36 from pot
Fabs944: doesn't show hand
*** SUMMARY ***
Total pot $0.37 | Rake $0.01
Board [6h 7c Qs 7h Jc]
Seat 1: Fabs944 (button) collected ($0.36)
Seat 2: theprince188 (small blind) folded before Flop
Seat 3: LLregs (big blind) folded before Flop
Seat 4: Kalifuchs folded before Flop (didn't bet)
Seat 5: laoban888 folded before Flop (didn't bet)
Seat 6: Xablau00 folded on the River

PokerStars Zoom Hand #247960529879:  Hold'em No Limit ($0.01/$0.02) - 2023/12/30 15:57:40 WET [2023/12/30 10:57:40 ET]
Table 'Halley' 6-max Seat #1 is the button
Seat 1: LLregs ($4.41 in chips)
Seat 2: gnom1977 ($2.09 in chips)
Seat 3: nuttymuch ($7.16 in chips)
Seat 4: chinex_sba ($2 in chips)
Seat 5: RodrigoNC340 ($2.97 in chips)
Seat 6: Jonupoi ($1.29 in chips)
gnom1977: posts small blind $0.01
nuttymuch: posts big blind $0.02
*** HOLE CARDS ***
Dealt to LLregs [2h Ts]
chinex_sba: folds
RodrigoNC340: folds
Jonupoi: raises $0.04 to $0.06
LLregs: folds
gnom1977: folds
nuttymuch: calls $0.04
*** FLOP *** [3h 7d 8s]
nuttymuch: checks
Jonupoi: bets $0.07
nuttymuch: calls $0.07
*** TURN *** [3h 7d 8s] [4d]
nuttymuch: checks
Jonupoi: checks
*** RIVER *** [3h 7d 8s 4d] [As]
nuttymuch: bets $0.20
Jonupoi: folds
Uncalled bet ($0.20) returned to nuttymuch
nuttymuch collected $0.26 from pot
nuttymuch: doesn't show hand
*** SUMMARY ***
Total pot $0.27 | Rake $0.01
Board [3h 7d 8s 4d As]
Seat 1: LLregs (button) folded before Flop (didn't bet)
Seat 2: gnom1977 (small blind) folded before Flop
Seat 3: nuttymuch (big blind) collected ($0.26)
Seat 4: chinex_sba folded before Flop (didn't bet)
Seat 5: RodrigoNC340 folded before Flop (didn't bet)
Seat 6: Jonupoi folded on the River

PokerStars Zoom Hand #247960533670:  Hold'em No Limit ($0.01/$0.02) - 2023/12/30 15:57:57 WET [2023/12/30 10:57:57 ET]
Table 'Halley' 6-max Seat #1 is the button
Seat 1: P.K.45677 ($1.80 in chips)
Seat 2: labelleyanie ($2.78 in chips)
Seat 3: FishAndFurious ($2 in chips)
Seat 4: rawsOT ($0.31 in chips)
Seat 5: Catadromus ($3.65 in chips)
Seat 6: LLregs ($4.40 in chips)
labelleyanie: posts small blind $0.01
FishAndFurious: posts big blind $0.02
*** HOLE CARDS ***
Dealt to LLregs [9c 9h]
rawsOT: folds
Catadromus: folds
LLregs: raises $0.04 to $0.06
P.K.45677: raises $0.12 to $0.18
labelleyanie: folds
FishAndFurious: folds
LLregs: calls $0.12
*** FLOP *** [Jc 3d 9d]
LLregs: checks
P.K.45677: checks
*** TURN *** [Jc 3d 9d] [2d]
LLregs: checks
P.K.45677: checks
*** RIVER *** [Jc 3d 9d 2d] [3c]
LLregs: bets $0.18
P.K.45677: folds
Uncalled bet ($0.18) returned to LLregs
LLregs collected $0.38 from pot
LLregs: doesn't show hand
*** SUMMARY ***
Total pot $0.39 | Rake $0.01
Board [Jc 3d 9d 2d 3c]
Seat 1: P.K.45677 (button) folded on the River
Seat 2: labelleyanie (small blind) folded before Flop
Seat 3: FishAndFurious (big blind) folded before Flop
Seat 4: rawsOT folded before Flop (didn't bet)
Seat 5: Catadromus folded before Flop (didn't bet)
Seat 6: LLregs collected ($0.38)

PokerStars Zoom Hand #247960541912:  Hold'em No Limit ($0.01/$0.02) - 2023/12/30 15:58:34 WET [2023/12/30 10:58:34 ET]
Table 'Halley' 6-max Seat #1 is the button
Seat 1: IrishPheonix ($2 in chips)
Seat 2: karintou8888 ($5.53 in chips)
Seat 3: LLregs ($4.60 in chips)
Seat 4: DonChone ($1.72 in chips)
Seat 5: rafds765 ($9.19 in chips)
Seat 6: PR3SUR3 ($7.36 in chips)
karintou8888: posts small blind $0.01
LLregs: posts big blind $0.02
*** HOLE CARDS ***
Dealt to LLregs [Jh 4h]
DonChone: folds
rafds765: folds
PR3SUR3: folds
IrishPheonix: folds
karintou8888: folds
Uncalled bet ($0.01) returned to LLregs
LLregs collected $0.02 from pot
LLregs: doesn't show hand
*** SUMMARY ***
Total pot $0.02 | Rake $0
Seat 1: IrishPheonix (button) folded before Flop (didn't bet)
Seat 2: karintou8888 (small blind) folded before Flop
Seat 3: LLregs (big blind) collected ($0.02)
Seat 4: DonChone folded before Flop (didn't bet)
Seat 5: rafds765 folded before Flop (didn't bet)
Seat 6: PR3SUR3 folded before Flop (didn't bet)

PokerStars Zoom Hand #247960546149:  Hold'em No Limit ($0.01/$0.02) - 2023/12/30 15:58:53 WET [2023/12/30 10:58:53 ET]
Table 'Halley' 6-max Seat #1 is the button
Seat 1: chinex_sba ($2.13 in chips)
Seat 2: laoban888 ($2 in chips)
Seat 3: rrluis1930 ($4.91 in chips)
Seat 4: 888lifeIS ($2.32 in chips)
Seat 5: LLregs ($4.61 in chips)
Seat 6: zoran445 ($0.93 in chips)
laoban888: posts small blind $0.01
rrluis1930: posts big blind $0.02
*** HOLE CARDS ***
Dealt to LLregs [Ac 4s]
888lifeIS: folds
LLregs: folds
zoran445: folds
chinex_sba: folds
laoban888: folds
Uncalled bet ($0.01) returned to rrluis1930
rrluis1930 collected $0.02 from pot
rrluis1930: doesn't show hand
*** SUMMARY ***
Total pot $0.02 | Rake $0
Seat 1: chinex_sba (button) folded before Flop (didn't bet)
Seat 2: laoban888 (small blind) folded before Flop
Seat 3: rrluis1930 (big blind) collected ($0.02)
Seat 4: 888lifeIS folded before Flop (didn't bet)
Seat 5: LLregs folded before Flop (didn't bet)
Seat 6: zoran445 folded before Flop (didn't bet)

PokerStars Zoom Hand #247960545022:  Hold'em No Limit ($0.01/$0.02) - 2023/12/30 15:58:48 WET [2023/12/30 10:58:48 ET]
Table 'Halley' 6-max Seat #1 is the button
Seat 1: Tombombadillo88 ($1 in chips)
Seat 2: Dimoni797979 ($2.98 in chips)
Seat 3: soulfly2145 ($2.05 in chips)
Seat 4: LLregs ($4.61 in chips)
Seat 5: chinex_sba ($2.13 in chips)
Seat 6: napoli222 ($5.02 in chips)
Dimoni797979: posts small blind $0.01
soulfly2145: posts big blind $0.02
*** HOLE CARDS ***
Dealt to LLregs [6d Th]
LLregs: folds
chinex_sba: folds
napoli222: folds
Tombombadillo88: calls $0.02
Dimoni797979: folds
soulfly2145: checks
*** FLOP *** [7s Qc Ts]
soulfly2145: checks
Tombombadillo88: checks
*** TURN *** [7s Qc Ts] [Qs]
soulfly2145: checks
Tombombadillo88: bets $0.02
soulfly2145: folds
Uncalled bet ($0.02) returned to Tombombadillo88
Tombombadillo88 collected $0.05 from pot
Tombombadillo88: doesn't show hand
*** SUMMARY ***
Total pot $0.05 | Rake $0
Board [7s Qc Ts Qs]
Seat 1: Tombombadillo88 (button) collected ($0.05)
Seat 2: Dimoni797979 (small blind) folded before Flop
Seat 3: soulfly2145 (big blind) folded on the Turn
Seat 4: LLregs folded before Flop (didn't bet)
Seat 5: chinex_sba folded before Flop (didn't bet)
Seat 6: napoli222 folded before Flop (didn't bet)

PokerStars Zoom Hand #247960548876:  Hold'em No Limit ($0.01/$0.02) - 2023/12/30 15:59:05 WET [2023/12/30 10:59:05 ET]
Table 'Halley' 6-max Seat #1 is the button
Seat 1: LLregs ($4.61 in chips)
Seat 2: lordz1 ($2.19 in chips)
Seat 3: avilaC73 ($3.94 in chips)
Seat 4: Castiel_Ivy ($2.19 in chips)
Seat 5: AllstarCon ($2.05 in chips)
Seat 6: 7zudluy7 ($0.97 in chips)
lordz1: posts small blind $0.01
avilaC73: posts big blind $0.02
*** HOLE CARDS ***
Dealt to LLregs [Th Qs]
Castiel_Ivy: folds
AllstarCon: folds
7zudluy7: folds
LLregs: raises $0.04 to $0.06
lordz1: raises $0.18 to $0.24
avilaC73: folds
LLregs: calls $0.18
*** FLOP *** [2c 6h Kh]
lordz1: bets $0.16
LLregs: folds
Uncalled bet ($0.16) returned to lordz1
lordz1 collected $0.48 from pot
lordz1: doesn't show hand
*** SUMMARY ***
Total pot $0.50 | Rake $0.02
Board [2c 6h Kh]
Seat 1: LLregs (button) folded on the Flop
Seat 2: lordz1 (small blind) collected ($0.48)
Seat 3: avilaC73 (big blind) folded before Flop
Seat 4: Castiel_Ivy folded before Flop (didn't bet)
Seat 5: AllstarCon folded before Flop (didn't bet)
Seat 6: 7zudluy7 folded before Flop (didn't bet)

PokerStars Zoom Hand #247960547966:  Hold'em No Limit ($0.01/$0.02) - 2023/12/30 15:59:01 WET [2023/12/30 10:59:01 ET]
Table 'Halley' 6-max Seat #1 is the button
Seat 1: MirianAraujo ($1.14 in chips)
Seat 2: Akira515 ($0.73 in chips)
Seat 3: Shmatrixs ($4.52 in chips)
Seat 4: LLregs ($4.61 in chips)
Seat 5: manoblack51 ($2.08 in chips)
Seat 6: MassterD21 ($2.83 in chips)
Akira515: posts small blind $0.01
Shmatrixs: posts big blind $0.02
*** HOLE CARDS ***
Dealt to LLregs [As 5c]
LLregs: folds
manoblack51: folds
MassterD21: folds
MirianAraujo: raises $0.02 to $0.04
Akira515: folds
Shmatrixs: calls $0.02
*** FLOP *** [Qd 9d 7h]
Shmatrixs: checks
MirianAraujo: bets $0.05
Shmatrixs: calls $0.05
*** TURN *** [Qd 9d 7h] [6h]
Shmatrixs: checks
MirianAraujo: bets $0.09
Shmatrixs: calls $0.09
*** RIVER *** [Qd 9d 7h 6h] [Th]
Shmatrixs: checks
MirianAraujo: bets $0.18
Shmatrixs: calls $0.18
*** SHOW DOWN ***
MirianAraujo: shows [Ks 8d] (a straight, Six to Ten)
Shmatrixs: mucks hand
MirianAraujo collected $0.70 from pot
*** SUMMARY ***
Total pot $0.73 | Rake $0.03
Board [Qd 9d 7h 6h Th]
Seat 1: MirianAraujo (button) showed [Ks 8d] and won ($0.70) with a straight, Six to Ten
Seat 2: Akira515 (small blind) folded before Flop
Seat 3: Shmatrixs (big blind) mucked [6c 7c]
Seat 4: LLregs folded before Flop (didn't bet)
Seat 5: manoblack51 folded before Flop (didn't bet)
Seat 6: MassterD21 folded before Flop (didn't bet)

PokerStars Zoom Hand #247960560272:  Hold'em No Limit ($0.01/$0.02) - 2023/12/30 15:59:57 WET [2023/12/30 10:59:57 ET]
Table 'Halley' 6-max Seat #1 is the button
Seat 1: Lysy1979 ($2.96 in chips)
Seat 2: marcegring ($2.68 in chips)
Seat 3: LLregs ($4.37 in chips)
Seat 4: DeXxTroza ($2.72 in chips)
Seat 5: manoblack51 ($2.05 in chips)
Seat 6: PR3SUR3 ($6.96 in chips)
marcegring: posts small blind $0.01
LLregs: posts big blind $0.02
*** HOLE CARDS ***
Dealt to LLregs [3s 6d]
DeXxTroza: raises $0.03 to $0.05
manoblack51: calls $0.05
PR3SUR3: folds
Lysy1979: folds
marcegring: folds
LLregs: folds
*** FLOP *** [Qs As 5d]
DeXxTroza: checks
manoblack51: checks
*** TURN *** [Qs As 5d] [Ac]
DeXxTroza: checks
manoblack51: checks
*** RIVER *** [Qs As 5d Ac] [2d]
DeXxTroza: checks
manoblack51: bets $0.02
DeXxTroza: folds
Uncalled bet ($0.02) returned to manoblack51
manoblack51 collected $0.13 from pot
manoblack51: doesn't show hand
*** SUMMARY ***
Total pot $0.13 | Rake $0
Board [Qs As 5d Ac 2d]
Seat 1: Lysy1979 (button) folded before Flop (didn't bet)
Seat 2: marcegring (small blind) folded before Flop
Seat 3: LLregs (big blind) folded before Flop
Seat 4: DeXxTroza folded on the River
Seat 5: manoblack51 collected ($0.13)
Seat 6: PR3SUR3 folded before Flop (didn't bet)

PokerStars Zoom Hand #247960561826:  Hold'em No Limit ($0.01/$0.02) - 2023/12/30 16:00:04 WET [2023/12/30 11:00:04 ET]
Table 'Halley' 6-max Seat #1 is the button
Seat 1: MSerik ($3.19 in chips)
Seat 2: LLregs ($4.35 in chips)
Seat 3: Papito187 ($3.61 in chips)
Seat 4: pessimist53 ($2.10 in chips)
Seat 5: soulfly2145 ($2.03 in chips)
Seat 6: gnom1977 ($5.81 in chips)
LLregs: posts small blind $0.01
Papito187: posts big blind $0.02
*** HOLE CARDS ***
Dealt to LLregs [Kh 7d]
pessimist53: folds
soulfly2145: folds
gnom1977: folds
MSerik: folds
LLregs: raises $0.04 to $0.06
Papito187: calls $0.04
*** FLOP *** [4s 2s 7s]
LLregs: checks
Papito187: checks
*** TURN *** [4s 2s 7s] [Jd]
LLregs: checks
Papito187: checks
*** RIVER *** [4s 2s 7s Jd] [Kd]
LLregs: bets $0.03
Papito187: folds
Uncalled bet ($0.03) returned to LLregs
LLregs collected $0.12 from pot
LLregs: doesn't show hand
*** SUMMARY ***
Total pot $0.12 | Rake $0
Board [4s 2s 7s Jd Kd]
Seat 1: MSerik (button) folded before Flop (didn't bet)
Seat 2: LLregs (small blind) collected ($0.12)
Seat 3: Papito187 (big blind) folded on the River
Seat 4: pessimist53 folded before Flop (didn't bet)
Seat 5: soulfly2145 folded before Flop (didn't bet)
Seat 6: gnom1977 folded before Flop (didn't bet)

PokerStars Zoom Hand #247960571412:  Hold'em No Limit ($0.01/$0.02) - 2023/12/30 16:00:44 WET [2023/12/30 11:00:44 ET]
Table 'Halley' 6-max Seat #1 is the button
Seat 1: BadBeat Bert ($1.72 in chips)
Seat 2: Jhon Rambo.CL ($2.01 in chips)
Seat 3: Chupacabra G ($2 in chips)
Seat 4: ZiggyBoy90 ($2.22 in chips)
Seat 5: Dexter9922 ($4.57 in chips)
Seat 6: LLregs ($4.41 in chips)
Jhon Rambo.CL: posts small blind $0.01
Chupacabra G: posts big blind $0.02
*** HOLE CARDS ***
Dealt to LLregs [4d Ad]
ZiggyBoy90: folds
Dexter9922: raises $0.02 to $0.04
LLregs: raises $0.10 to $0.14
BadBeat Bert: folds
Jhon Rambo.CL: folds
Chupacabra G: folds
Dexter9922: calls $0.10
*** FLOP *** [7h 5c 2c]
Dexter9922: checks
LLregs: bets $0.14
Dexter9922: folds
Uncalled bet ($0.14) returned to LLregs
LLregs collected $0.30 from pot
LLregs: doesn't show hand
*** SUMMARY ***
Total pot $0.31 | Rake $0.01
Board [7h 5c 2c]
Seat 1: BadBeat Bert (button) folded before Flop (didn't bet)
Seat 2: Jhon Rambo.CL (small blind) folded before Flop
Seat 3: Chupacabra G (big blind) folded before Flop
Seat 4: ZiggyBoy90 folded before Flop (didn't bet)
Seat 5: Dexter9922 folded on the Flop
Seat 6: LLregs collected ($0.30)

PokerStars Zoom Hand #247960584308:  Hold'em No Limit ($0.01/$0.02) - 2023/12/30 16:01:32 WET [2023/12/30 11:01:32 ET]
Table 'Halley' 6-max Seat #1 is the button
Seat 1: LLregs ($4.57 in chips)
Seat 2: liquidxrome ($1.14 in chips)
Seat 3: snapdrago241 ($1.12 in chips)
Seat 4: ivciks74lv ($3.08 in chips)
Seat 5: ôGuto ($1.69 in chips)
Seat 6: M1k3B4gUnc1nh4 ($1.82 in chips)
liquidxrome: posts small blind $0.01
snapdrago241: posts big blind $0.02
*** HOLE CARDS ***
Dealt to LLregs [2h 5d]
ivciks74lv: raises $0.05 to $0.07
ôGuto: calls $0.07
M1k3B4gUnc1nh4: folds
LLregs: folds
liquidxrome: folds
snapdrago241: folds
*** FLOP *** [Qd 6d 7d]
ivciks74lv: checks
ôGuto: bets $0.02
ivciks74lv: calls $0.02
*** TURN *** [Qd 6d 7d] [6h]
ivciks74lv: checks
ôGuto: bets $0.02
ivciks74lv: calls $0.02
*** RIVER *** [Qd 6d 7d 6h] [Th]
ivciks74lv: checks
ôGuto: bets $0.04
ivciks74lv: calls $0.04
*** SHOW DOWN ***
ôGuto: shows [Ad Ah] (two pair, Aces and Sixes)
ivciks74lv: mucks hand
ôGuto collected $0.32 from pot
*** SUMMARY ***
Total pot $0.33 | Rake $0.01
Board [Qd 6d 7d 6h Th]
Seat 1: LLregs (button) folded before Flop (didn't bet)
Seat 2: liquidxrome (small blind) folded before Flop
Seat 3: snapdrago241 (big blind) folded before Flop
Seat 4: ivciks74lv mucked [9d 9h]
Seat 5: ôGuto showed [Ad Ah] and won ($0.32) with two pair, Aces and Sixes
Seat 6: M1k3B4gUnc1nh4 folded before Flop (didn't bet)

PokerStars Zoom Hand #247960585504:  Hold'em No Limit ($0.01/$0.02) - 2023/12/30 16:01:36 WET [2023/12/30 11:01:36 ET]
Table 'Halley' 6-max Seat #1 is the button
Seat 1: Dexter9922 ($4.43 in chips)
Seat 2: BilugaMaster ($2.58 in chips)
Seat 3: M1k3B4gUnc1nh4 ($1.82 in chips)
Seat 4: dekomp3 ($1.98 in chips)
Seat 5: jpjp29 ($2.11 in chips)
Seat 6: LLregs ($4.57 in chips)
BilugaMaster: posts small blind $0.01
M1k3B4gUnc1nh4: posts big blind $0.02
*** HOLE CARDS ***
Dealt to LLregs [Kh 8d]
dekomp3: folds
jpjp29 has timed out
jpjp29: folds
LLregs: raises $0.04 to $0.06
Dexter9922: folds
BilugaMaster: calls $0.05
M1k3B4gUnc1nh4: folds
*** FLOP *** [6h 7s 8c]
BilugaMaster: checks
LLregs: bets $0.03
BilugaMaster: calls $0.03
*** TURN *** [6h 7s 8c] [2c]
BilugaMaster: checks
LLregs: bets $0.04
BilugaMaster: raises $0.06 to $0.10
LLregs: calls $0.06
*** RIVER *** [6h 7s 8c 2c] [Jc]
BilugaMaster: checks
LLregs: checks
*** SHOW DOWN ***
BilugaMaster: shows [9c Th] (a straight, Seven to Jack)
LLregs: mucks hand
BilugaMaster collected $0.39 from pot
*** SUMMARY ***
Total pot $0.40 | Rake $0.01
Board [6h 7s 8c 2c Jc]
Seat 1: Dexter9922 (button) folded before Flop (didn't bet)
Seat 2: BilugaMaster (small blind) showed [9c Th] and won ($0.39) with a straight, Seven to Jack
Seat 3: M1k3B4gUnc1nh4 (big blind) folded before Flop
Seat 4: dekomp3 folded before Flop (didn't bet)
Seat 5: jpjp29 folded before Flop (didn't bet)
Seat 6: LLregs mucked [Kh 8d]

PokerStars Zoom Hand #247960602070:  Hold'em No Limit ($0.01/$0.02) - 2023/12/30 16:02:35 WET [2023/12/30 11:02:35 ET]
Table 'Halley' 6-max Seat #1 is the button
Seat 1: Loucomeloo ($2 in chips)
Seat 2: DeXxTroza ($2.28 in chips)
Seat 3: nikkem971 ($3.82 in chips)
Seat 4: Mikeloko182 ($2.58 in chips)
Seat 5: LLregs ($4.38 in chips)
Seat 6: Nisquu1 ($2.26 in chips)
DeXxTroza: posts small blind $0.01
nikkem971: posts big blind $0.02
*** HOLE CARDS ***
Dealt to LLregs [3d Ac]
Mikeloko182: folds
LLregs: folds
Nisquu1: raises $0.03 to $0.05
Loucomeloo: folds
DeXxTroza: folds
nikkem971: folds
Uncalled bet ($0.03) returned to Nisquu1
Nisquu1 collected $0.05 from pot
Nisquu1: doesn't show hand
*** SUMMARY ***
Total pot $0.05 | Rake $0
Seat 1: Loucomeloo (button) folded before Flop (didn't bet)
Seat 2: DeXxTroza (small blind) folded before Flop
Seat 3: nikkem971 (big blind) folded before Flop
Seat 4: Mikeloko182 folded before Flop (didn't bet)
Seat 5: LLregs folded before Flop (didn't bet)
Seat 6: Nisquu1 collected ($0.05)

PokerStars Zoom Hand #247960603184:  Hold'em No Limit ($0.01/$0.02) - 2023/12/30 16:02:39 WET [2023/12/30 11:02:39 ET]
Table 'Halley' 6-max Seat #1 is the button
Seat 1: stackteef54 ($3.03 in chips)
Seat 2: LLregs ($4.38 in chips)
Seat 3: 7zudluy7 ($1.41 in chips)
Seat 4: nuttymuch ($7.15 in chips)
Seat 5: Lysy1979 ($2.96 in chips)
Seat 6: PAMOH78 ($1.35 in chips)
LLregs: posts small blind $0.01
7zudluy7: posts big blind $0.02
*** HOLE CARDS ***
Dealt to LLregs [Ad 3d]
nuttymuch: raises $0.03 to $0.05
Lysy1979: folds
PAMOH78: raises $0.03 to $0.08
stackteef54: folds
LLregs: calls $0.07
7zudluy7: folds
nuttymuch: calls $0.03
*** FLOP *** [6s 8s 5c]
LLregs: checks
nuttymuch: checks
PAMOH78: bets $0.12
LLregs: folds
nuttymuch: calls $0.12
*** TURN *** [6s 8s 5c] [Ks]
nuttymuch: checks
PAMOH78: bets $0.10
nuttymuch: calls $0.10
*** RIVER *** [6s 8s 5c Ks] [3c]
nuttymuch: checks
PAMOH78: checks
*** SHOW DOWN ***
nuttymuch: shows [Th Tc] (a pair of Tens)
PAMOH78: mucks hand
nuttymuch collected $0.68 from pot
*** SUMMARY ***
Total pot $0.70 | Rake $0.02
Board [6s 8s 5c Ks 3c]
Seat 1: stackteef54 (button) folded before Flop (didn't bet)
Seat 2: LLregs (small blind) folded on the Flop
Seat 3: 7zudluy7 (big blind) folded before Flop
Seat 4: nuttymuch showed [Th Tc] and won ($0.68) with a pair of Tens
Seat 5: Lysy1979 folded before Flop (didn't bet)
Seat 6: PAMOH78 mucked [2s 2h]

PokerStars Zoom Hand #247960609934:  Hold'em No Limit ($0.01/$0.02) - 2023/12/30 16:03:03 WET [2023/12/30 11:03:03 ET]
Table 'Halley' 6-max Seat #1 is the button
Seat 1: vovan22-99 ($2.21 in chips)
Seat 2: ungiwar ($0.88 in chips)
Seat 3: PozzzitiF ($1.81 in chips)
Seat 4: LLregs ($4.30 in chips)
Seat 5: mihai_s1984 ($1.48 in chips)
Seat 6: vecinul ($2.10 in chips)
ungiwar: posts small blind $0.01
PozzzitiF: posts big blind $0.02
*** HOLE CARDS ***
Dealt to LLregs [4h Ah]
LLregs: folds
mihai_s1984: folds
vecinul: folds
vovan22-99: folds
ungiwar: folds
Uncalled bet ($0.01) returned to PozzzitiF
PozzzitiF collected $0.02 from pot
PozzzitiF: doesn't show hand
*** SUMMARY ***
Total pot $0.02 | Rake $0
Seat 1: vovan22-99 (button) folded before Flop (didn't bet)
Seat 2: ungiwar (small blind) folded before Flop
Seat 3: PozzzitiF (big blind) collected ($0.02)
Seat 4: LLregs folded before Flop (didn't bet)
Seat 5: mihai_s1984 folded before Flop (didn't bet)
Seat 6: vecinul folded before Flop (didn't bet)

PokerStars Zoom Hand #247960611366:  Hold'em No Limit ($0.01/$0.02) - 2023/12/30 16:03:08 WET [2023/12/30 11:03:08 ET]
Table 'Halley' 6-max Seat #1 is the button
Seat 1: LLregs ($4.30 in chips)
Seat 2: tyzlit ($2.32 in chips)
Seat 3: Jhon Rambo.CL ($2.06 in chips)
Seat 4: pkrgrl04 ($2.24 in chips)
Seat 5: 888lifeIS ($2.03 in chips)
Seat 6: Arabescul ($2.14 in chips)
tyzlit: posts small blind $0.01
Jhon Rambo.CL: posts big blind $0.02
*** HOLE CARDS ***
Dealt to LLregs [5s 9c]
pkrgrl04: folds
888lifeIS: raises $0.02 to $0.04
Arabescul: folds
LLregs: folds
tyzlit: folds
Jhon Rambo.CL: folds
Uncalled bet ($0.02) returned to 888lifeIS
888lifeIS collected $0.05 from pot
888lifeIS: doesn't show hand
*** SUMMARY ***
Total pot $0.05 | Rake $0
Seat 1: LLregs (button) folded before Flop (didn't bet)
Seat 2: tyzlit (small blind) folded before Flop
Seat 3: Jhon Rambo.CL (big blind) folded before Flop
Seat 4: pkrgrl04 folded before Flop (didn't bet)
Seat 5: 888lifeIS collected ($0.05)
Seat 6: Arabescul folded before Flop (didn't bet)

PokerStars Zoom Hand #247960617731:  Hold'em No Limit ($0.01/$0.02) - 2023/12/30 16:03:30 WET [2023/12/30 11:03:30 ET]
Table 'Halley' 6-max Seat #1 is the button
Seat 1: jandsonpower ($5.92 in chips)
Seat 2: FishAndFurious ($2.06 in chips)
Seat 3: cr@sh test ($2 in chips)
Seat 4: 2plateado2 ($2.20 in chips)
Seat 5: LLregs ($4.28 in chips)
Seat 6: Campus RO ($1.21 in chips)
FishAndFurious: posts small blind $0.01
cr@sh test: posts big blind $0.02
*** HOLE CARDS ***
Dealt to LLregs [7h 9h]
2plateado2: folds
LLregs: raises $0.04 to $0.06
Campus RO: calls $0.06
jandsonpower: folds
FishAndFurious: raises $0.24 to $0.30
cr@sh test: folds
LLregs: folds
Campus RO: folds
Uncalled bet ($0.24) returned to FishAndFurious
FishAndFurious collected $0.20 from pot
FishAndFurious: doesn't show hand
*** SUMMARY ***
Total pot $0.20 | Rake $0
Seat 1: jandsonpower (button) folded before Flop (didn't bet)
Seat 2: FishAndFurious (small blind) collected ($0.20)
Seat 3: cr@sh test (big blind) folded before Flop
Seat 4: 2plateado2 folded before Flop (didn't bet)
Seat 5: LLregs folded before Flop
Seat 6: Campus RO folded before Flop

PokerStars Zoom Hand #247960612516:  Hold'em No Limit ($0.01/$0.02) - 2023/12/30 16:03:12 WET [2023/12/30 11:03:12 ET]
Table 'Halley' 6-max Seat #1 is the button
Seat 1: rafds765 ($14.07 in chips)
Seat 2: dsousAA ($2 in chips)
Seat 3: LLregs ($4.30 in chips)
Seat 4: thony100 ($1.53 in chips)
Seat 5: AwesomeKick ($2.32 in chips)
Seat 6: IrishPheonix ($2 in chips)
dsousAA: posts small blind $0.01
LLregs: posts big blind $0.02
*** HOLE CARDS ***
Dealt to LLregs [2d 4s]
thony100: folds
AwesomeKick: folds
IrishPheonix: folds
rafds765: raises $0.03 to $0.05
dsousAA: raises $0.15 to $0.20
LLregs: folds
rafds765: calls $0.15
*** FLOP *** [Kc 6s 4h]
dsousAA: bets $0.14
rafds765: calls $0.14
*** TURN *** [Kc 6s 4h] [4d]
dsousAA: bets $0.32
rafds765: folds
Uncalled bet ($0.32) returned to dsousAA
dsousAA collected $0.68 from pot
dsousAA: doesn't show hand
*** SUMMARY ***
Total pot $0.70 | Rake $0.02
Board [Kc 6s 4h 4d]
Seat 1: rafds765 (button) folded on the Turn
Seat 2: dsousAA (small blind) collected ($0.68)
Seat 3: LLregs (big blind) folded before Flop
Seat 4: thony100 folded before Flop (didn't bet)
Seat 5: AwesomeKick folded before Flop (didn't bet)
Seat 6: IrishPheonix folded before Flop (didn't bet)

PokerStars Zoom Hand #247960622781:  Hold'em No Limit ($0.01/$0.02) - 2023/12/30 16:03:48 WET [2023/12/30 11:03:48 ET]
Table 'Halley' 6-max Seat #1 is the button
Seat 1: rdp86 ($4.16 in chips)
Seat 2: gaidzys gieda ($2.99 in chips)
Seat 3: rrluis1930 ($5.22 in chips)
Seat 4: LLregs ($4.22 in chips)
Seat 5: rafds765 ($9.28 in chips)
Seat 6: Good2CUBack ($1.41 in chips)
gaidzys gieda: posts small blind $0.01
rrluis1930: posts big blind $0.02
*** HOLE CARDS ***
Dealt to LLregs [6s As]
LLregs: raises $0.04 to $0.06
rafds765: folds
Good2CUBack: raises $0.11 to $0.17
rdp86: calls $0.17
gaidzys gieda: folds
rrluis1930: folds
LLregs: calls $0.11
*** FLOP *** [6h Qd 5s]
LLregs: checks
Good2CUBack: checks
rdp86: bets $0.26
LLregs: folds
Good2CUBack: folds
Uncalled bet ($0.26) returned to rdp86
rdp86 collected $0.52 from pot
rdp86: doesn't show hand
*** SUMMARY ***
Total pot $0.54 | Rake $0.02
Board [6h Qd 5s]
Seat 1: rdp86 (button) collected ($0.52)
Seat 2: gaidzys gieda (small blind) folded before Flop
Seat 3: rrluis1930 (big blind) folded before Flop
Seat 4: LLregs folded on the Flop
Seat 5: rafds765 folded before Flop (didn't bet)
Seat 6: Good2CUBack folded on the Flop

PokerStars Zoom Hand #247960634894:  Hold'em No Limit ($0.01/$0.02) - 2023/12/30 16:04:30 WET [2023/12/30 11:04:30 ET]
Table 'Halley' 6-max Seat #1 is the button
Seat 1: placebo1970 ($0.83 in chips)
Seat 2: nayaratorres ($1.86 in chips)
Seat 3: LLregs ($4.05 in chips)
Seat 4: liquidxrome ($1.09 in chips)
Seat 5: MassterD21 ($2.38 in chips)
Seat 6: Arabescul ($2 in chips)
nayaratorres: posts small blind $0.01
LLregs: posts big blind $0.02
*** HOLE CARDS ***
Dealt to LLregs [5c 6d]
liquidxrome: folds
MassterD21: folds
Arabescul: raises $0.03 to $0.05
placebo1970: folds
nayaratorres: folds
LLregs: folds
Uncalled bet ($0.03) returned to Arabescul
Arabescul collected $0.05 from pot
Arabescul: doesn't show hand
*** SUMMARY ***
Total pot $0.05 | Rake $0
Seat 1: placebo1970 (button) folded before Flop (didn't bet)
Seat 2: nayaratorres (small blind) folded before Flop
Seat 3: LLregs (big blind) folded before Flop
Seat 4: liquidxrome folded before Flop (didn't bet)
Seat 5: MassterD21 folded before Flop (didn't bet)
Seat 6: Arabescul collected ($0.05)

PokerStars Zoom Hand #247960640889:  Hold'em No Limit ($0.01/$0.02) - 2023/12/30 16:04:51 WET [2023/12/30 11:04:51 ET]
Table 'Halley' 6-max Seat #1 is the button
Seat 1: Loucomeloo ($2.11 in chips)
Seat 2: LLregs ($4.03 in chips)
Seat 3: 07ijmando ($3.64 in chips)
Seat 4: Gazz_Bax ($1.89 in chips)
Seat 5: thony100 ($1.56 in chips)
Seat 6: IrishPheonix ($2 in chips)
LLregs: posts small blind $0.01
07ijmando: posts big blind $0.02
*** HOLE CARDS ***
Dealt to LLregs [Ts 7h]
Gazz_Bax: folds
thony100: folds
IrishPheonix: folds
Loucomeloo: raises $0.03 to $0.05
LLregs: folds
07ijmando: calls $0.03
*** FLOP *** [Ks 9h 4s]
07ijmando: checks
Loucomeloo: bets $0.04
07ijmando: calls $0.04
*** TURN *** [Ks 9h 4s] [5d]
07ijmando: checks
Loucomeloo: checks
*** RIVER *** [Ks 9h 4s 5d] [Js]
07ijmando: bets $0.20
Loucomeloo: folds
Uncalled bet ($0.20) returned to 07ijmando
07ijmando collected $0.18 from pot
07ijmando: doesn't show hand
*** SUMMARY ***
Total pot $0.19 | Rake $0.01
Board [Ks 9h 4s 5d Js]
Seat 1: Loucomeloo (button) folded on the River
Seat 2: LLregs (small blind) folded before Flop
Seat 3: 07ijmando (big blind) collected ($0.18)
Seat 4: Gazz_Bax folded before Flop (didn't bet)
Seat 5: thony100 folded before Flop (didn't bet)
Seat 6: IrishPheonix folded before Flop (didn't bet)

PokerStars Zoom Hand #247960641959:  Hold'em No Limit ($0.01/$0.02) - 2023/12/30 16:04:55 WET [2023/12/30 11:04:55 ET]
Table 'Halley' 6-max Seat #1 is the button
Seat 1: tyzlit ($2.36 in chips)
Seat 2: FishAndFurious ($2.21 in chips)
Seat 3: VIDOPRO23 ($3.14 in chips)
Seat 4: aproximo ($2.05 in chips)
Seat 5: Cpt_Price_67 ($1.82 in chips)
Seat 6: LLregs ($4.02 in chips)
FishAndFurious: posts small blind $0.01
VIDOPRO23: posts big blind $0.02
*** HOLE CARDS ***
Dealt to LLregs [Th 7h]
aproximo: folds
Cpt_Price_67: raises $0.02 to $0.04
LLregs: folds
tyzlit: folds
FishAndFurious: folds
VIDOPRO23: calls $0.02
*** FLOP *** [8c Qh 7d]
VIDOPRO23: bets $0.05
Cpt_Price_67: folds
Uncalled bet ($0.05) returned to VIDOPRO23
VIDOPRO23 collected $0.09 from pot
VIDOPRO23: doesn't show hand
*** SUMMARY ***
Total pot $0.09 | Rake $0
Board [8c Qh 7d]
Seat 1: tyzlit (button) folded before Flop (didn't bet)
Seat 2: FishAndFurious (small blind) folded before Flop
Seat 3: VIDOPRO23 (big blind) collected ($0.09)
Seat 4: aproximo folded before Flop (didn't bet)
Seat 5: Cpt_Price_67 folded on the Flop
Seat 6: LLregs folded before Flop (didn't bet)

PokerStars Zoom Hand #247960645838:  Hold'em No Limit ($0.01/$0.02) - 2023/12/30 16:05:08 WET [2023/12/30 11:05:08 ET]
Table 'Halley' 6-max Seat #1 is the button
Seat 1: LLregs ($4.02 in chips)
Seat 2: tomdane96 ($2.09 in chips)
Seat 3: kuelas ($2.12 in chips)
Seat 4: BluffConquest ($2.39 in chips)
Seat 5: Shmatrixs ($6.54 in chips)
Seat 6: nikkem971 ($3.11 in chips)
tomdane96: posts small blind $0.01
kuelas: posts big blind $0.02
*** HOLE CARDS ***
Dealt to LLregs [Jd Tc]
BluffConquest: folds
Shmatrixs: folds
nikkem971: raises $0.03 to $0.05
LLregs: calls $0.05
tomdane96: folds
kuelas: folds
*** FLOP *** [9h 6h Jh]
nikkem971: checks
LLregs: bets $0.04
nikkem971: calls $0.04
*** TURN *** [9h 6h Jh] [Js]
nikkem971: checks
LLregs: bets $0.04
nikkem971: calls $0.04
*** RIVER *** [9h 6h Jh Js] [2c]
nikkem971: checks
LLregs: checks
*** SHOW DOWN ***
nikkem971: shows [8h 8c] (two pair, Jacks and Eights)
LLregs: shows [Jd Tc] (three of a kind, Jacks)
LLregs collected $0.28 from pot
*** SUMMARY ***
Total pot $0.29 | Rake $0.01
Board [9h 6h Jh Js 2c]
Seat 1: LLregs (button) showed [Jd Tc] and won ($0.28) with three of a kind, Jacks
Seat 2: tomdane96 (small blind) folded before Flop
Seat 3: kuelas (big blind) folded before Flop
Seat 4: BluffConquest folded before Flop (didn't bet)
Seat 5: Shmatrixs folded before Flop (didn't bet)
Seat 6: nikkem971 showed [8h 8c] and lost with two pair, Jacks and Eights

PokerStars Zoom Hand #247960668884:  Hold'em No Limit ($0.01/$0.02) - 2023/12/30 16:06:27 WET [2023/12/30 11:06:27 ET]
Table 'Halley' 6-max Seat #1 is the button
Seat 1: psdgr3 ($2.11 in chips)
Seat 2: Kalle_2509 ($2.50 in chips)
Seat 3: jandsonpower ($2.47 in chips)
Seat 4: Chupacabra G ($2.45 in chips)
Seat 5: nikkem971 ($2.98 in chips)
Seat 6: LLregs ($4.17 in chips)
Kalle_2509: posts small blind $0.01
jandsonpower: posts big blind $0.02
*** HOLE CARDS ***
Dealt to LLregs [9d Qs]
Chupacabra G: folds
nikkem971: folds
LLregs: folds
psdgr3: raises $0.02 to $0.04
Kalle_2509: folds
jandsonpower: folds
Uncalled bet ($0.02) returned to psdgr3
psdgr3 collected $0.05 from pot
psdgr3: doesn't show hand
*** SUMMARY ***
Total pot $0.05 | Rake $0
Seat 1: psdgr3 (button) collected ($0.05)
Seat 2: Kalle_2509 (small blind) folded before Flop
Seat 3: jandsonpower (big blind) folded before Flop
Seat 4: Chupacabra G folded before Flop (didn't bet)
Seat 5: nikkem971 folded before Flop (didn't bet)
Seat 6: LLregs folded before Flop (didn't bet)

PokerStars Zoom Hand #247960670062:  Hold'em No Limit ($0.01/$0.02) - 2023/12/30 16:06:31 WET [2023/12/30 11:06:31 ET]
Table 'Halley' 6-max Seat #1 is the button
Seat 1: 888lifeIS ($2.60 in chips)
Seat 2: kaaaaw ($3.57 in chips)
Seat 3: LLregs ($4.17 in chips)
Seat 4: Sakke44 ($4.49 in chips)
Seat 5: Josip1119 ($2 in chips)
Seat 6: Skelter_AAA ($2.31 in chips)
kaaaaw: posts small blind $0.01
LLregs: posts big blind $0.02
*** HOLE CARDS ***
Dealt to LLregs [2h 8h]
Sakke44: folds
Josip1119: raises $0.04 to $0.06
Skelter_AAA: folds
888lifeIS: folds
kaaaaw: folds
LLregs: folds
Uncalled bet ($0.04) returned to Josip1119
Josip1119 collected $0.05 from pot
Josip1119: doesn't show hand
*** SUMMARY ***
Total pot $0.05 | Rake $0
Seat 1: 888lifeIS (button) folded before Flop (didn't bet)
Seat 2: kaaaaw (small blind) folded before Flop
Seat 3: LLregs (big blind) folded before Flop
Seat 4: Sakke44 folded before Flop (didn't bet)
Seat 5: Josip1119 collected ($0.05)
Seat 6: Skelter_AAA folded before Flop (didn't bet)

PokerStars Zoom Hand #247960675033:  Hold'em No Limit ($0.01/$0.02) - 2023/12/30 16:06:48 WET [2023/12/30 11:06:48 ET]
Table 'Halley' 6-max Seat #1 is the button
Seat 1: chinex_sba ($2 in chips)
Seat 2: Fzst119 ($2 in chips)
Seat 3: iPitbull1 ($2.08 in chips)
Seat 4: inhonestus ($3.55 in chips)
Seat 5: LLregs ($4.15 in chips)
Seat 6: dsousAA ($2 in chips)
Fzst119: posts small blind $0.01
iPitbull1: posts big blind $0.02
*** HOLE CARDS ***
Dealt to LLregs [Js Ad]
inhonestus: folds
LLregs: raises $0.04 to $0.06
dsousAA: folds
chinex_sba: folds
Fzst119: folds
iPitbull1: folds
Uncalled bet ($0.04) returned to LLregs
LLregs collected $0.05 from pot
LLregs: doesn't show hand
*** SUMMARY ***
Total pot $0.05 | Rake $0
Seat 1: chinex_sba (button) folded before Flop (didn't bet)
Seat 2: Fzst119 (small blind) folded before Flop
Seat 3: iPitbull1 (big blind) folded before Flop
Seat 4: inhonestus folded before Flop (didn't bet)
Seat 5: LLregs collected ($0.05)
Seat 6: dsousAA folded before Flop (didn't bet)

PokerStars Zoom Hand #247960678320:  Hold'em No Limit ($0.01/$0.02) - 2023/12/30 16:06:59 WET [2023/12/30 11:06:59 ET]
Table 'Halley' 6-max Seat #1 is the button
Seat 1: descandy ($2.36 in chips)
Seat 2: Fzst119 ($2 in chips)
Seat 3: Delfinnegro2023 ($2 in chips)
Seat 4: LLregs ($4.18 in chips)
Seat 5: Nutu1313 ($2.40 in chips)
Seat 6: 39REDMAN ($5.40 in chips)
Fzst119: posts small blind $0.01
Delfinnegro2023: posts big blind $0.02
*** HOLE CARDS ***
Dealt to LLregs [7s 2d]
LLregs: folds
Nutu1313: folds
39REDMAN: folds
descandy: raises $0.04 to $0.06
Fzst119: folds
Delfinnegro2023: folds
Uncalled bet ($0.04) returned to descandy
descandy collected $0.05 from pot
descandy: doesn't show hand
*** SUMMARY ***
Total pot $0.05 | Rake $0
Seat 1: descandy (button) collected ($0.05)
Seat 2: Fzst119 (small blind) folded before Flop
Seat 3: Delfinnegro2023 (big blind) folded before Flop
Seat 4: LLregs folded before Flop (didn't bet)
Seat 5: Nutu1313 folded before Flop (didn't bet)
Seat 6: 39REDMAN folded before Flop (didn't bet)

PokerStars Zoom Hand #247960680057:  Hold'em No Limit ($0.01/$0.02) - 2023/12/30 16:07:05 WET [2023/12/30 11:07:05 ET]
Table 'Halley' 6-max Seat #1 is the button
Seat 1: tyzlit ($2.22 in chips)
Seat 2: MSerik ($2.12 in chips)
Seat 3: gaidzys gieda ($2.19 in chips)
Seat 4: LLregs ($4.18 in chips)
Seat 5: iliyan66 ($12.30 in chips)
Seat 6: jandsonpower ($4.52 in chips)
MSerik: posts small blind $0.01
gaidzys gieda: posts big blind $0.02
*** HOLE CARDS ***
Dealt to LLregs [3d 6h]
LLregs: folds
iliyan66: folds
jandsonpower: raises $0.03 to $0.05
tyzlit: folds
MSerik: raises $0.12 to $0.17
gaidzys gieda: folds
jandsonpower: folds
Uncalled bet ($0.12) returned to MSerik
MSerik collected $0.12 from pot
MSerik: doesn't show hand
*** SUMMARY ***
Total pot $0.12 | Rake $0
Seat 1: tyzlit (button) folded before Flop (didn't bet)
Seat 2: MSerik (small blind) collected ($0.12)
Seat 3: gaidzys gieda (big blind) folded before Flop
Seat 4: LLregs folded before Flop (didn't bet)
Seat 5: iliyan66 folded before Flop (didn't bet)
Seat 6: jandsonpower folded before Flop

PokerStars Zoom Hand #247960681573:  Hold'em No Limit ($0.01/$0.02) - 2023/12/30 16:07:10 WET [2023/12/30 11:07:10 ET]
Table 'Halley' 6-max Seat #1 is the button
Seat 1: Maxi infinity ($2.09 in chips)
Seat 2: LLregs ($4.18 in chips)
Seat 3: sandrão71 ($1.04 in chips)
Seat 4: Fabricionu ($3.67 in chips)
Seat 5: DeXxTroza ($2.15 in chips)
Seat 6: Livio100 ($0.76 in chips)
LLregs: posts small blind $0.01
sandrão71: posts big blind $0.02
*** HOLE CARDS ***
Dealt to LLregs [6h 2s]
Fabricionu: folds
DeXxTroza: folds
Livio100: folds
Maxi infinity: raises $0.03 to $0.05
LLregs: folds
sandrão71: calls $0.03
*** FLOP *** [Ad 8h 8c]
sandrão71: checks
Maxi infinity: bets $0.04
sandrão71: folds
Uncalled bet ($0.04) returned to Maxi infinity
Maxi infinity collected $0.11 from pot
Maxi infinity: doesn't show hand
*** SUMMARY ***
Total pot $0.11 | Rake $0
Board [Ad 8h 8c]
Seat 1: Maxi infinity (button) collected ($0.11)
Seat 2: LLregs (small blind) folded before Flop
Seat 3: sandrão71 (big blind) folded on the Flop
Seat 4: Fabricionu folded before Flop (didn't bet)
Seat 5: DeXxTroza folded before Flop (didn't bet)
Seat 6: Livio100 folded before Flop (didn't bet)

PokerStars Zoom Hand #247960682655:  Hold'em No Limit ($0.01/$0.02) - 2023/12/30 16:07:14 WET [2023/12/30 11:07:14 ET]
Table 'Halley' 6-max Seat #1 is the button
Seat 1: Nisquu1 ($2.35 in chips)
Seat 2: iPitbull1 ($2.14 in chips)
Seat 3: Fabricionu ($3.67 in chips)
Seat 4: kuelas ($2.06 in chips)
Seat 5: LLregs ($4.17 in chips)
Seat 6: dsousAA ($2 in chips)
iPitbull1: posts small blind $0.01
Fabricionu: posts big blind $0.02
*** HOLE CARDS ***
Dealt to LLregs [8s Qc]
kuelas: raises $0.02 to $0.04
LLregs: folds
dsousAA: folds
Nisquu1: folds
iPitbull1: folds
Fabricionu: calls $0.02
*** FLOP *** [4d 4c Kh]
Fabricionu: checks
kuelas: bets $0.04
Fabricionu: calls $0.04
*** TURN *** [4d 4c Kh] [Ts]
Fabricionu: checks
kuelas: bets $0.08
Fabricionu: calls $0.08
*** RIVER *** [4d 4c Kh Ts] [9c]
Fabricionu: checks
kuelas: checks
*** SHOW DOWN ***
Fabricionu: shows [2c 2s] (two pair, Fours and Deuces)
kuelas: shows [6h 6c] (two pair, Sixes and Fours)
kuelas collected $0.32 from pot
*** SUMMARY ***
Total pot $0.33 | Rake $0.01
Board [4d 4c Kh Ts 9c]
Seat 1: Nisquu1 (button) folded before Flop (didn't bet)
Seat 2: iPitbull1 (small blind) folded before Flop
Seat 3: Fabricionu (big blind) showed [2c 2s] and lost with two pair, Fours and Deuces
Seat 4: kuelas showed [6h 6c] and won ($0.32) with two pair, Sixes and Fours
Seat 5: LLregs folded before Flop (didn't bet)
Seat 6: dsousAA folded before Flop (didn't bet)

PokerStars Zoom Hand #247960685106:  Hold'em No Limit ($0.01/$0.02) - 2023/12/30 16:07:22 WET [2023/12/30 11:07:22 ET]
Table 'Halley' 6-max Seat #1 is the button
Seat 1: Nutu1313 ($7.11 in chips)
Seat 2: SpectralLynx ($2.77 in chips)
Seat 3: PozzzitiF ($1.07 in chips)
Seat 4: LLregs ($4.17 in chips)
Seat 5: inhonestus ($3.58 in chips)
Seat 6: 888lifeIS ($2.04 in chips)
SpectralLynx: posts small blind $0.01
PozzzitiF: posts big blind $0.02
*** HOLE CARDS ***
Dealt to LLregs [Ad Jc]
LLregs: raises $0.04 to $0.06
inhonestus: folds
888lifeIS: folds
Nutu1313: folds
SpectralLynx: folds
PozzzitiF: folds
Uncalled bet ($0.04) returned to LLregs
LLregs collected $0.05 from pot
LLregs: doesn't show hand
*** SUMMARY ***
Total pot $0.05 | Rake $0
Seat 1: Nutu1313 (button) folded before Flop (didn't bet)
Seat 2: SpectralLynx (small blind) folded before Flop
Seat 3: PozzzitiF (big blind) folded before Flop
Seat 4: LLregs collected ($0.05)
Seat 5: inhonestus folded before Flop (didn't bet)
Seat 6: 888lifeIS folded before Flop (didn't bet)

PokerStars Zoom Hand #247960683738:  Hold'em No Limit ($0.01/$0.02) - 2023/12/30 16:07:18 WET [2023/12/30 11:07:18 ET]
Table 'Halley' 6-max Seat #1 is the button
Seat 1: lasica8312 ($2.25 in chips)
Seat 2: Jhon Rambo.CL ($3.39 in chips)
Seat 3: Arabescul ($2 in chips)
Seat 4: LLregs ($4.17 in chips)
Seat 5: ZiggyBoy90 ($2.31 in chips)
Seat 6: Fzst119 ($2 in chips)
Jhon Rambo.CL: posts small blind $0.01
Arabescul: posts big blind $0.02
*** HOLE CARDS ***
Dealt to LLregs [3s 7h]
LLregs: folds
ZiggyBoy90: raises $0.03 to $0.05
Fzst119: folds
lasica8312: folds
Jhon Rambo.CL: calls $0.04
Arabescul: folds
*** FLOP *** [As Ad 8h]
Jhon Rambo.CL: checks
ZiggyBoy90: bets $0.04
Jhon Rambo.CL: calls $0.04
*** TURN *** [As Ad 8h] [Jd]
Jhon Rambo.CL: checks
ZiggyBoy90: bets $0.14
Jhon Rambo.CL: calls $0.14
*** RIVER *** [As Ad 8h Jd] [Kd]
Jhon Rambo.CL: checks
ZiggyBoy90: checks
*** SHOW DOWN ***
Jhon Rambo.CL: shows [7c Ac] (three of a kind, Aces)
ZiggyBoy90: mucks hand
Jhon Rambo.CL collected $0.46 from pot
*** SUMMARY ***
Total pot $0.48 | Rake $0.02
Board [As Ad 8h Jd Kd]
Seat 1: lasica8312 (button) folded before Flop (didn't bet)
Seat 2: Jhon Rambo.CL (small blind) showed [7c Ac] and won ($0.46) with three of a kind, Aces
Seat 3: Arabescul (big blind) folded before Flop
Seat 4: LLregs folded before Flop (didn't bet)
Seat 5: ZiggyBoy90 mucked [9c Qc]
Seat 6: Fzst119 folded before Flop (didn't bet)

PokerStars Zoom Hand #247960694692:  Hold'em No Limit ($0.01/$0.02) - 2023/12/30 16:07:55 WET [2023/12/30 11:07:55 ET]
Table 'Halley' 6-max Seat #1 is the button
Seat 1: GoldeN0330 ($2.30 in chips)
Seat 2: LLregs ($4.20 in chips)
Seat 3: jailson509 ($1.11 in chips)
Seat 4: ungiwar ($1.10 in chips)
Seat 5: Campus RO ($1.01 in chips)
Seat 6: MSerik ($2.47 in chips)
LLregs: posts small blind $0.01
jailson509: posts big blind $0.02
*** HOLE CARDS ***
Dealt to LLregs [5h Qc]
ungiwar: raises $0.02 to $0.04
Campus RO: folds
MSerik: folds
GoldeN0330: folds
LLregs: folds
jailson509: folds
Uncalled bet ($0.02) returned to ungiwar
ungiwar collected $0.05 from pot
ungiwar: doesn't show hand
*** SUMMARY ***
Total pot $0.05 | Rake $0
Seat 1: GoldeN0330 (button) folded before Flop (didn't bet)
Seat 2: LLregs (small blind) folded before Flop
Seat 3: jailson509 (big blind) folded before Flop
Seat 4: ungiwar collected ($0.05)
Seat 5: Campus RO folded before Flop (didn't bet)
Seat 6: MSerik folded before Flop (didn't bet)

PokerStars Zoom Hand #247960697430:  Hold'em No Limit ($0.01/$0.02) - 2023/12/30 16:08:04 WET [2023/12/30 11:08:04 ET]
Table 'Halley' 6-max Seat #1 is the button
Seat 1: kaaaaw ($3.53 in chips)
Seat 2: magnus59 ($1.48 in chips)
Seat 3: LLregs ($4.19 in chips)
Seat 4: Campus RO ($1.01 in chips)
Seat 5: Shmatrixs ($6.62 in chips)
Seat 6: kyriarxoss ($3.95 in chips)
magnus59: posts small blind $0.01
LLregs: posts big blind $0.02
*** HOLE CARDS ***
Dealt to LLregs [Tc Qs]
Campus RO: raises $0.02 to $0.04
Shmatrixs: folds
kyriarxoss: raises $0.02 to $0.06
kaaaaw: folds
magnus59: folds
LLregs: calls $0.04
Campus RO: calls $0.02
*** FLOP *** [7h Qd Ts]
LLregs: checks
Campus RO: bets $0.06
kyriarxoss: raises $0.06 to $0.12
LLregs: calls $0.12
Campus RO: calls $0.06
*** TURN *** [7h Qd Ts] [8d]
LLregs: checks
Campus RO: checks
kyriarxoss: checks
*** RIVER *** [7h Qd Ts 8d] [Ac]
LLregs: bets $0.12
Campus RO: folds
kyriarxoss: raises $0.39 to $0.51
LLregs: calls $0.39
*** SHOW DOWN ***
kyriarxoss: shows [4d Th] (a pair of Tens)
LLregs: shows [Tc Qs] (two pair, Queens and Tens)
LLregs collected $1.52 from pot
*** SUMMARY ***
Total pot $1.57 | Rake $0.05
Board [7h Qd Ts 8d Ac]
Seat 1: kaaaaw (button) folded before Flop (didn't bet)
Seat 2: magnus59 (small blind) folded before Flop
Seat 3: LLregs (big blind) showed [Tc Qs] and won ($1.52) with two pair, Queens and Tens
Seat 4: Campus RO folded on the River
Seat 5: Shmatrixs folded before Flop (didn't bet)
Seat 6: kyriarxoss showed [4d Th] and lost with a pair of Tens

PokerStars Zoom Hand #247960719820:  Hold'em No Limit ($0.01/$0.02) - 2023/12/30 16:09:20 WET [2023/12/30 11:09:20 ET]
Table 'Halley' 6-max Seat #1 is the button
Seat 1: LLregs ($5.02 in chips)
Seat 2: theprince188 ($10.68 in chips)
Seat 3: ifiret68 ($2 in chips)
Seat 4: Delfinnegro2023 ($2.20 in chips)
Seat 5: chinex_sba ($2.03 in chips)
Seat 6: BilugaMaster ($2.09 in chips)
theprince188: posts small blind $0.01
ifiret68: posts big blind $0.02
*** HOLE CARDS ***
Dealt to LLregs [As 2s]
Delfinnegro2023: folds
chinex_sba: folds
BilugaMaster: folds
LLregs: folds
theprince188: raises $0.03 to $0.05
ifiret68: folds
Uncalled bet ($0.03) returned to theprince188
theprince188 collected $0.04 from pot
theprince188: doesn't show hand
*** SUMMARY ***
Total pot $0.04 | Rake $0
Seat 1: LLregs (button) folded before Flop (didn't bet)
Seat 2: theprince188 (small blind) collected ($0.04)
Seat 3: ifiret68 (big blind) folded before Flop
Seat 4: Delfinnegro2023 folded before Flop (didn't bet)
Seat 5: chinex_sba folded before Flop (didn't bet)
Seat 6: BilugaMaster folded before Flop (didn't bet)

PokerStars Zoom Hand #247960721253:  Hold'em No Limit ($0.01/$0.02) - 2023/12/30 16:09:25 WET [2023/12/30 11:09:25 ET]
Table 'Halley' 6-max Seat #1 is the button
Seat 1: ONIPIKA ($2.14 in chips)
Seat 2: P.K.45677 ($2.40 in chips)
Seat 3: MXLVI ($2.19 in chips)
Seat 4: chinex_sba ($2.03 in chips)
Seat 5: gmansilva ($2 in chips)
Seat 6: LLregs ($5.02 in chips)
P.K.45677: posts small blind $0.01
MXLVI: posts big blind $0.02
*** HOLE CARDS ***
Dealt to LLregs [4h 4c]
chinex_sba: folds
gmansilva: raises $0.02 to $0.04
LLregs: calls $0.04
ONIPIKA: folds
P.K.45677: folds
MXLVI: raises $0.16 to $0.20
gmansilva: calls $0.16
LLregs: folds
*** FLOP *** [3c Kc Jc]
MXLVI: checks
gmansilva: checks
*** TURN *** [3c Kc Jc] [Kh]
MXLVI: checks
gmansilva: checks
*** RIVER *** [3c Kc Jc Kh] [2d]
MXLVI: checks
gmansilva: bets $0.22
MXLVI: folds
Uncalled bet ($0.22) returned to gmansilva
gmansilva collected $0.43 from pot
gmansilva: doesn't show hand
*** SUMMARY ***
Total pot $0.45 | Rake $0.02
Board [3c Kc Jc Kh 2d]
Seat 1: ONIPIKA (button) folded before Flop (didn't bet)
Seat 2: P.K.45677 (small blind) folded before Flop
Seat 3: MXLVI (big blind) folded on the River
Seat 4: chinex_sba folded before Flop (didn't bet)
Seat 5: gmansilva collected ($0.43)
Seat 6: LLregs folded before Flop

PokerStars Zoom Hand #247960735259:  Hold'em No Limit ($0.01/$0.02) - 2023/12/30 16:10:13 WET [2023/12/30 11:10:13 ET]
Table 'Halley' 6-max Seat #1 is the button
Seat 1: GoldLion77 ($2.29 in chips)
Seat 2: PozzzitiF ($0.68 in chips)
Seat 3: LLregs ($4.98 in chips)
Seat 4: Skelter_AAA ($2.18 in chips)
Seat 5: Arabescul ($2.01 in chips)
Seat 6: gmansilva ($2.23 in chips)
PozzzitiF: posts small blind $0.01
LLregs: posts big blind $0.02
*** HOLE CARDS ***
Dealt to LLregs [3c 3h]
Skelter_AAA: folds
Arabescul: folds
gmansilva: folds
GoldLion77: raises $0.03 to $0.05
PozzzitiF: raises $0.63 to $0.68 and is all-in
LLregs: folds
GoldLion77: folds
Uncalled bet ($0.63) returned to PozzzitiF
PozzzitiF collected $0.12 from pot
PozzzitiF: doesn't show hand
*** SUMMARY ***
Total pot $0.12 | Rake $0
Seat 1: GoldLion77 (button) folded before Flop
Seat 2: PozzzitiF (small blind) collected ($0.12)
Seat 3: LLregs (big blind) folded before Flop
Seat 4: Skelter_AAA folded before Flop (didn't bet)
Seat 5: Arabescul folded before Flop (didn't bet)
Seat 6: gmansilva folded before Flop (didn't bet)

PokerStars Zoom Hand #247960740013:  Hold'em No Limit ($0.01/$0.02) - 2023/12/30 16:10:29 WET [2023/12/30 11:10:29 ET]
Table 'Halley' 6-max Seat #1 is the button
Seat 1: Lysy1979 ($2 in chips)
Seat 2: LLregs ($4.96 in chips)
Seat 3: giantmonkey36 ($2 in chips)
Seat 4: theprince188 ($10.77 in chips)
Seat 5: 7zudluy7 ($1.20 in chips)
Seat 6: Gerard Hopkins ($2.50 in chips)
LLregs: posts small blind $0.01
giantmonkey36: posts big blind $0.02
*** HOLE CARDS ***
Dealt to LLregs [8c 4d]
theprince188: raises $0.03 to $0.05
7zudluy7: folds
Gerard Hopkins: folds
Lysy1979: folds
LLregs: folds
giantmonkey36: folds
Uncalled bet ($0.03) returned to theprince188
theprince188 collected $0.05 from pot
theprince188: doesn't show hand
*** SUMMARY ***
Total pot $0.05 | Rake $0
Seat 1: Lysy1979 (button) folded before Flop (didn't bet)
Seat 2: LLregs (small blind) folded before Flop
Seat 3: giantmonkey36 (big blind) folded before Flop
Seat 4: theprince188 collected ($0.05)
Seat 5: 7zudluy7 folded before Flop (didn't bet)
Seat 6: Gerard Hopkins folded before Flop (didn't bet)

PokerStars Zoom Hand #247960732979:  Hold'em No Limit ($0.01/$0.02) - 2023/12/30 16:10:05 WET [2023/12/30 11:10:05 ET]
Table 'Halley' 6-max Seat #1 is the button
Seat 1: LLregs ($4.98 in chips)
Seat 2: Odysseia ($2.52 in chips)
Seat 3: Fearedhel ($1.25 in chips)
Seat 4: praznina ($2.44 in chips)
Seat 5: PozzzitiF ($0.68 in chips)
Seat 6: woelli30 ($2.80 in chips)
Odysseia: posts small blind $0.01
Fearedhel: posts big blind $0.02
*** HOLE CARDS ***
Dealt to LLregs [Js 3h]
praznina: folds
PozzzitiF: folds
woelli30: raises $0.02 to $0.04
LLregs: folds
Odysseia: raises $0.10 to $0.14
Fearedhel: calls $0.12
woelli30: folds
*** FLOP *** [7d 3d 6h]
Odysseia: checks
Fearedhel: bets $0.31
Odysseia: raises $0.93 to $1.24
Fearedhel: calls $0.80 and is all-in
Uncalled bet ($0.13) returned to Odysseia
*** TURN *** [7d 3d 6h] [3c]
*** RIVER *** [7d 3d 6h 3c] [Kh]
*** SHOW DOWN ***
Odysseia: shows [As 6s] (two pair, Sixes and Threes)
Fearedhel: shows [Jc 7c] (two pair, Sevens and Threes)
Fearedhel collected $2.45 from pot
*** SUMMARY ***
Total pot $2.54 | Rake $0.09
Board [7d 3d 6h 3c Kh]
Seat 1: LLregs (button) folded before Flop (didn't bet)
Seat 2: Odysseia (small blind) showed [As 6s] and lost with two pair, Sixes and Threes
Seat 3: Fearedhel (big blind) showed [Jc 7c] and won ($2.45) with two pair, Sevens and Threes
Seat 4: praznina folded before Flop (didn't bet)
Seat 5: PozzzitiF folded before Flop (didn't bet)
Seat 6: woelli30 folded before Flop

PokerStars Zoom Hand #247960734170:  Hold'em No Limit ($0.01/$0.02) - 2023/12/30 16:10:09 WET [2023/12/30 11:10:09 ET]
Table 'Halley' 6-max Seat #1 is the button
Seat 1: 888lifeIS ($2.20 in chips)
Seat 2: Harold_Seven ($9.08 in chips)
Seat 3: GoldeN0330 ($2.22 in chips)
Seat 4: liquidxrome ($1.04 in chips)
Seat 5: September 022 ($2.17 in chips)
Seat 6: LLregs ($4.98 in chips)
Harold_Seven: posts small blind $0.01
GoldeN0330: posts big blind $0.02
*** HOLE CARDS ***
Dealt to LLregs [4s 6d]
liquidxrome: folds
September 022: folds
LLregs: folds
888lifeIS: folds
Harold_Seven: raises $0.02 to $0.04
GoldeN0330: calls $0.02
*** FLOP *** [6s Ah 3c]
Harold_Seven: checks
GoldeN0330: checks
*** TURN *** [6s Ah 3c] [9c]
Harold_Seven: bets $0.05
GoldeN0330: folds
Uncalled bet ($0.05) returned to Harold_Seven
Harold_Seven collected $0.08 from pot
Harold_Seven: doesn't show hand
*** SUMMARY ***
Total pot $0.08 | Rake $0
Board [6s Ah 3c 9c]
Seat 1: 888lifeIS (button) folded before Flop (didn't bet)
Seat 2: Harold_Seven (small blind) collected ($0.08)
Seat 3: GoldeN0330 (big blind) folded on the Turn
Seat 4: liquidxrome folded before Flop (didn't bet)
Seat 5: September 022 folded before Flop (didn't bet)
Seat 6: LLregs folded before Flop (didn't bet)

PokerStars Zoom Hand #247960741161:  Hold'em No Limit ($0.01/$0.02) - 2023/12/30 16:10:33 WET [2023/12/30 11:10:33 ET]
Table 'Halley' 6-max Seat #1 is the button
Seat 1: VIDOPRO23 ($2.23 in chips)
Seat 2: 010felipes ($1.80 in chips)
Seat 3: Lysy1979 ($2.77 in chips)
Seat 4: leedsrounder ($2.07 in chips)
Seat 5: LLregs ($4.95 in chips)
Seat 6: NeckCarp ($0.90 in chips)
010felipes: posts small blind $0.01
Lysy1979: posts big blind $0.02
*** HOLE CARDS ***
Dealt to LLregs [Ad Kd]
leedsrounder: folds
LLregs: raises $0.04 to $0.06
NeckCarp: calls $0.06
VIDOPRO23: folds
010felipes: folds
Lysy1979: calls $0.04
*** FLOP *** [Ac 8c Jc]
Lysy1979: checks
LLregs: bets $0.09
NeckCarp: folds
Lysy1979: calls $0.09
*** TURN *** [Ac 8c Jc] [7d]
Lysy1979: checks
LLregs: bets $0.12
Lysy1979: calls $0.12
*** RIVER *** [Ac 8c Jc 7d] [4c]
Lysy1979: checks
LLregs: checks
*** SHOW DOWN ***
Lysy1979: shows [Th Tc] (a flush, Ace high)
LLregs: mucks hand
Lysy1979 collected $0.59 from pot
*** SUMMARY ***
Total pot $0.61 | Rake $0.02
Board [Ac 8c Jc 7d 4c]
Seat 1: VIDOPRO23 (button) folded before Flop (didn't bet)
Seat 2: 010felipes (small blind) folded before Flop
Seat 3: Lysy1979 (big blind) showed [Th Tc] and won ($0.59) with a flush, Ace high
Seat 4: leedsrounder folded before Flop (didn't bet)
Seat 5: LLregs mucked [Ad Kd]
Seat 6: NeckCarp folded on the Flop

PokerStars Zoom Hand #247960756149:  Hold'em No Limit ($0.01/$0.02) - 2023/12/30 16:11:24 WET [2023/12/30 11:11:24 ET]
Table 'Halley' 6-max Seat #1 is the button
Seat 1: LLregs ($4.68 in chips)
Seat 2: MATIASdaKING32 ($1.96 in chips)
Seat 3: BadBeat Bert ($1.55 in chips)
Seat 4: DeadKiriyama ($4.52 in chips)
Seat 5: tomdane96 ($2.02 in chips)
Seat 6: djulio94rike ($2 in chips)
MATIASdaKING32: posts small blind $0.01
BadBeat Bert: posts big blind $0.02
*** HOLE CARDS ***
Dealt to LLregs [4h 2c]
DeadKiriyama: folds
tomdane96: raises $0.03 to $0.05
djulio94rike: folds
LLregs: folds
MATIASdaKING32: folds
BadBeat Bert: folds
Uncalled bet ($0.03) returned to tomdane96
tomdane96 collected $0.05 from pot
tomdane96: doesn't show hand
*** SUMMARY ***
Total pot $0.05 | Rake $0
Seat 1: LLregs (button) folded before Flop (didn't bet)
Seat 2: MATIASdaKING32 (small blind) folded before Flop
Seat 3: BadBeat Bert (big blind) folded before Flop
Seat 4: DeadKiriyama folded before Flop (didn't bet)
Seat 5: tomdane96 collected ($0.05)
Seat 6: djulio94rike folded before Flop (didn't bet)

PokerStars Zoom Hand #247960757150:  Hold'em No Limit ($0.01/$0.02) - 2023/12/30 16:11:27 WET [2023/12/30 11:11:27 ET]
Table 'Halley' 6-max Seat #1 is the button
Seat 1: High Fumph ($2.02 in chips)
Seat 2: Balonas ($2 in chips)
Seat 3: P.K.45677 ($2.49 in chips)
Seat 4: LLregs ($4.68 in chips)
Seat 5: Thooorrr ($2.03 in chips)
Seat 6: iPitbull1 ($2.48 in chips)
Balonas: posts small blind $0.01
P.K.45677: posts big blind $0.02
*** HOLE CARDS ***
Dealt to LLregs [8s Jh]
LLregs: folds
Thooorrr: raises $0.03 to $0.05
iPitbull1: folds
High Fumph: folds
Balonas: folds
P.K.45677: folds
Uncalled bet ($0.03) returned to Thooorrr
Thooorrr collected $0.05 from pot
Thooorrr: doesn't show hand
*** SUMMARY ***
Total pot $0.05 | Rake $0
Seat 1: High Fumph (button) folded before Flop (didn't bet)
Seat 2: Balonas (small blind) folded before Flop
Seat 3: P.K.45677 (big blind) folded before Flop
Seat 4: LLregs folded before Flop (didn't bet)
Seat 5: Thooorrr collected ($0.05)
Seat 6: iPitbull1 folded before Flop (didn't bet)

PokerStars Zoom Hand #247960759721:  Hold'em No Limit ($0.01/$0.02) - 2023/12/30 16:11:36 WET [2023/12/30 11:11:36 ET]
Table 'Halley' 6-max Seat #1 is the button
Seat 1: dsousAA ($2.08 in chips)
Seat 2: 07ijmando ($3.79 in chips)
Seat 3: theprince188 ($3.07 in chips)
Seat 4: vecinul ($2.03 in chips)
Seat 5: LLregs ($4.68 in chips)
Seat 6: iliyan66 ($6.05 in chips)
07ijmando: posts small blind $0.01
theprince188: posts big blind $0.02
*** HOLE CARDS ***
Dealt to LLregs [8c 9h]
vecinul: folds
LLregs: folds
iliyan66: folds
dsousAA: folds
07ijmando: folds
Uncalled bet ($0.01) returned to theprince188
theprince188 collected $0.02 from pot
theprince188: doesn't show hand
*** SUMMARY ***
Total pot $0.02 | Rake $0
Seat 1: dsousAA (button) folded before Flop (didn't bet)
Seat 2: 07ijmando (small blind) folded before Flop
Seat 3: theprince188 (big blind) collected ($0.02)
Seat 4: vecinul folded before Flop (didn't bet)
Seat 5: LLregs folded before Flop (didn't bet)
Seat 6: iliyan66 folded before Flop (didn't bet)

PokerStars Zoom Hand #247960758616:  Hold'em No Limit ($0.01/$0.02) - 2023/12/30 16:11:32 WET [2023/12/30 11:11:32 ET]
Table 'Halley' 6-max Seat #1 is the button
Seat 1: PozzzitiF ($1.14 in chips)
Seat 2: ONIPIKA ($2.01 in chips)
Seat 3: High Fumph ($2.03 in chips)
Seat 4: LLregs ($4.68 in chips)
Seat 5: giantmonkey36 ($2.09 in chips)
Seat 6: PR3SUR3 ($4.91 in chips)
ONIPIKA: posts small blind $0.01
High Fumph: posts big blind $0.02
*** HOLE CARDS ***
Dealt to LLregs [2c Qc]
LLregs: folds
giantmonkey36: raises $0.03 to $0.05
PR3SUR3: folds
PozzzitiF: folds
ONIPIKA: folds
High Fumph: calls $0.03
*** FLOP *** [7h 5c 7d]
High Fumph: checks
giantmonkey36: bets $0.04
High Fumph: folds
Uncalled bet ($0.04) returned to giantmonkey36
giantmonkey36 collected $0.11 from pot
giantmonkey36: doesn't show hand
*** SUMMARY ***
Total pot $0.11 | Rake $0
Board [7h 5c 7d]
Seat 1: PozzzitiF (button) folded before Flop (didn't bet)
Seat 2: ONIPIKA (small blind) folded before Flop
Seat 3: High Fumph (big blind) folded on the Flop
Seat 4: LLregs folded before Flop (didn't bet)
Seat 5: giantmonkey36 collected ($0.11)
Seat 6: PR3SUR3 folded before Flop (didn't bet)

PokerStars Zoom Hand #247960760892:  Hold'em No Limit ($0.01/$0.02) - 2023/12/30 16:11:40 WET [2023/12/30 11:11:40 ET]
Table 'Halley' 6-max Seat #1 is the button
Seat 1: zoli1981 ($1.47 in chips)
Seat 2: 39REDMAN ($5.48 in chips)
Seat 3: LLregs ($4.68 in chips)
Seat 4: tyzlit ($2.17 in chips)
Seat 5: September 022 ($2.03 in chips)
Seat 6: akasku54 ($1.51 in chips)
39REDMAN: posts small blind $0.01
LLregs: posts big blind $0.02
*** HOLE CARDS ***
Dealt to LLregs [6h 3d]
tyzlit: folds
September 022: folds
akasku54: folds
zoli1981: calls $0.02
39REDMAN: calls $0.01
LLregs: checks
*** FLOP *** [6d Ah 5d]
39REDMAN: checks
LLregs: bets $0.02
zoli1981: folds
39REDMAN: calls $0.02
*** TURN *** [6d Ah 5d] [7s]
39REDMAN: checks
LLregs: checks
*** RIVER *** [6d Ah 5d 7s] [8h]
39REDMAN: checks
LLregs: bets $0.05
39REDMAN: folds
Uncalled bet ($0.05) returned to LLregs
LLregs collected $0.10 from pot
LLregs: doesn't show hand
*** SUMMARY ***
Total pot $0.10 | Rake $0
Board [6d Ah 5d 7s 8h]
Seat 1: zoli1981 (button) folded on the Flop
Seat 2: 39REDMAN (small blind) folded on the River
Seat 3: LLregs (big blind) collected ($0.10)
Seat 4: tyzlit folded before Flop (didn't bet)
Seat 5: September 022 folded before Flop (didn't bet)
Seat 6: akasku54 folded before Flop (didn't bet)

PokerStars Zoom Hand #247960771090:  Hold'em No Limit ($0.01/$0.02) - 2023/12/30 16:12:15 WET [2023/12/30 11:12:15 ET]
Table 'Halley' 6-max Seat #1 is the button
Seat 1: iPitbull1 ($2.48 in chips)
Seat 2: LLregs ($4.74 in chips)
Seat 3: lapoleka ($0.54 in chips)
Seat 4: Jenly1234 ($3.37 in chips)
Seat 5: giantmonkey36 ($2.01 in chips)
Seat 6: Fidelity#33 ($0.77 in chips)
LLregs: posts small blind $0.01
lapoleka: posts big blind $0.02
*** HOLE CARDS ***
Dealt to LLregs [Qh Td]
Jenly1234: folds
giantmonkey36: raises $0.03 to $0.05
Fidelity#33: folds
iPitbull1: folds
LLregs: calls $0.04
lapoleka: folds
*** FLOP *** [2c Jd 2h]
LLregs: checks
giantmonkey36: bets $0.04
LLregs: calls $0.04
*** TURN *** [2c Jd 2h] [2s]
LLregs: checks
giantmonkey36: checks
*** RIVER *** [2c Jd 2h 2s] [9c]
LLregs: bets $0.06
giantmonkey36: calls $0.06
*** SHOW DOWN ***
LLregs: shows [Qh Td] (three of a kind, Deuces)
giantmonkey36: shows [Jh Kh] (a full house, Deuces full of Jacks)
giantmonkey36 collected $0.31 from pot
*** SUMMARY ***
Total pot $0.32 | Rake $0.01
Board [2c Jd 2h 2s 9c]
Seat 1: iPitbull1 (button) folded before Flop (didn't bet)
Seat 2: LLregs (small blind) showed [Qh Td] and lost with three of a kind, Deuces
Seat 3: lapoleka (big blind) folded before Flop
Seat 4: Jenly1234 folded before Flop (didn't bet)
Seat 5: giantmonkey36 showed [Jh Kh] and won ($0.31) with a full house, Deuces full of Jacks
Seat 6: Fidelity#33 folded before Flop (didn't bet)

PokerStars Zoom Hand #247960784562:  Hold'em No Limit ($0.01/$0.02) - 2023/12/30 16:13:01 WET [2023/12/30 11:13:01 ET]
Table 'Halley' 6-max Seat #1 is the button
Seat 1: LLregs ($4.59 in chips)
Seat 2: QRX46 ($0.07 in chips)
Seat 3: gorgio1973 ($1.81 in chips)
Seat 4: nuttymuch ($7.41 in chips)
Seat 5: Sakke44 ($5.65 in chips)
Seat 6: jandsonpower ($6.73 in chips)
QRX46: posts small blind $0.01
gorgio1973: posts big blind $0.02
*** HOLE CARDS ***
Dealt to LLregs [2d Qc]
nuttymuch: folds
Sakke44: folds
jandsonpower: folds
LLregs: folds
QRX46: folds
Uncalled bet ($0.01) returned to gorgio1973
gorgio1973 collected $0.02 from pot
gorgio1973: doesn't show hand
*** SUMMARY ***
Total pot $0.02 | Rake $0
Seat 1: LLregs (button) folded before Flop (didn't bet)
Seat 2: QRX46 (small blind) folded before Flop
Seat 3: gorgio1973 (big blind) collected ($0.02)
Seat 4: nuttymuch folded before Flop (didn't bet)
Seat 5: Sakke44 folded before Flop (didn't bet)
Seat 6: jandsonpower folded before Flop (didn't bet)

PokerStars Zoom Hand #247960787401:  Hold'em No Limit ($0.01/$0.02) - 2023/12/30 16:13:11 WET [2023/12/30 11:13:11 ET]
Table 'Halley' 6-max Seat #1 is the button
Seat 1: Odysseia ($1.06 in chips)
Seat 2: MassterD21 ($3.38 in chips)
Seat 3: vovan22-99 ($1.64 in chips)
Seat 4: Fabs944 ($4.41 in chips)
Seat 5: High Fumph ($1.97 in chips)
Seat 6: LLregs ($4.59 in chips)
MassterD21: posts small blind $0.01
vovan22-99: posts big blind $0.02
*** HOLE CARDS ***
Dealt to LLregs [Ah 2s]
Fabs944: folds
High Fumph: folds
LLregs: folds
Odysseia: raises $0.04 to $0.06
MassterD21: folds
vovan22-99: folds
Uncalled bet ($0.04) returned to Odysseia
Odysseia collected $0.05 from pot
Odysseia: doesn't show hand
*** SUMMARY ***
Total pot $0.05 | Rake $0
Seat 1: Odysseia (button) collected ($0.05)
Seat 2: MassterD21 (small blind) folded before Flop
Seat 3: vovan22-99 (big blind) folded before Flop
Seat 4: Fabs944 folded before Flop (didn't bet)
Seat 5: High Fumph folded before Flop (didn't bet)
Seat 6: LLregs folded before Flop (didn't bet)

PokerStars Zoom Hand #247960789125:  Hold'em No Limit ($0.01/$0.02) - 2023/12/30 16:13:17 WET [2023/12/30 11:13:17 ET]
Table 'Halley' 6-max Seat #1 is the button
Seat 1: gorgio1973 ($1.81 in chips)
Seat 2: LLregs ($4.59 in chips)
Seat 3: rafds765 ($5.60 in chips)
Seat 4: vecinul ($3.27 in chips)
Seat 5: ssapperlott ($2 in chips)
Seat 6: Maxi infinity ($2.59 in chips)
LLregs: posts small blind $0.01
rafds765: posts big blind $0.02
*** HOLE CARDS ***
Dealt to LLregs [Kh Tc]
vecinul: folds
ssapperlott has timed out
ssapperlott: folds
Maxi infinity: folds
gorgio1973: folds
LLregs: raises $0.04 to $0.06
rafds765: folds
Uncalled bet ($0.04) returned to LLregs
LLregs collected $0.04 from pot
LLregs: doesn't show hand
*** SUMMARY ***
Total pot $0.04 | Rake $0
Seat 1: gorgio1973 (button) folded before Flop (didn't bet)
Seat 2: LLregs (small blind) collected ($0.04)
Seat 3: rafds765 (big blind) folded before Flop
Seat 4: vecinul folded before Flop (didn't bet)
Seat 5: ssapperlott folded before Flop (didn't bet)
Seat 6: Maxi infinity folded before Flop (didn't bet)

PokerStars Zoom Hand #247960798671:  Hold'em No Limit ($0.01/$0.02) - 2023/12/30 16:13:49 WET [2023/12/30 11:13:49 ET]
Table 'Halley' 6-max Seat #1 is the button
Seat 1: loneginger ($2.03 in chips)
Seat 2: RodrigoNC340 ($3.86 in chips)
Seat 3: AllstarCon ($2.02 in chips)
Seat 4: pessimist53 ($0.69 in chips)
Seat 5: LLregs ($4.61 in chips)
Seat 6: Thooorrr ($2.03 in chips)
RodrigoNC340: posts small blind $0.01
AllstarCon: posts big blind $0.02
*** HOLE CARDS ***
Dealt to LLregs [9d 8d]
pessimist53: raises $0.04 to $0.06
LLregs: folds
Thooorrr: folds
loneginger: folds
RodrigoNC340: folds
AllstarCon: folds
Uncalled bet ($0.04) returned to pessimist53
pessimist53 collected $0.05 from pot
pessimist53: doesn't show hand
*** SUMMARY ***
Total pot $0.05 | Rake $0
Seat 1: loneginger (button) folded before Flop (didn't bet)
Seat 2: RodrigoNC340 (small blind) folded before Flop
Seat 3: AllstarCon (big blind) folded before Flop
Seat 4: pessimist53 collected ($0.05)
Seat 5: LLregs folded before Flop (didn't bet)
Seat 6: Thooorrr folded before Flop (didn't bet)

PokerStars Zoom Hand #247960803104:  Hold'em No Limit ($0.01/$0.02) - 2023/12/30 16:14:04 WET [2023/12/30 11:14:04 ET]
Table 'Halley' 6-max Seat #1 is the button
Seat 1: giantmonkey36 ($2.16 in chips)
Seat 2: WWR73 ($3.04 in chips)
Seat 3: LLregs ($4.61 in chips)
Seat 4: rafds765 ($14.51 in chips)
Seat 5: Scarlet cloak ($2 in chips)
Seat 6: dedmazaika80 ($1.98 in chips)
WWR73: posts small blind $0.01
LLregs: posts big blind $0.02
*** HOLE CARDS ***
Dealt to LLregs [8d Ks]
rafds765: folds
Scarlet cloak: folds
dedmazaika80: calls $0.02
giantmonkey36: folds
WWR73: folds
LLregs: raises $0.04 to $0.06
dedmazaika80: calls $0.04
*** FLOP *** [3h 9h 9s]
LLregs: checks
dedmazaika80: checks
*** TURN *** [3h 9h 9s] [Qh]
LLregs: bets $0.06
dedmazaika80: calls $0.06
*** RIVER *** [3h 9h 9s Qh] [Tc]
LLregs: bets $0.08
dedmazaika80: calls $0.08
*** SHOW DOWN ***
LLregs: shows [8d Ks] (a pair of Nines)
dedmazaika80: shows [Qd Ts] (two pair, Queens and Tens)
dedmazaika80 collected $0.40 from pot
*** SUMMARY ***
Total pot $0.41 | Rake $0.01
Board [3h 9h 9s Qh Tc]
Seat 1: giantmonkey36 (button) folded before Flop (didn't bet)
Seat 2: WWR73 (small blind) folded before Flop
Seat 3: LLregs (big blind) showed [8d Ks] and lost with a pair of Nines
Seat 4: rafds765 folded before Flop (didn't bet)
Seat 5: Scarlet cloak folded before Flop (didn't bet)
Seat 6: dedmazaika80 showed [Qd Ts] and won ($0.40) with two pair, Queens and Tens

PokerStars Zoom Hand #247960819563:  Hold'em No Limit ($0.01/$0.02) - 2023/12/30 16:15:00 WET [2023/12/30 11:15:00 ET]
Table 'Halley' 6-max Seat #1 is the button
Seat 1: LLregs ($4.41 in chips)
Seat 2: lordz1 ($2.24 in chips)
Seat 3: RTedeschi19 ($1.71 in chips)
Seat 4: vecinul ($2.28 in chips)
Seat 5: dedmazaika80 ($2.18 in chips)
Seat 6: September 022 ($2 in chips)
lordz1: posts small blind $0.01
RTedeschi19: posts big blind $0.02
*** HOLE CARDS ***
Dealt to LLregs [7h Jh]
vecinul: raises $0.04 to $0.06
dedmazaika80 is disconnected
dedmazaika80 has timed out while disconnected
dedmazaika80: folds
September 022: folds
LLregs: calls $0.06
lordz1: folds
RTedeschi19: calls $0.04
*** FLOP *** [Js Ts Ac]
RTedeschi19: bets $0.18
vecinul: calls $0.18
LLregs: folds
*** TURN *** [Js Ts Ac] [5c]
RTedeschi19: checks
vecinul: bets $0.80
RTedeschi19: calls $0.80
*** RIVER *** [Js Ts Ac 5c] [Kc]
RTedeschi19: bets $0.67 and is all-in
vecinul: calls $0.67
*** SHOW DOWN ***
RTedeschi19: shows [5s Ks] (two pair, Kings and Fives)
vecinul: shows [Jc Ad] (two pair, Aces and Jacks)
vecinul collected $3.37 from pot
*** SUMMARY ***
Total pot $3.49 | Rake $0.12
Board [Js Ts Ac 5c Kc]
Seat 1: LLregs (button) folded on the Flop
Seat 2: lordz1 (small blind) folded before Flop
Seat 3: RTedeschi19 (big blind) showed [5s Ks] and lost with two pair, Kings and Fives
Seat 4: vecinul showed [Jc Ad] and won ($3.37) with two pair, Aces and Jacks
Seat 5: dedmazaika80 folded before Flop (didn't bet)
Seat 6: September 022 folded before Flop (didn't bet)

PokerStars Zoom Hand #247960832058:  Hold'em No Limit ($0.01/$0.02) - 2023/12/30 16:15:42 WET [2023/12/30 11:15:42 ET]
Table 'Halley' 6-max Seat #1 is the button
Seat 1: D3j4nuts ($1.86 in chips)
Seat 2: iPitbull1 ($2 in chips)
Seat 3: Jack_191200 ($1.73 in chips)
Seat 4: jameshutch00 ($2.28 in chips)
Seat 5: LLregs ($4.35 in chips)
Seat 6: Odysseia ($1.93 in chips)
iPitbull1: posts small blind $0.01
Jack_191200: posts big blind $0.02
*** HOLE CARDS ***
Dealt to LLregs [Ad As]
jameshutch00: calls $0.02
LLregs: raises $0.04 to $0.06
Odysseia: folds
D3j4nuts: folds
iPitbull1: folds
Jack_191200: folds
jameshutch00: calls $0.04
*** FLOP *** [Qh Ac Jd]
jameshutch00: checks
LLregs: checks
*** TURN *** [Qh Ac Jd] [Ah]
jameshutch00: bets $0.14
LLregs: calls $0.14
*** RIVER *** [Qh Ac Jd Ah] [4d]
jameshutch00: bets $0.21
LLregs: raises $0.40 to $0.61
jameshutch00: calls $0.40
*** SHOW DOWN ***
LLregs: shows [Ad As] (four of a kind, Aces)
jameshutch00: mucks hand
LLregs collected $1.59 from pot
*** SUMMARY ***
Total pot $1.65 | Rake $0.06
Board [Qh Ac Jd Ah 4d]
Seat 1: D3j4nuts (button) folded before Flop (didn't bet)
Seat 2: iPitbull1 (small blind) folded before Flop
Seat 3: Jack_191200 (big blind) folded before Flop
Seat 4: jameshutch00 mucked [Qc 9d]
Seat 5: LLregs showed [Ad As] and won ($1.59) with four of a kind, Aces
Seat 6: Odysseia folded before Flop (didn't bet)

PokerStars Zoom Hand #247960852400:  Hold'em No Limit ($0.01/$0.02) - 2023/12/30 16:16:50 WET [2023/12/30 11:16:50 ET]
Table 'Halley' 6-max Seat #1 is the button
Seat 1: Johnstefk ($2.05 in chips)
Seat 2: Harold_Seven ($10.01 in chips)
Seat 3: psdgr3 ($2.03 in chips)
Seat 4: jameshutch00 ($1.47 in chips)
Seat 5: Poklikash? ($3.64 in chips)
Seat 6: LLregs ($5.13 in chips)
Harold_Seven: posts small blind $0.01
psdgr3: posts big blind $0.02
*** HOLE CARDS ***
Dealt to LLregs [5d Kc]
jameshutch00: folds
Poklikash?: raises $0.03 to $0.05
LLregs: folds
Johnstefk: folds
Harold_Seven: folds
psdgr3: folds
Uncalled bet ($0.03) returned to Poklikash?
Poklikash? collected $0.05 from pot
Poklikash?: doesn't show hand
*** SUMMARY ***
Total pot $0.05 | Rake $0
Seat 1: Johnstefk (button) folded before Flop (didn't bet)
Seat 2: Harold_Seven (small blind) folded before Flop
Seat 3: psdgr3 (big blind) folded before Flop
Seat 4: jameshutch00 folded before Flop (didn't bet)
Seat 5: Poklikash? collected ($0.05)
Seat 6: LLregs folded before Flop (didn't bet)

PokerStars Zoom Hand #247960857792:  Hold'em No Limit ($0.01/$0.02) - 2023/12/30 16:17:08 WET [2023/12/30 11:17:08 ET]
Table 'Halley' 6-max Seat #1 is the button
Seat 1: marcegring ($4.59 in chips)
Seat 2: Dexter9922 ($2.43 in chips)
Seat 3: MATIASdaKING32 ($1.94 in chips)
Seat 4: LLregs ($5.13 in chips)
Seat 5: Sakke44 ($4.61 in chips)
Seat 6: Pedrowilso ($1.83 in chips)
Dexter9922: posts small blind $0.01
MATIASdaKING32: posts big blind $0.02
*** HOLE CARDS ***
Dealt to LLregs [7d 8h]
LLregs: folds
Sakke44: folds
Pedrowilso: folds
marcegring: folds
Dexter9922: folds
Uncalled bet ($0.01) returned to MATIASdaKING32
MATIASdaKING32 collected $0.02 from pot
MATIASdaKING32: doesn't show hand
*** SUMMARY ***
Total pot $0.02 | Rake $0
Seat 1: marcegring (button) folded before Flop (didn't bet)
Seat 2: Dexter9922 (small blind) folded before Flop
Seat 3: MATIASdaKING32 (big blind) collected ($0.02)
Seat 4: LLregs folded before Flop (didn't bet)
Seat 5: Sakke44 folded before Flop (didn't bet)
Seat 6: Pedrowilso folded before Flop (didn't bet)

PokerStars Zoom Hand #247960854666:  Hold'em No Limit ($0.01/$0.02) - 2023/12/30 16:16:58 WET [2023/12/30 11:16:58 ET]
Table 'Halley' 6-max Seat #1 is the button
Seat 1: chinex_sba ($2 in chips)
Seat 2: Tombombadillo88 ($1.80 in chips)
Seat 3: iPitbull1 ($2.02 in chips)
Seat 4: Fidelity#33 ($0.80 in chips)
Seat 5: LLregs ($5.13 in chips)
Seat 6: vladuross ($2.89 in chips)
Tombombadillo88: posts small blind $0.01
iPitbull1: posts big blind $0.02
*** HOLE CARDS ***
Dealt to LLregs [3d Ad]
Fidelity#33: raises $0.04 to $0.06
LLregs: folds
vladuross: folds
chinex_sba: folds
Tombombadillo88: calls $0.05
iPitbull1: folds
*** FLOP *** [5s Jh 7s]
Tombombadillo88: checks
Fidelity#33: bets $0.06
Tombombadillo88: folds
Uncalled bet ($0.06) returned to Fidelity#33
Fidelity#33 collected $0.14 from pot
Fidelity#33: doesn't show hand
*** SUMMARY ***
Total pot $0.14 | Rake $0
Board [5s Jh 7s]
Seat 1: chinex_sba (button) folded before Flop (didn't bet)
Seat 2: Tombombadillo88 (small blind) folded on the Flop
Seat 3: iPitbull1 (big blind) folded before Flop
Seat 4: Fidelity#33 collected ($0.14)
Seat 5: LLregs folded before Flop (didn't bet)
Seat 6: vladuross folded before Flop (didn't bet)

PokerStars Zoom Hand #247960858985:  Hold'em No Limit ($0.01/$0.02) - 2023/12/30 16:17:12 WET [2023/12/30 11:17:12 ET]
Table 'Halley' 6-max Seat #1 is the button
Seat 1: MXLVI ($2.07 in chips)
Seat 2: 2plateado2 ($2 in chips)
Seat 3: LLregs ($5.13 in chips)
Seat 4: olsekpoker ($2 in chips)
Seat 5: nuttymuch ($2.12 in chips)
Seat 6: LeBreton67 ($1.30 in chips)
2plateado2: posts small blind $0.01
LLregs: posts big blind $0.02
*** HOLE CARDS ***
Dealt to LLregs [3s Kd]
olsekpoker: folds
nuttymuch: folds
LeBreton67: folds
MXLVI: folds
2plateado2: raises $0.04 to $0.06
LLregs: folds
Uncalled bet ($0.04) returned to 2plateado2
2plateado2 collected $0.04 from pot
2plateado2: doesn't show hand
*** SUMMARY ***
Total pot $0.04 | Rake $0
Seat 1: MXLVI (button) folded before Flop (didn't bet)
Seat 2: 2plateado2 (small blind) collected ($0.04)
Seat 3: LLregs (big blind) folded before Flop
Seat 4: olsekpoker folded before Flop (didn't bet)
Seat 5: nuttymuch folded before Flop (didn't bet)
Seat 6: LeBreton67 folded before Flop (didn't bet)

PokerStars Zoom Hand #247960867468:  Hold'em No Limit ($0.01/$0.02) - 2023/12/30 16:17:40 WET [2023/12/30 11:17:40 ET]
Table 'Halley' 6-max Seat #1 is the button
Seat 1: Maxi infinity ($2.12 in chips)
Seat 2: LLregs ($5.11 in chips)
Seat 3: MFanderson ($2 in chips)
Seat 4: gismouck ($2.63 in chips)
Seat 5: zoli1981 ($1.96 in chips)
Seat 6: iPitbull1 ($2 in chips)
LLregs: posts small blind $0.01
MFanderson: posts big blind $0.02
*** HOLE CARDS ***
Dealt to LLregs [9s 7h]
gismouck: folds
zoli1981: folds
iPitbull1: folds
Maxi infinity: folds
LLregs: raises $0.04 to $0.06
MFanderson: folds
Uncalled bet ($0.04) returned to LLregs
LLregs collected $0.04 from pot
LLregs: doesn't show hand
*** SUMMARY ***
Total pot $0.04 | Rake $0
Seat 1: Maxi infinity (button) folded before Flop (didn't bet)
Seat 2: LLregs (small blind) collected ($0.04)
Seat 3: MFanderson (big blind) folded before Flop
Seat 4: gismouck folded before Flop (didn't bet)
Seat 5: zoli1981 folded before Flop (didn't bet)
Seat 6: iPitbull1 folded before Flop (didn't bet)

PokerStars Zoom Hand #247960871974:  Hold'em No Limit ($0.01/$0.02) - 2023/12/30 16:17:55 WET [2023/12/30 11:17:55 ET]
Table 'Halley' 6-max Seat #1 is the button
Seat 1: LLregs ($5.13 in chips)
Seat 2: marcegring ($3.59 in chips)
Seat 3: GoldeN0330 ($2.02 in chips)
Seat 4: drchilled ($5.94 in chips)
Seat 5: September 022 ($2 in chips)
Seat 6: Skelter_AAA ($2.14 in chips)
marcegring: posts small blind $0.01
GoldeN0330: posts big blind $0.02
*** HOLE CARDS ***
Dealt to LLregs [2c Ah]
drchilled: raises $0.04 to $0.06
September 022: folds
Skelter_AAA: folds
LLregs: calls $0.06
marcegring: folds
GoldeN0330: folds
*** FLOP *** [Th 9c 7d]
drchilled: checks
LLregs: checks
*** TURN *** [Th 9c 7d] [6s]
drchilled: bets $0.07
LLregs: folds
Uncalled bet ($0.07) returned to drchilled
drchilled collected $0.14 from pot
drchilled: doesn't show hand
*** SUMMARY ***
Total pot $0.15 | Rake $0.01
Board [Th 9c 7d 6s]
Seat 1: LLregs (button) folded on the Turn
Seat 2: marcegring (small blind) folded before Flop
Seat 3: GoldeN0330 (big blind) folded before Flop
Seat 4: drchilled collected ($0.14)
Seat 5: September 022 folded before Flop (didn't bet)
Seat 6: Skelter_AAA folded before Flop (didn't bet)

PokerStars Zoom Hand #247960882809:  Hold'em No Limit ($0.01/$0.02) - 2023/12/30 16:18:31 WET [2023/12/30 11:18:31 ET]
Table 'Halley' 6-max Seat #1 is the button
Seat 1: 2plateado2 ($2.44 in chips)
Seat 2: descandy ($2 in chips)
Seat 3: DeXxTroza ($2.09 in chips)
Seat 4: iliyan66 ($12.24 in chips)
Seat 5: SebaBarre ($2.01 in chips)
Seat 6: LLregs ($5.07 in chips)
descandy: posts small blind $0.01
DeXxTroza: posts big blind $0.02
*** HOLE CARDS ***
Dealt to LLregs [8s 4d]
iliyan66 has timed out
iliyan66: folds
SebaBarre: raises $0.04 to $0.06
LLregs: folds
2plateado2: folds
descandy: folds
DeXxTroza: folds
Uncalled bet ($0.04) returned to SebaBarre
SebaBarre collected $0.05 from pot
SebaBarre: doesn't show hand
*** SUMMARY ***
Total pot $0.05 | Rake $0
Seat 1: 2plateado2 (button) folded before Flop (didn't bet)
Seat 2: descandy (small blind) folded before Flop
Seat 3: DeXxTroza (big blind) folded before Flop
Seat 4: iliyan66 folded before Flop (didn't bet)
Seat 5: SebaBarre collected ($0.05)
Seat 6: LLregs folded before Flop (didn't bet)

PokerStars Zoom Hand #247960887319:  Hold'em No Limit ($0.01/$0.02) - 2023/12/30 16:18:46 WET [2023/12/30 11:18:46 ET]
Table 'Halley' 6-max Seat #1 is the button
Seat 1: RTedeschi19 ($2.26 in chips)
Seat 2: Odysseia ($1.71 in chips)
Seat 3: r3v3rs3f3r3t ($2.34 in chips)
Seat 4: LLregs ($5.07 in chips)
Seat 5: nuttymuch ($7.15 in chips)
Seat 6: rdp86 ($2.02 in chips)
Odysseia: posts small blind $0.01
r3v3rs3f3r3t: posts big blind $0.02
*** HOLE CARDS ***
Dealt to LLregs [Jd 3s]
LLregs: folds
nuttymuch: folds
rdp86: raises $0.06 to $0.08
RTedeschi19: folds
Odysseia: folds
r3v3rs3f3r3t: folds
Uncalled bet ($0.06) returned to rdp86
rdp86 collected $0.05 from pot
rdp86: doesn't show hand
*** SUMMARY ***
Total pot $0.05 | Rake $0
Seat 1: RTedeschi19 (button) folded before Flop (didn't bet)
Seat 2: Odysseia (small blind) folded before Flop
Seat 3: r3v3rs3f3r3t (big blind) folded before Flop
Seat 4: LLregs folded before Flop (didn't bet)
Seat 5: nuttymuch folded before Flop (didn't bet)
Seat 6: rdp86 collected ($0.05)

PokerStars Zoom Hand #247960888897:  Hold'em No Limit ($0.01/$0.02) - 2023/12/30 16:18:51 WET [2023/12/30 11:18:51 ET]
Table 'Halley' 6-max Seat #1 is the button
Seat 1: rrluis1930 ($4.96 in chips)
Seat 2: Balonas ($2.26 in chips)
Seat 3: Jhon Rambo.CL ($7.55 in chips)
Seat 4: PR3SUR3 ($4.64 in chips)
Seat 5: milhouse999 ($1.63 in chips)
Seat 6: LLregs ($5.07 in chips)
Balonas: posts small blind $0.01
Jhon Rambo.CL: posts big blind $0.02
*** HOLE CARDS ***
Dealt to LLregs [Qs Th]
PR3SUR3: folds
milhouse999: folds
LLregs: raises $0.04 to $0.06
rrluis1930: folds
Balonas: folds
Jhon Rambo.CL: folds
Uncalled bet ($0.04) returned to LLregs
LLregs collected $0.05 from pot
LLregs: doesn't show hand
*** SUMMARY ***
Total pot $0.05 | Rake $0
Seat 1: rrluis1930 (button) folded before Flop (didn't bet)
Seat 2: Balonas (small blind) folded before Flop
Seat 3: Jhon Rambo.CL (big blind) folded before Flop
Seat 4: PR3SUR3 folded before Flop (didn't bet)
Seat 5: milhouse999 folded before Flop (didn't bet)
Seat 6: LLregs collected ($0.05)

PokerStars Zoom Hand #247960904168:  Hold'em No Limit ($0.01/$0.02) - 2023/12/30 16:19:43 WET [2023/12/30 11:19:43 ET]
Table 'Halley' 6-max Seat #1 is the button
Seat 1: nuttymuch ($2 in chips)
Seat 2: 39REDMAN ($4.84 in chips)
Seat 3: LLregs ($5.10 in chips)
Seat 4: dmitriy2426 ($1.97 in chips)
Seat 5: RevivalFish ($2.04 in chips)
Seat 6: GoldeN0330 ($2 in chips)
39REDMAN: posts small blind $0.01
LLregs: posts big blind $0.02
*** HOLE CARDS ***
Dealt to LLregs [Kc 2c]
dmitriy2426: folds
RevivalFish: raises $0.04 to $0.06
GoldeN0330: folds
nuttymuch: folds
39REDMAN: folds
LLregs: calls $0.04
*** FLOP *** [Qd 4h Ad]
LLregs: checks
RevivalFish: bets $0.13
LLregs: folds
Uncalled bet ($0.13) returned to RevivalFish
RevivalFish collected $0.13 from pot
RevivalFish: doesn't show hand
*** SUMMARY ***
Total pot $0.13 | Rake $0
Board [Qd 4h Ad]
Seat 1: nuttymuch (button) folded before Flop (didn't bet)
Seat 2: 39REDMAN (small blind) folded before Flop
Seat 3: LLregs (big blind) folded on the Flop
Seat 4: dmitriy2426 folded before Flop (didn't bet)
Seat 5: RevivalFish collected ($0.13)
Seat 6: GoldeN0330 folded before Flop (didn't bet)

PokerStars Zoom Hand #247960916924:  Hold'em No Limit ($0.01/$0.02) - 2023/12/30 16:20:26 WET [2023/12/30 11:20:26 ET]
Table 'Halley' 6-max Seat #1 is the button
Seat 1: diegorodrigues3 ($1.93 in chips)
Seat 2: OMG77777 ($2.02 in chips)
Seat 3: quiet64 ($0.67 in chips)
Seat 4: LLregs ($5.04 in chips)
Seat 5: PR3SUR3 ($6.28 in chips)
Seat 6: PozzzitiF ($1.02 in chips)
OMG77777: posts small blind $0.01
quiet64: posts big blind $0.02
*** HOLE CARDS ***
Dealt to LLregs [2s Ks]
LLregs: folds
PR3SUR3: folds
PozzzitiF: folds
diegorodrigues3: folds
OMG77777: calls $0.01
quiet64: checks
*** FLOP *** [7d 4s 8c]
OMG77777: checks
quiet64: bets $0.04
OMG77777: folds
Uncalled bet ($0.04) returned to quiet64
quiet64 collected $0.04 from pot
quiet64: doesn't show hand
*** SUMMARY ***
Total pot $0.04 | Rake $0
Board [7d 4s 8c]
Seat 1: diegorodrigues3 (button) folded before Flop (didn't bet)
Seat 2: OMG77777 (small blind) folded on the Flop
Seat 3: quiet64 (big blind) collected ($0.04)
Seat 4: LLregs folded before Flop (didn't bet)
Seat 5: PR3SUR3 folded before Flop (didn't bet)
Seat 6: PozzzitiF folded before Flop (didn't bet)

PokerStars Zoom Hand #247960918385:  Hold'em No Limit ($0.01/$0.02) - 2023/12/30 16:20:31 WET [2023/12/30 11:20:31 ET]
Table 'Halley' 6-max Seat #1 is the button
Seat 1: rubyersi ($4 in chips)
Seat 2: LLregs ($5.04 in chips)
Seat 3: High Fumph ($1.52 in chips)
Seat 4: RTedeschi19 ($3.21 in chips)
Seat 5: VIDOPRO23 ($2.42 in chips)
Seat 6: portcounty ($0.98 in chips)
LLregs: posts small blind $0.01
High Fumph: posts big blind $0.02
*** HOLE CARDS ***
Dealt to LLregs [Qd 8s]
RTedeschi19: raises $0.02 to $0.04
VIDOPRO23: folds
portcounty: folds
rubyersi: folds
LLregs: raises $0.12 to $0.16
High Fumph: folds
RTedeschi19: calls $0.12
*** FLOP *** [4d 5s Kh]
LLregs: checks
RTedeschi19: bets $0.12
LLregs: raises $0.19 to $0.31
RTedeschi19: raises $0.45 to $0.76
LLregs: folds
Uncalled bet ($0.45) returned to RTedeschi19
RTedeschi19 collected $0.93 from pot
RTedeschi19: doesn't show hand
*** SUMMARY ***
Total pot $0.96 | Rake $0.03
Board [4d 5s Kh]
Seat 1: rubyersi (button) folded before Flop (didn't bet)
Seat 2: LLregs (small blind) folded on the Flop
Seat 3: High Fumph (big blind) folded before Flop
Seat 4: RTedeschi19 collected ($0.93)
Seat 5: VIDOPRO23 folded before Flop (didn't bet)
Seat 6: portcounty folded before Flop (didn't bet)

PokerStars Zoom Hand #247960937557:  Hold'em No Limit ($0.01/$0.02) - 2023/12/30 16:21:35 WET [2023/12/30 11:21:35 ET]
Table 'Halley' 6-max Seat #1 is the button
Seat 1: iPitbull1 ($2 in chips)
Seat 2: Scarlet cloak ($2.71 in chips)
Seat 3: anatoliw ($5.80 in chips)
Seat 4: LLregs ($4.57 in chips)
Seat 5: Dexterpoint ($1.95 in chips)
Seat 6: praznina ($1.36 in chips)
Scarlet cloak: posts small blind $0.01
anatoliw: posts big blind $0.02
*** HOLE CARDS ***
Dealt to LLregs [8c Ad]
LLregs: folds
Dexterpoint: folds
praznina has timed out
praznina: folds
iPitbull1: folds
Scarlet cloak: folds
Uncalled bet ($0.01) returned to anatoliw
anatoliw collected $0.02 from pot
anatoliw: doesn't show hand
*** SUMMARY ***
Total pot $0.02 | Rake $0
Seat 1: iPitbull1 (button) folded before Flop (didn't bet)
Seat 2: Scarlet cloak (small blind) folded before Flop
Seat 3: anatoliw (big blind) collected ($0.02)
Seat 4: LLregs folded before Flop (didn't bet)
Seat 5: Dexterpoint folded before Flop (didn't bet)
Seat 6: praznina folded before Flop (didn't bet)

PokerStars Zoom Hand #247960938703:  Hold'em No Limit ($0.01/$0.02) - 2023/12/30 16:21:38 WET [2023/12/30 11:21:38 ET]
Table 'Halley' 6-max Seat #1 is the button
Seat 1: tisadaisy ($2.03 in chips)
Seat 2: MSerik ($2.24 in chips)
Seat 3: rafds765 ($14.77 in chips)
Seat 4: GoldeN0330 ($2 in chips)
Seat 5: Balonas ($2 in chips)
Seat 6: LLregs ($4.57 in chips)
MSerik: posts small blind $0.01
rafds765: posts big blind $0.02
*** HOLE CARDS ***
Dealt to LLregs [2c 3h]
GoldeN0330: raises $0.04 to $0.06
Balonas: folds
LLregs: folds
tisadaisy: folds
MSerik: folds
rafds765: folds
Uncalled bet ($0.04) returned to GoldeN0330
GoldeN0330 collected $0.05 from pot
GoldeN0330: doesn't show hand
*** SUMMARY ***
Total pot $0.05 | Rake $0
Seat 1: tisadaisy (button) folded before Flop (didn't bet)
Seat 2: MSerik (small blind) folded before Flop
Seat 3: rafds765 (big blind) folded before Flop
Seat 4: GoldeN0330 collected ($0.05)
Seat 5: Balonas folded before Flop (didn't bet)
Seat 6: LLregs folded before Flop (didn't bet)

PokerStars Zoom Hand #247960936367:  Hold'em No Limit ($0.01/$0.02) - 2023/12/30 16:21:31 WET [2023/12/30 11:21:31 ET]
Table 'Halley' 6-max Seat #1 is the button
Seat 1: LLregs ($4.57 in chips)
Seat 2: Bigtallpaul85 ($1.44 in chips)
Seat 3: El Vheyn ($2.81 in chips)
Seat 4: OMG77777 ($2.06 in chips)
Seat 5: AllstarCon ($2 in chips)
Seat 6: BETH257 ($3.12 in chips)
Bigtallpaul85: posts small blind $0.01
El Vheyn: posts big blind $0.02
*** HOLE CARDS ***
Dealt to LLregs [Ah 3s]
OMG77777: folds
AllstarCon: folds
BETH257: calls $0.02
LLregs: folds
Bigtallpaul85: folds
El Vheyn: raises $0.04 to $0.06
BETH257: calls $0.04
*** FLOP *** [6h Jd 5c]
El Vheyn: bets $0.04
BETH257: calls $0.04
*** TURN *** [6h Jd 5c] [4d]
El Vheyn: bets $0.10
BETH257: calls $0.10
*** RIVER *** [6h Jd 5c 4d] [Qs]
El Vheyn: checks
BETH257: bets $0.20
El Vheyn: calls $0.20
*** SHOW DOWN ***
BETH257: shows [9s 8s] (high card Queen)
El Vheyn: shows [Tc Th] (a pair of Tens)
El Vheyn collected $0.78 from pot
*** SUMMARY ***
Total pot $0.81 | Rake $0.03
Board [6h Jd 5c 4d Qs]
Seat 1: LLregs (button) folded before Flop (didn't bet)
Seat 2: Bigtallpaul85 (small blind) folded before Flop
Seat 3: El Vheyn (big blind) showed [Tc Th] and won ($0.78) with a pair of Tens
Seat 4: OMG77777 folded before Flop (didn't bet)
Seat 5: AllstarCon folded before Flop (didn't bet)
Seat 6: BETH257 showed [9s 8s] and lost with high card Queen

PokerStars Zoom Hand #247960939433:  Hold'em No Limit ($0.01/$0.02) - 2023/12/30 16:21:41 WET [2023/12/30 11:21:41 ET]
Table 'Halley' 6-max Seat #1 is the button
Seat 1: Mumbeer1978 ($1.93 in chips)
Seat 2: OFSHOR ($4 in chips)
Seat 3: LLregs ($4.57 in chips)
Seat 4: tomdane96 ($2.29 in chips)
Seat 5: SteveDelgado ($2.20 in chips)
Seat 6: Jack_191200 ($1.43 in chips)
OFSHOR: posts small blind $0.01
LLregs: posts big blind $0.02
*** HOLE CARDS ***
Dealt to LLregs [6c 6s]
tomdane96: folds
SteveDelgado: folds
Jack_191200: folds
Mumbeer1978: calls $0.02
OFSHOR: folds
LLregs: raises $0.04 to $0.06
Mumbeer1978: calls $0.04
*** FLOP *** [Jd Qd 5d]
LLregs: bets $0.03
Mumbeer1978: calls $0.03
*** TURN *** [Jd Qd 5d] [5h]
LLregs: checks
Mumbeer1978: bets $0.09
LLregs: folds
Uncalled bet ($0.09) returned to Mumbeer1978
Mumbeer1978 collected $0.18 from pot
Mumbeer1978: doesn't show hand
*** SUMMARY ***
Total pot $0.19 | Rake $0.01
Board [Jd Qd 5d 5h]
Seat 1: Mumbeer1978 (button) collected ($0.18)
Seat 2: OFSHOR (small blind) folded before Flop
Seat 3: LLregs (big blind) folded on the Turn
Seat 4: tomdane96 folded before Flop (didn't bet)
Seat 5: SteveDelgado folded before Flop (didn't bet)
Seat 6: Jack_191200 folded before Flop (didn't bet)

PokerStars Zoom Hand #247960950408:  Hold'em No Limit ($0.01/$0.02) - 2023/12/30 16:22:17 WET [2023/12/30 11:22:17 ET]
Table 'Halley' 6-max Seat #1 is the button
Seat 1: turnburgler ($1.94 in chips)
Seat 2: LLregs ($4.48 in chips)
Seat 3: Roosvelt67 ($0.83 in chips)
Seat 4: vecinul ($3.22 in chips)
Seat 5: nuttymuch ($2.80 in chips)
Seat 6: Nutu1313 ($3.74 in chips)
LLregs: posts small blind $0.01
Roosvelt67: posts big blind $0.02
*** HOLE CARDS ***
Dealt to LLregs [7h Js]
vecinul: folds
nuttymuch: folds
Nutu1313: folds
turnburgler: folds
LLregs: folds
Uncalled bet ($0.01) returned to Roosvelt67
Roosvelt67 collected $0.02 from pot
Roosvelt67: doesn't show hand
*** SUMMARY ***
Total pot $0.02 | Rake $0
Seat 1: turnburgler (button) folded before Flop (didn't bet)
Seat 2: LLregs (small blind) folded before Flop
Seat 3: Roosvelt67 (big blind) collected ($0.02)
Seat 4: vecinul folded before Flop (didn't bet)
Seat 5: nuttymuch folded before Flop (didn't bet)
Seat 6: Nutu1313 folded before Flop (didn't bet)

PokerStars Zoom Hand #247960952537:  Hold'em No Limit ($0.01/$0.02) - 2023/12/30 16:22:25 WET [2023/12/30 11:22:25 ET]
Table 'Halley' 6-max Seat #1 is the button
Seat 1: Juggstar ($2.03 in chips)
Seat 2: 2plateado2 ($2.22 in chips)
Seat 3: nuttymuch ($6.69 in chips)
Seat 4: Nutu1313 ($2.84 in chips)
Seat 5: LLregs ($4.47 in chips)
Seat 6: RodrigoNC340 ($4.61 in chips)
2plateado2: posts small blind $0.01
nuttymuch: posts big blind $0.02
*** HOLE CARDS ***
Dealt to LLregs [Js Ah]
Nutu1313: raises $0.04 to $0.06
LLregs: calls $0.06
RodrigoNC340: folds
Juggstar: folds
2plateado2: folds
nuttymuch: calls $0.04
*** FLOP *** [Jh Ts 9c]
nuttymuch: checks
Nutu1313: checks
LLregs: bets $0.06
nuttymuch: folds
Nutu1313: calls $0.06
*** TURN *** [Jh Ts 9c] [3s]
Nutu1313: checks
LLregs: checks
*** RIVER *** [Jh Ts 9c 3s] [6d]
Nutu1313: checks
LLregs: bets $0.07
Nutu1313: folds
Uncalled bet ($0.07) returned to LLregs
LLregs collected $0.30 from pot
LLregs: doesn't show hand
*** SUMMARY ***
Total pot $0.31 | Rake $0.01
Board [Jh Ts 9c 3s 6d]
Seat 1: Juggstar (button) folded before Flop (didn't bet)
Seat 2: 2plateado2 (small blind) folded before Flop
Seat 3: nuttymuch (big blind) folded on the Flop
Seat 4: Nutu1313 folded on the River
Seat 5: LLregs collected ($0.30)
Seat 6: RodrigoNC340 folded before Flop (didn't bet)

PokerStars Zoom Hand #247960973884:  Hold'em No Limit ($0.01/$0.02) - 2023/12/30 16:23:37 WET [2023/12/30 11:23:37 ET]
Table 'Halley' 6-max Seat #1 is the button
Seat 1: ZiggyBoy90 ($2.26 in chips)
Seat 2: FishAndFurious ($2.07 in chips)
Seat 3: BadBeat Bert ($1.22 in chips)
Seat 4: pkrgrl04 ($4.45 in chips)
Seat 5: Tomas_Petriche ($1.52 in chips)
Seat 6: LLregs ($4.45 in chips)
FishAndFurious: posts small blind $0.01
BadBeat Bert: posts big blind $0.02
*** HOLE CARDS ***
Dealt to LLregs [5h As]
pkrgrl04: folds
Tomas_Petriche: folds
LLregs: folds
ZiggyBoy90: raises $0.03 to $0.05
FishAndFurious: folds
BadBeat Bert: folds
Uncalled bet ($0.03) returned to ZiggyBoy90
ZiggyBoy90 collected $0.05 from pot
ZiggyBoy90: doesn't show hand
*** SUMMARY ***
Total pot $0.05 | Rake $0
Seat 1: ZiggyBoy90 (button) collected ($0.05)
Seat 2: FishAndFurious (small blind) folded before Flop
Seat 3: BadBeat Bert (big blind) folded before Flop
Seat 4: pkrgrl04 folded before Flop (didn't bet)
Seat 5: Tomas_Petriche folded before Flop (didn't bet)
Seat 6: LLregs folded before Flop (didn't bet)

PokerStars Zoom Hand #247960964582:  Hold'em No Limit ($0.01/$0.02) - 2023/12/30 16:23:06 WET [2023/12/30 11:23:06 ET]
Table 'Halley' 6-max Seat #1 is the button
Seat 1: LLregs ($4.65 in chips)
Seat 2: djulio94rike ($2.01 in chips)
Seat 3: GirlieBurger ($2.15 in chips)
Seat 4: praznina ($2.44 in chips)
Seat 5: ivciks74lv ($2.06 in chips)
Seat 6: ZiggyBoy90 ($6.35 in chips)
djulio94rike: posts small blind $0.01
GirlieBurger: posts big blind $0.02
*** HOLE CARDS ***
Dealt to LLregs [9h 9s]
praznina: raises $0.04 to $0.06
ivciks74lv: calls $0.06
ZiggyBoy90: folds
LLregs: raises $0.14 to $0.20
djulio94rike: folds
GirlieBurger: raises $0.34 to $0.54
praznina: folds
ivciks74lv: folds
LLregs: folds
Uncalled bet ($0.34) returned to GirlieBurger
GirlieBurger collected $0.53 from pot
GirlieBurger: doesn't show hand
*** SUMMARY ***
Total pot $0.53 | Rake $0
Seat 1: LLregs (button) folded before Flop
Seat 2: djulio94rike (small blind) folded before Flop
Seat 3: GirlieBurger (big blind) collected ($0.53)
Seat 4: praznina folded before Flop
Seat 5: ivciks74lv folded before Flop
Seat 6: ZiggyBoy90 folded before Flop (didn't bet)

PokerStars Zoom Hand #247960975079:  Hold'em No Limit ($0.01/$0.02) - 2023/12/30 16:23:41 WET [2023/12/30 11:23:41 ET]
Table 'Halley' 6-max Seat #1 is the button
Seat 1: quiet64 ($0.69 in chips)
Seat 2: 888lifeIS ($2.07 in chips)
Seat 3: rubyersi ($4.07 in chips)
Seat 4: LLregs ($4.45 in chips)
Seat 5: Mikeloko182 ($5.36 in chips)
Seat 6: stanmatyk ($1.54 in chips)
888lifeIS: posts small blind $0.01
rubyersi: posts big blind $0.02
*** HOLE CARDS ***
Dealt to LLregs [Jd Kd]
LLregs: raises $0.04 to $0.06
Mikeloko182: folds
stanmatyk: folds
quiet64: folds
888lifeIS: folds
rubyersi: calls $0.04
*** FLOP *** [7s 8h Jh]
rubyersi: checks
LLregs: bets $0.04
rubyersi: folds
Uncalled bet ($0.04) returned to LLregs
LLregs collected $0.13 from pot
LLregs: doesn't show hand
*** SUMMARY ***
Total pot $0.13 | Rake $0
Board [7s 8h Jh]
Seat 1: quiet64 (button) folded before Flop (didn't bet)
Seat 2: 888lifeIS (small blind) folded before Flop
Seat 3: rubyersi (big blind) folded on the Flop
Seat 4: LLregs collected ($0.13)
Seat 5: Mikeloko182 folded before Flop (didn't bet)
Seat 6: stanmatyk folded before Flop (didn't bet)

PokerStars Zoom Hand #247960987686:  Hold'em No Limit ($0.01/$0.02) - 2023/12/30 16:24:23 WET [2023/12/30 11:24:23 ET]
Table 'Halley' 6-max Seat #1 is the button
Seat 1: Nutu1313 ($4.50 in chips)
Seat 2: Dexter9922 ($2.65 in chips)
Seat 3: LLregs ($4.52 in chips)
Seat 4: Maxi infinity ($2 in chips)
Seat 5: Billa1177 ($0.83 in chips)
Seat 6: FishAndFurious ($6.30 in chips)
Dexter9922: posts small blind $0.01
LLregs: posts big blind $0.02
*** HOLE CARDS ***
Dealt to LLregs [3c Ks]
Maxi infinity: folds
Billa1177: folds
FishAndFurious: folds
Nutu1313: raises $0.03 to $0.05
Dexter9922: folds
LLregs: folds
Uncalled bet ($0.03) returned to Nutu1313
Nutu1313 collected $0.05 from pot
Nutu1313: doesn't show hand
*** SUMMARY ***
Total pot $0.05 | Rake $0
Seat 1: Nutu1313 (button) collected ($0.05)
Seat 2: Dexter9922 (small blind) folded before Flop
Seat 3: LLregs (big blind) folded before Flop
Seat 4: Maxi infinity folded before Flop (didn't bet)
Seat 5: Billa1177 folded before Flop (didn't bet)
Seat 6: FishAndFurious folded before Flop (didn't bet)

PokerStars Zoom Hand #247960992940:  Hold'em No Limit ($0.01/$0.02) - 2023/12/30 16:24:41 WET [2023/12/30 11:24:41 ET]
Table 'Halley' 6-max Seat #1 is the button
Seat 1: kxetinha ($2.33 in chips)
Seat 2: LLregs ($4.50 in chips)
Seat 3: dsousAA ($2.02 in chips)
Seat 4: iPitbull1 ($2.34 in chips)
Seat 5: RodrigoNC340 ($4.45 in chips)
Seat 6: l_pokkkker_l ($2.17 in chips)
LLregs: posts small blind $0.01
dsousAA: posts big blind $0.02
*** HOLE CARDS ***
Dealt to LLregs [5c 9d]
iPitbull1: folds
RodrigoNC340: raises $0.04 to $0.06
l_pokkkker_l: folds
kxetinha: folds
LLregs: folds
dsousAA: folds
Uncalled bet ($0.04) returned to RodrigoNC340
RodrigoNC340 collected $0.05 from pot
RodrigoNC340: doesn't show hand
*** SUMMARY ***
Total pot $0.05 | Rake $0
Seat 1: kxetinha (button) folded before Flop (didn't bet)
Seat 2: LLregs (small blind) folded before Flop
Seat 3: dsousAA (big blind) folded before Flop
Seat 4: iPitbull1 folded before Flop (didn't bet)
Seat 5: RodrigoNC340 collected ($0.05)
Seat 6: l_pokkkker_l folded before Flop (didn't bet)

PokerStars Zoom Hand #247960986165:  Hold'em No Limit ($0.01/$0.02) - 2023/12/30 16:24:18 WET [2023/12/30 11:24:18 ET]
Table 'Halley' 6-max Seat #1 is the button
Seat 1: P.K.45677 ($2.07 in chips)
Seat 2: High Fumph ($1.28 in chips)
Seat 3: 888lifeIS ($2.09 in chips)
Seat 4: ZiggyBoy90 ($2.13 in chips)
Seat 5: LLregs ($4.52 in chips)
Seat 6: mihai_s1984 ($0.85 in chips)
High Fumph: posts small blind $0.01
888lifeIS: posts big blind $0.02
*** HOLE CARDS ***
Dealt to LLregs [5c 3h]
ZiggyBoy90: folds
LLregs: folds
mihai_s1984: folds
P.K.45677: folds
High Fumph: raises $0.02 to $0.04
888lifeIS: raises $0.14 to $0.18
High Fumph: calls $0.14
*** FLOP *** [7c Th 3c]
High Fumph: checks
888lifeIS: bets $0.18
High Fumph: folds
Uncalled bet ($0.18) returned to 888lifeIS
888lifeIS collected $0.35 from pot
888lifeIS: doesn't show hand
*** SUMMARY ***
Total pot $0.36 | Rake $0.01
Board [7c Th 3c]
Seat 1: P.K.45677 (button) folded before Flop (didn't bet)
Seat 2: High Fumph (small blind) folded on the Flop
Seat 3: 888lifeIS (big blind) collected ($0.35)
Seat 4: ZiggyBoy90 folded before Flop (didn't bet)
Seat 5: LLregs folded before Flop (didn't bet)
Seat 6: mihai_s1984 folded before Flop (didn't bet)

PokerStars Zoom Hand #247960993963:  Hold'em No Limit ($0.01/$0.02) - 2023/12/30 16:24:44 WET [2023/12/30 11:24:44 ET]
Table 'Halley' 6-max Seat #1 is the button
Seat 1: LLregs ($4.49 in chips)
Seat 2: MXLVI ($2 in chips)
Seat 3: Nutu1313 ($3.77 in chips)
Seat 4: Chupacabra G ($3.72 in chips)
Seat 5: Arabescul ($2.16 in chips)
Seat 6: praznina ($2.59 in chips)
MXLVI: posts small blind $0.01
Nutu1313: posts big blind $0.02
*** HOLE CARDS ***
Dealt to LLregs [8d 5h]
Chupacabra G: folds
Arabescul: folds
praznina: folds
LLregs: raises $0.04 to $0.06
MXLVI: calls $0.05
Nutu1313: folds
*** FLOP *** [9c 2c Js]
MXLVI: checks
LLregs: checks
*** TURN *** [9c 2c Js] [Kh]
MXLVI: checks
LLregs: bets $0.03
MXLVI: calls $0.03
*** RIVER *** [9c 2c Js Kh] [6s]
MXLVI: checks
LLregs: checks
*** SHOW DOWN ***
MXLVI: shows [Ac 6c] (a pair of Sixes)
LLregs: mucks hand
MXLVI collected $0.19 from pot
*** SUMMARY ***
Total pot $0.20 | Rake $0.01
Board [9c 2c Js Kh 6s]
Seat 1: LLregs (button) mucked [8d 5h]
Seat 2: MXLVI (small blind) showed [Ac 6c] and won ($0.19) with a pair of Sixes
Seat 3: Nutu1313 (big blind) folded before Flop
Seat 4: Chupacabra G folded before Flop (didn't bet)
Seat 5: Arabescul folded before Flop (didn't bet)
Seat 6: praznina folded before Flop (didn't bet)

PokerStars Zoom Hand #247961005612:  Hold'em No Limit ($0.01/$0.02) - 2023/12/30 16:25:24 WET [2023/12/30 11:25:24 ET]
Table 'Halley' 6-max Seat #1 is the button
Seat 1: minc85 ($2 in chips)
Seat 2: SaulN ($0.30 in chips)
Seat 3: RenoRosco ($2.06 in chips)
Seat 4: kevinlmaf ($1.12 in chips)
Seat 5: FishAndFurious ($6.31 in chips)
Seat 6: LLregs ($4.40 in chips)
SaulN: posts small blind $0.01
RenoRosco: posts big blind $0.02
*** HOLE CARDS ***
Dealt to LLregs [7d Qd]
kevinlmaf: folds
FishAndFurious: folds
LLregs: raises $0.02 to $0.04
minc85: raises $0.11 to $0.15
SaulN: folds
RenoRosco: raises $0.25 to $0.40
LLregs: folds
minc85: folds
Uncalled bet ($0.25) returned to RenoRosco
RenoRosco collected $0.35 from pot
RenoRosco: doesn't show hand
*** SUMMARY ***
Total pot $0.35 | Rake $0
Seat 1: minc85 (button) folded before Flop
Seat 2: SaulN (small blind) folded before Flop
Seat 3: RenoRosco (big blind) collected ($0.35)
Seat 4: kevinlmaf folded before Flop (didn't bet)
Seat 5: FishAndFurious folded before Flop (didn't bet)
Seat 6: LLregs folded before Flop

PokerStars Zoom Hand #247961014680:  Hold'em No Limit ($0.01/$0.02) - 2023/12/30 16:25:54 WET [2023/12/30 11:25:54 ET]
Table 'Halley' 6-max Seat #1 is the button
Seat 1: Stoichev777 ($7.74 in chips)
Seat 2: rrluis1930 ($2.12 in chips)
Seat 3: MXLVI ($2.07 in chips)
Seat 4: marcegring ($4.48 in chips)
Seat 5: LLregs ($4.36 in chips)
Seat 6: leedsrounder ($2.65 in chips)
rrluis1930: posts small blind $0.01
MXLVI: posts big blind $0.02
*** HOLE CARDS ***
Dealt to LLregs [Qs 9d]
marcegring has timed out
marcegring: folds
LLregs: folds
leedsrounder: folds
Stoichev777: folds
rrluis1930: raises $0.04 to $0.06
MXLVI: folds
Uncalled bet ($0.04) returned to rrluis1930
rrluis1930 collected $0.04 from pot
rrluis1930: doesn't show hand
*** SUMMARY ***
Total pot $0.04 | Rake $0
Seat 1: Stoichev777 (button) folded before Flop (didn't bet)
Seat 2: rrluis1930 (small blind) collected ($0.04)
Seat 3: MXLVI (big blind) folded before Flop
Seat 4: marcegring folded before Flop (didn't bet)
Seat 5: LLregs folded before Flop (didn't bet)
Seat 6: leedsrounder folded before Flop (didn't bet)

PokerStars Zoom Hand #247961015837:  Hold'em No Limit ($0.01/$0.02) - 2023/12/30 16:25:58 WET [2023/12/30 11:25:58 ET]
Table 'Halley' 6-max Seat #1 is the button
Seat 1: luciakabzsi ($3.39 in chips)
Seat 2: chianca98 ($2.20 in chips)
Seat 3: LLregs ($4.36 in chips)
Seat 4: VIDOPRO23 ($1.95 in chips)
Seat 5: tomdane96 ($3.21 in chips)
Seat 6: Asso187 ($2.27 in chips)
chianca98: posts small blind $0.01
LLregs: posts big blind $0.02
*** HOLE CARDS ***
Dealt to LLregs [Qs 3c]
VIDOPRO23: folds
tomdane96: folds
Asso187: folds
luciakabzsi: raises $0.02 to $0.04
chianca98: folds
LLregs: calls $0.02
*** FLOP *** [4h 6h Qh]
LLregs: checks
luciakabzsi: checks
*** TURN *** [4h 6h Qh] [Ad]
LLregs: bets $0.02
luciakabzsi: calls $0.02
*** RIVER *** [4h 6h Qh Ad] [Th]
LLregs: checks
luciakabzsi: checks
*** SHOW DOWN ***
LLregs: shows [Qs 3c] (a pair of Queens)
luciakabzsi: shows [5c Ac] (a pair of Aces)
luciakabzsi collected $0.13 from pot
*** SUMMARY ***
Total pot $0.13 | Rake $0
Board [4h 6h Qh Ad Th]
Seat 1: luciakabzsi (button) showed [5c Ac] and won ($0.13) with a pair of Aces
Seat 2: chianca98 (small blind) folded before Flop
Seat 3: LLregs (big blind) showed [Qs 3c] and lost with a pair of Queens
Seat 4: VIDOPRO23 folded before Flop (didn't bet)
Seat 5: tomdane96 folded before Flop (didn't bet)
Seat 6: Asso187 folded before Flop (didn't bet)

PokerStars Zoom Hand #247961023074:  Hold'em No Limit ($0.01/$0.02) - 2023/12/30 16:26:22 WET [2023/12/30 11:26:22 ET]
Table 'Halley' 6-max Seat #1 is the button
Seat 1: szary79 ($2.10 in chips)
Seat 2: LLregs ($4.30 in chips)
Seat 3: camelprof800 ($2.69 in chips)
Seat 4: Thooorrr ($2.49 in chips)
Seat 5: IngeniEbr10 ($2 in chips)
Seat 6: dsousAA ($2.03 in chips)
LLregs: posts small blind $0.01
camelprof800: posts big blind $0.02
*** HOLE CARDS ***
Dealt to LLregs [9s 6s]
Thooorrr: folds
IngeniEbr10: raises $0.02 to $0.04
dsousAA: folds
szary79: folds
LLregs: folds
camelprof800: folds
Uncalled bet ($0.02) returned to IngeniEbr10
IngeniEbr10 collected $0.05 from pot
IngeniEbr10: doesn't show hand
*** SUMMARY ***
Total pot $0.05 | Rake $0
Seat 1: szary79 (button) folded before Flop (didn't bet)
Seat 2: LLregs (small blind) folded before Flop
Seat 3: camelprof800 (big blind) folded before Flop
Seat 4: Thooorrr folded before Flop (didn't bet)
Seat 5: IngeniEbr10 collected ($0.05)
Seat 6: dsousAA folded before Flop (didn't bet)

PokerStars Zoom Hand #247961026686:  Hold'em No Limit ($0.01/$0.02) - 2023/12/30 16:26:34 WET [2023/12/30 11:26:34 ET]
Table 'Halley' 6-max Seat #1 is the button
Seat 1: cala23 ($1.11 in chips)
Seat 2: loneginger ($3.07 in chips)
Seat 3: nikkem971 ($2.43 in chips)
Seat 4: LLregs ($4.29 in chips)
Seat 5: Balonas ($2.08 in chips)
Seat 6: Dimoni797979 ($2.45 in chips)
loneginger: posts small blind $0.01
nikkem971: posts big blind $0.02
*** HOLE CARDS ***
Dealt to LLregs [4h 4d]
LLregs: raises $0.04 to $0.06
Balonas: folds
Dimoni797979: folds
cala23: calls $0.06
loneginger: folds
nikkem971: folds
*** FLOP *** [Tc Ac 7s]
LLregs: bets $0.07
cala23: folds
Uncalled bet ($0.07) returned to LLregs
LLregs collected $0.14 from pot
LLregs: doesn't show hand
*** SUMMARY ***
Total pot $0.15 | Rake $0.01
Board [Tc Ac 7s]
Seat 1: cala23 (button) folded on the Flop
Seat 2: loneginger (small blind) folded before Flop
Seat 3: nikkem971 (big blind) folded before Flop
Seat 4: LLregs collected ($0.14)
Seat 5: Balonas folded before Flop (didn't bet)
Seat 6: Dimoni797979 folded before Flop (didn't bet)

PokerStars Zoom Hand #247961032279:  Hold'em No Limit ($0.01/$0.02) - 2023/12/30 16:26:53 WET [2023/12/30 11:26:53 ET]
Table 'Halley' 6-max Seat #1 is the button
Seat 1: LLregs ($4.37 in chips)
Seat 2: ripbon ($2.14 in chips)
Seat 3: Gerard Hopkins ($2.43 in chips)
Seat 4: ONIPIKA ($2.15 in chips)
Seat 5: MXLVI ($2.03 in chips)
Seat 6: PR3SUR3 ($5.83 in chips)
ripbon: posts small blind $0.01
Gerard Hopkins: posts big blind $0.02
*** HOLE CARDS ***
Dealt to LLregs [9c Tc]
ONIPIKA: folds
MXLVI: folds
PR3SUR3: folds
LLregs: raises $0.04 to $0.06
ripbon: raises $0.18 to $0.24
Gerard Hopkins: folds
LLregs: folds
Uncalled bet ($0.18) returned to ripbon
ripbon collected $0.14 from pot
ripbon: doesn't show hand
*** SUMMARY ***
Total pot $0.14 | Rake $0
Seat 1: LLregs (button) folded before Flop
Seat 2: ripbon (small blind) collected ($0.14)
Seat 3: Gerard Hopkins (big blind) folded before Flop
Seat 4: ONIPIKA folded before Flop (didn't bet)
Seat 5: MXLVI folded before Flop (didn't bet)
Seat 6: PR3SUR3 folded before Flop (didn't bet)

PokerStars Zoom Hand #247964100715:  Hold'em No Limit ($0.01/$0.02) - 2023/12/30 19:02:03 WET [2023/12/30 14:02:03 ET]
Table 'Halley' 6-max Seat #1 is the button
Seat 1: Ninjafuturo123 ($2.41 in chips)
Seat 2: Cris0ner ($2.72 in chips)
Seat 3: LLregs ($2 in chips)
Seat 4: rav79rav ($2.50 in chips)
Seat 5: Tutunn ($1.47 in chips)
Seat 6: akima777 ($1.88 in chips)
Cris0ner: posts small blind $0.01
LLregs: posts big blind $0.02
*** HOLE CARDS ***
Dealt to LLregs [Ks Qh]
rav79rav: raises $0.03 to $0.05
Tutunn: folds
akima777: folds
Ninjafuturo123: calls $0.05
Cris0ner: folds
LLregs: calls $0.03
*** FLOP *** [5c 7d 4s]
LLregs: checks
rav79rav: bets $0.05
Ninjafuturo123: folds
LLregs: calls $0.05
*** TURN *** [5c 7d 4s] [Tc]
LLregs: checks
rav79rav: bets $0.13
LLregs: folds
Uncalled bet ($0.13) returned to rav79rav
rav79rav collected $0.25 from pot
rav79rav: doesn't show hand
*** SUMMARY ***
Total pot $0.26 | Rake $0.01
Board [5c 7d 4s Tc]
Seat 1: Ninjafuturo123 (button) folded on the Flop
Seat 2: Cris0ner (small blind) folded before Flop
Seat 3: LLregs (big blind) folded on the Turn
Seat 4: rav79rav collected ($0.25)
Seat 5: Tutunn folded before Flop (didn't bet)
Seat 6: akima777 folded before Flop (didn't bet)

PokerStars Zoom Hand #247964114841:  Hold'em No Limit ($0.01/$0.02) - 2023/12/30 19:02:41 WET [2023/12/30 14:02:41 ET]
Table 'Halley' 6-max Seat #1 is the button
Seat 1: cachusky ($2 in chips)
Seat 2: LLregs ($2 in chips)
Seat 3: Harold_Seven ($1.28 in chips)
Seat 4: Forever smile3 ($2.49 in chips)
Seat 5: praga-zg ($1.70 in chips)
Seat 6: CrazyFairfox ($1.94 in chips)
LLregs: posts small blind $0.01
Harold_Seven: posts big blind $0.02
*** HOLE CARDS ***
Dealt to LLregs [8d 9h]
Forever smile3: folds
praga-zg: folds
CrazyFairfox: folds
cachusky: folds
LLregs: raises $0.04 to $0.06
Harold_Seven: raises $0.16 to $0.22
LLregs: folds
Uncalled bet ($0.16) returned to Harold_Seven
Harold_Seven collected $0.12 from pot
Harold_Seven: doesn't show hand
*** SUMMARY ***
Total pot $0.12 | Rake $0
Seat 1: cachusky (button) folded before Flop (didn't bet)
Seat 2: LLregs (small blind) folded before Flop
Seat 3: Harold_Seven (big blind) collected ($0.12)
Seat 4: Forever smile3 folded before Flop (didn't bet)
Seat 5: praga-zg folded before Flop (didn't bet)
Seat 6: CrazyFairfox folded before Flop (didn't bet)

PokerStars Zoom Hand #247964127306:  Hold'em No Limit ($0.01/$0.02) - 2023/12/30 19:03:13 WET [2023/12/30 14:03:13 ET]
Table 'Halley' 6-max Seat #1 is the button
Seat 1: LLregs ($2 in chips)
Seat 2: flobox818 ($2.16 in chips)
Seat 3: Arabescul ($2.16 in chips)
Seat 4: MrOT1 ($3.29 in chips)
Seat 5: G1olight ($5.01 in chips)
Seat 6: davidbarrels ($2.95 in chips)
flobox818: posts small blind $0.01
Arabescul: posts big blind $0.02
*** HOLE CARDS ***
Dealt to LLregs [Jh 2h]
MrOT1: folds
G1olight: folds
davidbarrels: raises $0.04 to $0.06
LLregs: folds
flobox818: raises $0.14 to $0.20
Arabescul: folds
davidbarrels: folds
Uncalled bet ($0.14) returned to flobox818
flobox818 collected $0.14 from pot
flobox818: doesn't show hand
*** SUMMARY ***
Total pot $0.14 | Rake $0
Seat 1: LLregs (button) folded before Flop (didn't bet)
Seat 2: flobox818 (small blind) collected ($0.14)
Seat 3: Arabescul (big blind) folded before Flop
Seat 4: MrOT1 folded before Flop (didn't bet)
Seat 5: G1olight folded before Flop (didn't bet)
Seat 6: davidbarrels folded before Flop

PokerStars Zoom Hand #247964124912:  Hold'em No Limit ($0.01/$0.02) - 2023/12/30 19:03:09 WET [2023/12/30 14:03:09 ET]
Table 'Halley' 6-max Seat #1 is the button
Seat 1: conspy84 ($1.97 in chips)
Seat 2: cachusky ($2 in chips)
Seat 3: JaUm_V ($3.15 in chips)
Seat 4: pezirobs ($2.02 in chips)
Seat 5: LLregs ($2 in chips)
Seat 6: chinezu333 ($1.81 in chips)
cachusky: posts small blind $0.01
JaUm_V: posts big blind $0.02
*** HOLE CARDS ***
Dealt to LLregs [Kd 3h]
pezirobs: folds
LLregs: folds
chinezu333: folds
conspy84: raises $0.02 to $0.04
cachusky: folds
JaUm_V: calls $0.02
*** FLOP *** [8d 6h Js]
JaUm_V: checks
conspy84: bets $0.02
JaUm_V: folds
Uncalled bet ($0.02) returned to conspy84
conspy84 collected $0.09 from pot
conspy84: doesn't show hand
*** SUMMARY ***
Total pot $0.09 | Rake $0
Board [8d 6h Js]
Seat 1: conspy84 (button) collected ($0.09)
Seat 2: cachusky (small blind) folded before Flop
Seat 3: JaUm_V (big blind) folded on the Flop
Seat 4: pezirobs folded before Flop (didn't bet)
Seat 5: LLregs folded before Flop (didn't bet)
Seat 6: chinezu333 folded before Flop (didn't bet)

PokerStars Zoom Hand #247964132065:  Hold'em No Limit ($0.01/$0.02) - 2023/12/30 19:03:26 WET [2023/12/30 14:03:26 ET]
Table 'Halley' 6-max Seat #1 is the button
Seat 1: begui150507 ($3.63 in chips)
Seat 2: Cris0ner ($7.10 in chips)
Seat 3: Ninjafuturo123 ($2.05 in chips)
Seat 4: nestor-ruso ($3.60 in chips)
Seat 5: dsousAA ($2 in chips)
Seat 6: LLregs ($2 in chips)
Cris0ner: posts small blind $0.01
Ninjafuturo123: posts big blind $0.02
*** HOLE CARDS ***
Dealt to LLregs [7d Js]
nestor-ruso: folds
dsousAA: raises $0.03 to $0.05
LLregs: folds
begui150507: folds
Cris0ner: folds
Ninjafuturo123: folds
Uncalled bet ($0.03) returned to dsousAA
dsousAA collected $0.05 from pot
dsousAA: doesn't show hand
*** SUMMARY ***
Total pot $0.05 | Rake $0
Seat 1: begui150507 (button) folded before Flop (didn't bet)
Seat 2: Cris0ner (small blind) folded before Flop
Seat 3: Ninjafuturo123 (big blind) folded before Flop
Seat 4: nestor-ruso folded before Flop (didn't bet)
Seat 5: dsousAA collected ($0.05)
Seat 6: LLregs folded before Flop (didn't bet)

PokerStars Zoom Hand #247964137212:  Hold'em No Limit ($0.01/$0.02) - 2023/12/30 19:03:39 WET [2023/12/30 14:03:39 ET]
Table 'Halley' 6-max Seat #1 is the button
Seat 1: MassterD21 ($1.55 in chips)
Seat 2: Luckman 53 ($1.67 in chips)
Seat 3: LLregs ($2 in chips)
Seat 4: ajimvr ($5.80 in chips)
Seat 5: Hollyweed_DOPE ($1.97 in chips)
Seat 6: Harold_Seven ($1.05 in chips)
Luckman 53: posts small blind $0.01
LLregs: posts big blind $0.02
*** HOLE CARDS ***
Dealt to LLregs [Th As]
ajimvr: folds
Hollyweed_DOPE: raises $0.02 to $0.04
Harold_Seven: folds
MassterD21: calls $0.04
Luckman 53: folds
LLregs: calls $0.02
*** FLOP *** [Ts 6d 2s]
LLregs: bets $0.04
Hollyweed_DOPE: folds
MassterD21: raises $0.04 to $0.08
LLregs: calls $0.04
*** TURN *** [Ts 6d 2s] [4s]
LLregs: checks
MassterD21: bets $0.24
LLregs: calls $0.24
*** RIVER *** [Ts 6d 2s 4s] [9c]
LLregs: bets $0.36
MassterD21: raises $0.83 to $1.19 and is all-in
LLregs: folds
Uncalled bet ($0.83) returned to MassterD21
MassterD21 collected $1.44 from pot
MassterD21: doesn't show hand
*** SUMMARY ***
Total pot $1.49 | Rake $0.05
Board [Ts 6d 2s 4s 9c]
Seat 1: MassterD21 (button) collected ($1.44)
Seat 2: Luckman 53 (small blind) folded before Flop
Seat 3: LLregs (big blind) folded on the River
Seat 4: ajimvr folded before Flop (didn't bet)
Seat 5: Hollyweed_DOPE folded on the Flop
Seat 6: Harold_Seven folded before Flop (didn't bet)

PokerStars Zoom Hand #247964172862:  Hold'em No Limit ($0.01/$0.02) - 2023/12/30 19:05:12 WET [2023/12/30 14:05:12 ET]
Table 'Halley' 6-max Seat #1 is the button
Seat 1: darkhexxer ($3.77 in chips)
Seat 2: Niinowa ($0.88 in chips)
Seat 3: jjuul ($3.96 in chips)
Seat 4: LLregs ($2 in chips)
Seat 5: Gaigel ($2 in chips)
Seat 6: Timo_H922 ($2.01 in chips)
Niinowa: posts small blind $0.01
jjuul: posts big blind $0.02
*** HOLE CARDS ***
Dealt to LLregs [5c 8c]
LLregs: folds
Gaigel: folds
Timo_H922: raises $0.03 to $0.05
darkhexxer: folds
Niinowa: folds
jjuul: folds
Uncalled bet ($0.03) returned to Timo_H922
Timo_H922 collected $0.05 from pot
Timo_H922: doesn't show hand
*** SUMMARY ***
Total pot $0.05 | Rake $0
Seat 1: darkhexxer (button) folded before Flop (didn't bet)
Seat 2: Niinowa (small blind) folded before Flop
Seat 3: jjuul (big blind) folded before Flop
Seat 4: LLregs folded before Flop (didn't bet)
Seat 5: Gaigel folded before Flop (didn't bet)
Seat 6: Timo_H922 collected ($0.05)

PokerStars Zoom Hand #247964175793:  Hold'em No Limit ($0.01/$0.02) - 2023/12/30 19:05:20 WET [2023/12/30 14:05:20 ET]
Table 'Halley' 6-max Seat #1 is the button
Seat 1: LLregs ($2 in chips)
Seat 2: Ryg_89 ($1.73 in chips)
Seat 3: Recasia ($2.36 in chips)
Seat 4: piterpank31 ($2.02 in chips)
Seat 5: PRrey ($2.38 in chips)
Seat 6: jjuul ($3.94 in chips)
Ryg_89: posts small blind $0.01
Recasia: posts big blind $0.02
*** HOLE CARDS ***
Dealt to LLregs [5h Qs]
piterpank31: folds
PRrey: folds
jjuul: folds
LLregs: folds
Ryg_89: folds
Uncalled bet ($0.01) returned to Recasia
Recasia collected $0.02 from pot
Recasia: doesn't show hand
*** SUMMARY ***
Total pot $0.02 | Rake $0
Seat 1: LLregs (button) folded before Flop (didn't bet)
Seat 2: Ryg_89 (small blind) folded before Flop
Seat 3: Recasia (big blind) collected ($0.02)
Seat 4: piterpank31 folded before Flop (didn't bet)
Seat 5: PRrey folded before Flop (didn't bet)
Seat 6: jjuul folded before Flop (didn't bet)

PokerStars Zoom Hand #247964174280:  Hold'em No Limit ($0.01/$0.02) - 2023/12/30 19:05:16 WET [2023/12/30 14:05:16 ET]
Table 'Halley' 6-max Seat #1 is the button
Seat 1: xTheBulletsx ($2.52 in chips)
Seat 2: LLregs ($2 in chips)
Seat 3: jandsonpower ($2.80 in chips)
Seat 4: Cris0ner ($2.86 in chips)
Seat 5: plak69 ($2 in chips)
Seat 6: marcegring ($3 in chips)
LLregs: posts small blind $0.01
jandsonpower: posts big blind $0.02
*** HOLE CARDS ***
Dealt to LLregs [Kd 6c]
Cris0ner: raises $0.04 to $0.06
plak69: folds
marcegring: calls $0.06
xTheBulletsx: folds
LLregs: folds
jandsonpower: folds
*** FLOP *** [5h 7c 5s]
Cris0ner: checks
marcegring: bets $0.10
Cris0ner: folds
Uncalled bet ($0.10) returned to marcegring
marcegring collected $0.14 from pot
marcegring: doesn't show hand
*** SUMMARY ***
Total pot $0.15 | Rake $0.01
Board [5h 7c 5s]
Seat 1: xTheBulletsx (button) folded before Flop (didn't bet)
Seat 2: LLregs (small blind) folded before Flop
Seat 3: jandsonpower (big blind) folded before Flop
Seat 4: Cris0ner folded on the Flop
Seat 5: plak69 folded before Flop (didn't bet)
Seat 6: marcegring collected ($0.14)

PokerStars Zoom Hand #247964177356:  Hold'em No Limit ($0.01/$0.02) - 2023/12/30 19:05:24 WET [2023/12/30 14:05:24 ET]
Table 'Halley' 6-max Seat #1 is the button
Seat 1: napoli222 ($3.12 in chips)
Seat 2: piterpank31 ($2.02 in chips)
Seat 3: darkhexxer ($3.77 in chips)
Seat 4: vannstarzz ($10.13 in chips)
Seat 5: conspy84 ($2.44 in chips)
Seat 6: LLregs ($2 in chips)
piterpank31: posts small blind $0.01
darkhexxer: posts big blind $0.02
*** HOLE CARDS ***
Dealt to LLregs [5c Ac]
vannstarzz: folds
conspy84: raises $0.02 to $0.04
LLregs: calls $0.04
napoli222: folds
piterpank31: folds
darkhexxer: folds
*** FLOP *** [5d Qh 2c]
conspy84: bets $0.04
LLregs: raises $0.08 to $0.12
conspy84: folds
Uncalled bet ($0.08) returned to LLregs
LLregs collected $0.18 from pot
LLregs: doesn't show hand
*** SUMMARY ***
Total pot $0.19 | Rake $0.01
Board [5d Qh 2c]
Seat 1: napoli222 (button) folded before Flop (didn't bet)
Seat 2: piterpank31 (small blind) folded before Flop
Seat 3: darkhexxer (big blind) folded before Flop
Seat 4: vannstarzz folded before Flop (didn't bet)
Seat 5: conspy84 folded on the Flop
Seat 6: LLregs collected ($0.18)

PokerStars Zoom Hand #247964191284:  Hold'em No Limit ($0.01/$0.02) - 2023/12/30 19:06:00 WET [2023/12/30 14:06:00 ET]
Table 'Halley' 6-max Seat #1 is the button
Seat 1: erickdamotta ($1.99 in chips)
Seat 2: napoli222 ($2.01 in chips)
Seat 3: conspy84 ($2.35 in chips)
Seat 4: Ryg_89 ($1.75 in chips)
Seat 5: FilthyFinn ($2.08 in chips)
Seat 6: LLregs ($2.10 in chips)
napoli222: posts small blind $0.01
conspy84: posts big blind $0.02
*** HOLE CARDS ***
Dealt to LLregs [Kh Qd]
erickdamotta is disconnected
Ryg_89: folds
FilthyFinn: folds
LLregs: raises $0.04 to $0.06
erickdamotta has timed out while disconnected
erickdamotta: folds
napoli222: folds
conspy84: calls $0.04
*** FLOP *** [9c Ad 2s]
conspy84: checks
LLregs: checks
*** TURN *** [9c Ad 2s] [2c]
conspy84: checks
LLregs: bets $0.03
conspy84: folds
Uncalled bet ($0.03) returned to LLregs
LLregs collected $0.13 from pot
LLregs: doesn't show hand
*** SUMMARY ***
Total pot $0.13 | Rake $0
Board [9c Ad 2s 2c]
Seat 1: erickdamotta (button) folded before Flop (didn't bet)
Seat 2: napoli222 (small blind) folded before Flop
Seat 3: conspy84 (big blind) folded on the Turn
Seat 4: Ryg_89 folded before Flop (didn't bet)
Seat 5: FilthyFinn folded before Flop (didn't bet)
Seat 6: LLregs collected ($0.13)

PokerStars Zoom Hand #247964189724:  Hold'em No Limit ($0.01/$0.02) - 2023/12/30 19:05:56 WET [2023/12/30 14:05:56 ET]
Table 'Halley' 6-max Seat #1 is the button
Seat 1: Fig0uu ($3.05 in chips)
Seat 2: frankquanki ($1.24 in chips)
Seat 3: Floggy73 ($1.56 in chips)
Seat 4: LLregs ($2.10 in chips)
Seat 5: Alanxx77 ($4.41 in chips)
Seat 6: nuttymuch ($5.43 in chips)
frankquanki: posts small blind $0.01
Floggy73: posts big blind $0.02
*** HOLE CARDS ***
Dealt to LLregs [2h 3s]
LLregs: folds
Alanxx77: folds
nuttymuch: raises $0.03 to $0.05
Fig0uu: calls $0.05
frankquanki: folds
Floggy73: folds
*** FLOP *** [Ah 5d Kc]
nuttymuch: bets $0.04
Fig0uu: calls $0.04
*** TURN *** [Ah 5d Kc] [5h]
nuttymuch: checks
Fig0uu: checks
*** RIVER *** [Ah 5d Kc 5h] [Jd]
nuttymuch: checks
Fig0uu: checks
*** SHOW DOWN ***
nuttymuch: shows [Qd 8d] (a pair of Fives)
Fig0uu: shows [7c 7s] (two pair, Sevens and Fives)
Fig0uu collected $0.20 from pot
*** SUMMARY ***
Total pot $0.21 | Rake $0.01
Board [Ah 5d Kc 5h Jd]
Seat 1: Fig0uu (button) showed [7c 7s] and won ($0.20) with two pair, Sevens and Fives
Seat 2: frankquanki (small blind) folded before Flop
Seat 3: Floggy73 (big blind) folded before Flop
Seat 4: LLregs folded before Flop (didn't bet)
Seat 5: Alanxx77 folded before Flop (didn't bet)
Seat 6: nuttymuch showed [Qd 8d] and lost with a pair of Fives

PokerStars Zoom Hand #247964188232:  Hold'em No Limit ($0.01/$0.02) - 2023/12/30 19:05:52 WET [2023/12/30 14:05:52 ET]
Table 'Halley' 6-max Seat #1 is the button
Seat 1: 2plateado2 ($2.77 in chips)
Seat 2: LordRocky89 ($3.79 in chips)
Seat 3: panosarg88 ($2.19 in chips)
Seat 4: praznina ($2.38 in chips)
Seat 5: LLregs ($2.10 in chips)
Seat 6: erickdamotta ($1.99 in chips)
LordRocky89: posts small blind $0.01
panosarg88: posts big blind $0.02
*** HOLE CARDS ***
Dealt to LLregs [3c Qs]
praznina: folds
LLregs: folds
erickdamotta: folds
2plateado2: raises $0.03 to $0.05
LordRocky89: folds
panosarg88: raises $0.11 to $0.16
2plateado2: raises $0.26 to $0.42
panosarg88: calls $0.26
*** FLOP *** [9c Th 6d]
panosarg88: checks
2plateado2: bets $0.27
panosarg88: calls $0.27
*** TURN *** [9c Th 6d] [9h]
panosarg88: checks
2plateado2: checks
*** RIVER *** [9c Th 6d 9h] [8h]
panosarg88: checks
2plateado2: checks
*** SHOW DOWN ***
panosarg88: shows [Jd Jc] (two pair, Jacks and Nines)
2plateado2: mucks hand
panosarg88 collected $1.34 from pot
*** SUMMARY ***
Total pot $1.39 | Rake $0.05
Board [9c Th 6d 9h 8h]
Seat 1: 2plateado2 (button) mucked [Ah Ks]
Seat 2: LordRocky89 (small blind) folded before Flop
Seat 3: panosarg88 (big blind) showed [Jd Jc] and won ($1.34) with two pair, Jacks and Nines
Seat 4: praznina folded before Flop (didn't bet)
Seat 5: LLregs folded before Flop (didn't bet)
Seat 6: erickdamotta folded before Flop (didn't bet)

PokerStars Zoom Hand #247964212149:  Hold'em No Limit ($0.01/$0.02) - 2023/12/30 19:06:54 WET [2023/12/30 14:06:54 ET]
Table 'Halley' 6-max Seat #1 is the button
Seat 1: Dimoni797979 ($5.58 in chips)
Seat 2: mauchin ($0.28 in chips)
Seat 3: LLregs ($2.17 in chips)
Seat 4: Jonatandamian ($1.40 in chips)
Seat 5: DarkRazer17 ($3.44 in chips)
Seat 6: goldwinm ($0.89 in chips)
mauchin: posts small blind $0.01
LLregs: posts big blind $0.02
*** HOLE CARDS ***
Dealt to LLregs [8d Qh]
Jonatandamian: folds
DarkRazer17: folds
goldwinm: raises $0.04 to $0.06
Dimoni797979: folds
mauchin: folds
LLregs: folds
Uncalled bet ($0.04) returned to goldwinm
goldwinm collected $0.05 from pot
goldwinm: doesn't show hand
*** SUMMARY ***
Total pot $0.05 | Rake $0
Seat 1: Dimoni797979 (button) folded before Flop (didn't bet)
Seat 2: mauchin (small blind) folded before Flop
Seat 3: LLregs (big blind) folded before Flop
Seat 4: Jonatandamian folded before Flop (didn't bet)
Seat 5: DarkRazer17 folded before Flop (didn't bet)
Seat 6: goldwinm collected ($0.05)

PokerStars Zoom Hand #247964234424:  Hold'em No Limit ($0.01/$0.02) - 2023/12/30 19:07:52 WET [2023/12/30 14:07:52 ET]
Table 'Halley' 6-max Seat #1 is the button
Seat 1: LLregs ($2.09 in chips)
Seat 2: Teflonmemory ($2.01 in chips)
Seat 3: Mr Jodan ($3.30 in chips)
Seat 4: mkskek ($2.29 in chips)
Seat 5: ssolruoy ($1.78 in chips)
Seat 6: Agneobr ($2.28 in chips)
Teflonmemory: posts small blind $0.01
Mr Jodan: posts big blind $0.02
*** HOLE CARDS ***
Dealt to LLregs [7d 5s]
mkskek: folds
ssolruoy: folds
Agneobr: folds
LLregs: folds
Teflonmemory: folds
Uncalled bet ($0.01) returned to Mr Jodan
Mr Jodan collected $0.02 from pot
Mr Jodan: doesn't show hand
*** SUMMARY ***
Total pot $0.02 | Rake $0
Seat 1: LLregs (button) folded before Flop (didn't bet)
Seat 2: Teflonmemory (small blind) folded before Flop
Seat 3: Mr Jodan (big blind) collected ($0.02)
Seat 4: mkskek folded before Flop (didn't bet)
Seat 5: ssolruoy folded before Flop (didn't bet)
Seat 6: Agneobr folded before Flop (didn't bet)

PokerStars Zoom Hand #247964217783:  Hold'em No Limit ($0.01/$0.02) - 2023/12/30 19:07:09 WET [2023/12/30 14:07:09 ET]
Table 'Halley' 6-max Seat #1 is the button
Seat 1: 888lifeIS ($3.74 in chips)
Seat 2: LLregs ($2.15 in chips)
Seat 3: OldGrandPaAA ($0.93 in chips)
Seat 4: yukon Ronald ($1.07 in chips)
Seat 5: Forever smile3 ($1.96 in chips)
Seat 6: Ninjafuturo123 ($1.95 in chips)
LLregs: posts small blind $0.01
OldGrandPaAA: posts big blind $0.02
*** HOLE CARDS ***
Dealt to LLregs [8s Qh]
yukon Ronald: calls $0.02
Forever smile3: folds
Ninjafuturo123: folds
888lifeIS: folds
LLregs: raises $0.04 to $0.06
OldGrandPaAA: calls $0.04
yukon Ronald: calls $0.04
*** FLOP *** [4d 5d 2s]
LLregs: checks
OldGrandPaAA: bets $0.09
yukon Ronald: calls $0.09
LLregs: folds
*** TURN *** [4d 5d 2s] [4s]
OldGrandPaAA: bets $0.18
yukon Ronald: calls $0.18
*** RIVER *** [4d 5d 2s 4s] [9d]
OldGrandPaAA: checks
yukon Ronald: bets $0.35
OldGrandPaAA: calls $0.35
*** SHOW DOWN ***
yukon Ronald: shows [8h 4h] (three of a kind, Fours)
OldGrandPaAA: mucks hand
yukon Ronald collected $1.37 from pot
*** SUMMARY ***
Total pot $1.42 | Rake $0.05
Board [4d 5d 2s 4s 9d]
Seat 1: 888lifeIS (button) folded before Flop (didn't bet)
Seat 2: LLregs (small blind) folded on the Flop
Seat 3: OldGrandPaAA (big blind) mucked [Tc 5c]
Seat 4: yukon Ronald showed [8h 4h] and won ($1.37) with three of a kind, Fours
Seat 5: Forever smile3 folded before Flop (didn't bet)
Seat 6: Ninjafuturo123 folded before Flop (didn't bet)

PokerStars Zoom Hand #247964235661:  Hold'em No Limit ($0.01/$0.02) - 2023/12/30 19:07:55 WET [2023/12/30 14:07:55 ET]
Table 'Halley' 6-max Seat #1 is the button
Seat 1: goldwinm ($1.21 in chips)
Seat 2: 010011100100 ($2 in chips)
Seat 3: Naildey ($2.18 in chips)
Seat 4: marcegring ($2.92 in chips)
Seat 5: LLregs ($2.09 in chips)
Seat 6: Castiel_Ivy ($2 in chips)
010011100100: posts small blind $0.01
Naildey: posts big blind $0.02
*** HOLE CARDS ***
Dealt to LLregs [Tc Qd]
marcegring: folds
LLregs: raises $0.04 to $0.06
Castiel_Ivy: folds
goldwinm: folds
010011100100: folds
Naildey: raises $0.04 to $0.10
LLregs: calls $0.04
*** FLOP *** [2h 3d Ad]
Naildey: checks
LLregs: checks
*** TURN *** [2h 3d Ad] [5s]
Naildey: bets $0.20
LLregs: folds
Uncalled bet ($0.20) returned to Naildey
Naildey collected $0.20 from pot
Naildey: doesn't show hand
*** SUMMARY ***
Total pot $0.21 | Rake $0.01
Board [2h 3d Ad 5s]
Seat 1: goldwinm (button) folded before Flop (didn't bet)
Seat 2: 010011100100 (small blind) folded before Flop
Seat 3: Naildey (big blind) collected ($0.20)
Seat 4: marcegring folded before Flop (didn't bet)
Seat 5: LLregs folded on the Turn
Seat 6: Castiel_Ivy folded before Flop (didn't bet)

PokerStars Zoom Hand #247964254663:  Hold'em No Limit ($0.01/$0.02) - 2023/12/30 19:08:44 WET [2023/12/30 14:08:44 ET]
Table 'Halley' 6-max Seat #1 is the button
Seat 1: NovatoHn ($2.18 in chips)
Seat 2: rav79rav ($2.04 in chips)
Seat 3: GeRA XG ($1.16 in chips)
Seat 4: LLregs ($2 in chips)
Seat 5: scurvy idler ($2.03 in chips)
Seat 6: wee_smurf23 ($2.15 in chips)
rav79rav: posts small blind $0.01
GeRA XG: posts big blind $0.02
*** HOLE CARDS ***
Dealt to LLregs [2h Qd]
LLregs: folds
scurvy idler: folds
wee_smurf23: folds
NovatoHn: folds
rav79rav: folds
Uncalled bet ($0.01) returned to GeRA XG
GeRA XG collected $0.02 from pot
GeRA XG: doesn't show hand
*** SUMMARY ***
Total pot $0.02 | Rake $0
Seat 1: NovatoHn (button) folded before Flop (didn't bet)
Seat 2: rav79rav (small blind) folded before Flop
Seat 3: GeRA XG (big blind) collected ($0.02)
Seat 4: LLregs folded before Flop (didn't bet)
Seat 5: scurvy idler folded before Flop (didn't bet)
Seat 6: wee_smurf23 folded before Flop (didn't bet)

PokerStars Zoom Hand #247964256113:  Hold'em No Limit ($0.01/$0.02) - 2023/12/30 19:08:48 WET [2023/12/30 14:08:48 ET]
Table 'Halley' 6-max Seat #1 is the button
Seat 1: rwatson_linden ($1.68 in chips)
Seat 2: G1olight ($2.83 in chips)
Seat 3: GeRA XG ($1.63 in chips)
Seat 4: LLregs ($2 in chips)
Seat 5: Balonas ($2.82 in chips)
Seat 6: dsousAA ($2.01 in chips)
G1olight: posts small blind $0.01
GeRA XG: posts big blind $0.02
*** HOLE CARDS ***
Dealt to LLregs [Tc Jd]
LLregs: folds
Balonas: raises $0.03 to $0.05
dsousAA: folds
rwatson_linden: folds
G1olight: folds
GeRA XG: folds
Uncalled bet ($0.03) returned to Balonas
Balonas collected $0.05 from pot
Balonas: doesn't show hand
*** SUMMARY ***
Total pot $0.05 | Rake $0
Seat 1: rwatson_linden (button) folded before Flop (didn't bet)
Seat 2: G1olight (small blind) folded before Flop
Seat 3: GeRA XG (big blind) folded before Flop
Seat 4: LLregs folded before Flop (didn't bet)
Seat 5: Balonas collected ($0.05)
Seat 6: dsousAA folded before Flop (didn't bet)

PokerStars Zoom Hand #247964258599:  Hold'em No Limit ($0.01/$0.02) - 2023/12/30 19:08:54 WET [2023/12/30 14:08:54 ET]
Table 'Halley' 6-max Seat #1 is the button
Seat 1: Vertertorix ($1.92 in chips)
Seat 2: LLregs ($2 in chips)
Seat 3: Dimoni797979 ($3.27 in chips)
Seat 4: pawelllo1 ($5.40 in chips)
Seat 5: LDenisL ($2.23 in chips)
Seat 6: rwatson_linden ($1.68 in chips)
LLregs: posts small blind $0.01
Dimoni797979: posts big blind $0.02
*** HOLE CARDS ***
Dealt to LLregs [3d 3c]
pawelllo1: folds
LDenisL: folds
rwatson_linden: raises $0.02 to $0.04
Vertertorix: folds
LLregs: calls $0.03
Dimoni797979: folds
*** FLOP *** [Jh Js Ad]
LLregs: checks
rwatson_linden: checks
*** TURN *** [Jh Js Ad] [Ts]
LLregs: bets $0.02
rwatson_linden: calls $0.02
*** RIVER *** [Jh Js Ad Ts] [7c]
LLregs: bets $0.03
rwatson_linden: calls $0.03
*** SHOW DOWN ***
LLregs: shows [3d 3c] (two pair, Jacks and Threes)
rwatson_linden: mucks hand
LLregs collected $0.19 from pot
*** SUMMARY ***
Total pot $0.20 | Rake $0.01
Board [Jh Js Ad Ts 7c]
Seat 1: Vertertorix (button) folded before Flop (didn't bet)
Seat 2: LLregs (small blind) showed [3d 3c] and won ($0.19) with two pair, Jacks and Threes
Seat 3: Dimoni797979 (big blind) folded before Flop
Seat 4: pawelllo1 folded before Flop (didn't bet)
Seat 5: LDenisL folded before Flop (didn't bet)
Seat 6: rwatson_linden mucked [2d 2s]

PokerStars Zoom Hand #247964270390:  Hold'em No Limit ($0.01/$0.02) - 2023/12/30 19:09:25 WET [2023/12/30 14:09:25 ET]
Table 'Halley' 6-max Seat #1 is the button
Seat 1: mangalisa ($5.64 in chips)
Seat 2: ds_pearce2 ($1.87 in chips)
Seat 3: LLregs ($2.10 in chips)
Seat 4: herby2888 ($4.03 in chips)
Seat 5: LukeSoldier ($2.42 in chips)
Seat 6: #1spoon ($0.92 in chips)
ds_pearce2: posts small blind $0.01
LLregs: posts big blind $0.02
*** HOLE CARDS ***
Dealt to LLregs [9s 4c]
herby2888: calls $0.02
LukeSoldier: folds
#1spoon: folds
mangalisa: folds
ds_pearce2: folds
LLregs: checks
*** FLOP *** [Kd Js 3h]
LLregs: checks
herby2888: checks
*** TURN *** [Kd Js 3h] [7d]
LLregs: checks
herby2888: bets $0.03
LLregs: folds
Uncalled bet ($0.03) returned to herby2888
herby2888 collected $0.05 from pot
herby2888: doesn't show hand
*** SUMMARY ***
Total pot $0.05 | Rake $0
Board [Kd Js 3h 7d]
Seat 1: mangalisa (button) folded before Flop (didn't bet)
Seat 2: ds_pearce2 (small blind) folded before Flop
Seat 3: LLregs (big blind) folded on the Turn
Seat 4: herby2888 collected ($0.05)
Seat 5: LukeSoldier folded before Flop (didn't bet)
Seat 6: #1spoon folded before Flop (didn't bet)

PokerStars Zoom Hand #247964281533:  Hold'em No Limit ($0.01/$0.02) - 2023/12/30 19:09:54 WET [2023/12/30 14:09:54 ET]
Table 'Halley' 6-max Seat #1 is the button
Seat 1: Ninjafuturo123 ($1.82 in chips)
Seat 2: LLregs ($2.08 in chips)
Seat 3: Raymond322 ($5.91 in chips)
Seat 4: dsousAA ($2.13 in chips)
Seat 5: tekkkk1 ($2.01 in chips)
Seat 6: fukazapam ($2 in chips)
LLregs: posts small blind $0.01
Raymond322: posts big blind $0.02
*** HOLE CARDS ***
Dealt to LLregs [2c 5c]
dsousAA: folds
tekkkk1: folds
fukazapam: folds
Ninjafuturo123: folds
LLregs: folds
Uncalled bet ($0.01) returned to Raymond322
Raymond322 collected $0.02 from pot
Raymond322: doesn't show hand
*** SUMMARY ***
Total pot $0.02 | Rake $0
Seat 1: Ninjafuturo123 (button) folded before Flop (didn't bet)
Seat 2: LLregs (small blind) folded before Flop
Seat 3: Raymond322 (big blind) collected ($0.02)
Seat 4: dsousAA folded before Flop (didn't bet)
Seat 5: tekkkk1 folded before Flop (didn't bet)
Seat 6: fukazapam folded before Flop (didn't bet)

PokerStars Zoom Hand #247964280059:  Hold'em No Limit ($0.01/$0.02) - 2023/12/30 19:09:50 WET [2023/12/30 14:09:50 ET]
Table 'Halley' 6-max Seat #1 is the button
Seat 1: LLregs ($2.08 in chips)
Seat 2: 888lifeIS ($2.01 in chips)
Seat 3: pokertito109 ($1.84 in chips)
Seat 4: RocketFir271 ($2.69 in chips)
Seat 5: Val'demar.ks ($1.59 in chips)
Seat 6: flobox818 ($2.04 in chips)
888lifeIS: posts small blind $0.01
pokertito109: posts big blind $0.02
*** HOLE CARDS ***
Dealt to LLregs [8c 2c]
RocketFir271: raises $0.03 to $0.05
Val'demar.ks: folds
flobox818: folds
LLregs: folds
888lifeIS: folds
pokertito109: folds
Uncalled bet ($0.03) returned to RocketFir271
RocketFir271 collected $0.05 from pot
RocketFir271: doesn't show hand
*** SUMMARY ***
Total pot $0.05 | Rake $0
Seat 1: LLregs (button) folded before Flop (didn't bet)
Seat 2: 888lifeIS (small blind) folded before Flop
Seat 3: pokertito109 (big blind) folded before Flop
Seat 4: RocketFir271 collected ($0.05)
Seat 5: Val'demar.ks folded before Flop (didn't bet)
Seat 6: flobox818 folded before Flop (didn't bet)

PokerStars Zoom Hand #247964286540:  Hold'em No Limit ($0.01/$0.02) - 2023/12/30 19:10:07 WET [2023/12/30 14:10:07 ET]
Table 'Halley' 6-max Seat #1 is the button
Seat 1: Radarovici93 ($1.64 in chips)
Seat 2: Cris0ner ($7.10 in chips)
Seat 3: Loucomeloo ($2.30 in chips)
Seat 4: AkiloniC ($2.05 in chips)
Seat 5: pillopk ($2 in chips)
Seat 6: LLregs ($2.07 in chips)
Cris0ner: posts small blind $0.01
Loucomeloo: posts big blind $0.02
*** HOLE CARDS ***
Dealt to LLregs [Jc 5d]
AkiloniC: folds
pillopk: raises $0.04 to $0.06
LLregs: folds
Radarovici93: folds
Cris0ner: folds
Loucomeloo: folds
Uncalled bet ($0.04) returned to pillopk
pillopk collected $0.05 from pot
pillopk: doesn't show hand
*** SUMMARY ***
Total pot $0.05 | Rake $0
Seat 1: Radarovici93 (button) folded before Flop (didn't bet)
Seat 2: Cris0ner (small blind) folded before Flop
Seat 3: Loucomeloo (big blind) folded before Flop
Seat 4: AkiloniC folded before Flop (didn't bet)
Seat 5: pillopk collected ($0.05)
Seat 6: LLregs folded before Flop (didn't bet)

PokerStars Zoom Hand #247964290428:  Hold'em No Limit ($0.01/$0.02) - 2023/12/30 19:10:17 WET [2023/12/30 14:10:17 ET]
Table 'Halley' 6-max Seat #1 is the button
Seat 1: AkiloniC ($2.05 in chips)
Seat 2: nuttymuch ($3.97 in chips)
Seat 3: kohagyma ($2.75 in chips)
Seat 4: LLregs ($2.07 in chips)
Seat 5: kalkulater ($2.70 in chips)
Seat 6: TeshioRiver ($2 in chips)
nuttymuch: posts small blind $0.01
kohagyma: posts big blind $0.02
*** HOLE CARDS ***
Dealt to LLregs [5s Qc]
LLregs: folds
kalkulater: raises $0.03 to $0.05
TeshioRiver: folds
AkiloniC: folds
nuttymuch: folds
kohagyma: folds
Uncalled bet ($0.03) returned to kalkulater
kalkulater collected $0.05 from pot
kalkulater: doesn't show hand
*** SUMMARY ***
Total pot $0.05 | Rake $0
Seat 1: AkiloniC (button) folded before Flop (didn't bet)
Seat 2: nuttymuch (small blind) folded before Flop
Seat 3: kohagyma (big blind) folded before Flop
Seat 4: LLregs folded before Flop (didn't bet)
Seat 5: kalkulater collected ($0.05)
Seat 6: TeshioRiver folded before Flop (didn't bet)

PokerStars Zoom Hand #247964288872:  Hold'em No Limit ($0.01/$0.02) - 2023/12/30 19:10:13 WET [2023/12/30 14:10:13 ET]
Table 'Halley' 6-max Seat #1 is the button
Seat 1: marcegring ($3.21 in chips)
Seat 2: 888lifeIS ($2.18 in chips)
Seat 3: SKV_1985 ($2.04 in chips)
Seat 4: roz534 ($2.06 in chips)
Seat 5: LLregs ($2.07 in chips)
Seat 6: 13Princess94 ($2.87 in chips)
888lifeIS: posts small blind $0.01
SKV_1985: posts big blind $0.02
*** HOLE CARDS ***
Dealt to LLregs [8c 5d]
roz534: calls $0.02
LLregs: folds
13Princess94: folds
marcegring: folds
888lifeIS: folds
SKV_1985: raises $0.10 to $0.12
roz534: folds
Uncalled bet ($0.10) returned to SKV_1985
SKV_1985 collected $0.05 from pot
SKV_1985: doesn't show hand
*** SUMMARY ***
Total pot $0.05 | Rake $0
Seat 1: marcegring (button) folded before Flop (didn't bet)
Seat 2: 888lifeIS (small blind) folded before Flop
Seat 3: SKV_1985 (big blind) collected ($0.05)
Seat 4: roz534 folded before Flop
Seat 5: LLregs folded before Flop (didn't bet)
Seat 6: 13Princess94 folded before Flop (didn't bet)

PokerStars Zoom Hand #247964292572:  Hold'em No Limit ($0.01/$0.02) - 2023/12/30 19:10:23 WET [2023/12/30 14:10:23 ET]
Table 'Halley' 6-max Seat #1 is the button
Seat 1: LLregs ($2.07 in chips)
Seat 2: OFSHOR ($6.37 in chips)
Seat 3: lacost_blr ($2.08 in chips)
Seat 4: Tutunn ($2.41 in chips)
Seat 5: ungiwar ($0.74 in chips)
Seat 6: Dimoni797979 ($3.15 in chips)
OFSHOR: posts small blind $0.01
lacost_blr: posts big blind $0.02
*** HOLE CARDS ***
Dealt to LLregs [9d Qd]
Tutunn: folds
ungiwar: folds
Dimoni797979: raises $0.02 to $0.04
LLregs: calls $0.04
OFSHOR: folds
lacost_blr: folds
*** FLOP *** [7s Qh 9s]
Dimoni797979: checks
LLregs: checks
*** TURN *** [7s Qh 9s] [2d]
Dimoni797979: bets $0.11
LLregs: calls $0.11
*** RIVER *** [7s Qh 9s 2d] [2s]
Dimoni797979: checks
LLregs: bets $0.25
Dimoni797979: folds
Uncalled bet ($0.25) returned to LLregs
LLregs collected $0.32 from pot
LLregs: doesn't show hand
*** SUMMARY ***
Total pot $0.33 | Rake $0.01
Board [7s Qh 9s 2d 2s]
Seat 1: LLregs (button) collected ($0.32)
Seat 2: OFSHOR (small blind) folded before Flop
Seat 3: lacost_blr (big blind) folded before Flop
Seat 4: Tutunn folded before Flop (didn't bet)
Seat 5: ungiwar folded before Flop (didn't bet)
Seat 6: Dimoni797979 folded on the River

PokerStars Zoom Hand #247964311054:  Hold'em No Limit ($0.01/$0.02) - 2023/12/30 19:11:11 WET [2023/12/30 14:11:11 ET]
Table 'Halley' 6-max Seat #1 is the button
Seat 1: dsousAA ($2.06 in chips)
Seat 2: Plmax94 ($1.55 in chips)
Seat 3: klaegie2000 ($2 in chips)
Seat 4: LLregs ($2.24 in chips)
Seat 5: LucasPapada ($2.91 in chips)
Seat 6: piterpank31 ($2.20 in chips)
Plmax94: posts small blind $0.01
klaegie2000: posts big blind $0.02
*** HOLE CARDS ***
Dealt to LLregs [9c Ts]
LLregs: folds
LucasPapada: folds
piterpank31: folds
dsousAA: folds
Plmax94: folds
Uncalled bet ($0.01) returned to klaegie2000
klaegie2000 collected $0.02 from pot
klaegie2000: doesn't show hand
*** SUMMARY ***
Total pot $0.02 | Rake $0
Seat 1: dsousAA (button) folded before Flop (didn't bet)
Seat 2: Plmax94 (small blind) folded before Flop
Seat 3: klaegie2000 (big blind) collected ($0.02)
Seat 4: LLregs folded before Flop (didn't bet)
Seat 5: LucasPapada folded before Flop (didn't bet)
Seat 6: piterpank31 folded before Flop (didn't bet)

PokerStars Zoom Hand #247964319132:  Hold'em No Limit ($0.01/$0.02) - 2023/12/30 19:11:32 WET [2023/12/30 14:11:32 ET]
Table 'Halley' 6-max Seat #1 is the button
Seat 1: SannBy ($5.38 in chips)
Seat 2: kuelas ($2 in chips)
Seat 3: a_281zh078g ($3.64 in chips)
Seat 4: kalkulater ($2 in chips)
Seat 5: Wouzie ($1.90 in chips)
Seat 6: LLregs ($2.21 in chips)
kuelas: posts small blind $0.01
a_281zh078g: posts big blind $0.02
*** HOLE CARDS ***
Dealt to LLregs [6d Qh]
kalkulater: folds
Wouzie: folds
LLregs: folds
SannBy: folds
kuelas: folds
Uncalled bet ($0.01) returned to a_281zh078g
a_281zh078g collected $0.02 from pot
a_281zh078g: doesn't show hand
*** SUMMARY ***
Total pot $0.02 | Rake $0
Seat 1: SannBy (button) folded before Flop (didn't bet)
Seat 2: kuelas (small blind) folded before Flop
Seat 3: a_281zh078g (big blind) collected ($0.02)
Seat 4: kalkulater folded before Flop (didn't bet)
Seat 5: Wouzie folded before Flop (didn't bet)
Seat 6: LLregs folded before Flop (didn't bet)

PokerStars Zoom Hand #247964317530:  Hold'em No Limit ($0.01/$0.02) - 2023/12/30 19:11:28 WET [2023/12/30 14:11:28 ET]
Table 'Halley' 6-max Seat #1 is the button
Seat 1: Arabescul ($2.31 in chips)
Seat 2: LLregs ($2.22 in chips)
Seat 3: GeRA XG ($1.49 in chips)
Seat 4: Plmax94 ($1.52 in chips)
Seat 5: A•R•D377™7 ($0.76 in chips)
Seat 6: yuzu0921 ($1.46 in chips)
LLregs: posts small blind $0.01
GeRA XG: posts big blind $0.02
*** HOLE CARDS ***
Dealt to LLregs [7d 4s]
Plmax94: folds
A•R•D377™7: raises $0.05 to $0.07
yuzu0921: folds
Arabescul: folds
LLregs: folds
GeRA XG: folds
Uncalled bet ($0.05) returned to A•R•D377™7
A•R•D377™7 collected $0.05 from pot
A•R•D377™7: doesn't show hand
*** SUMMARY ***
Total pot $0.05 | Rake $0
Seat 1: Arabescul (button) folded before Flop (didn't bet)
Seat 2: LLregs (small blind) folded before Flop
Seat 3: GeRA XG (big blind) folded before Flop
Seat 4: Plmax94 folded before Flop (didn't bet)
Seat 5: A•R•D377™7 collected ($0.05)
Seat 6: yuzu0921 folded before Flop (didn't bet)

PokerStars Zoom Hand #247964313377:  Hold'em No Limit ($0.01/$0.02) - 2023/12/30 19:11:17 WET [2023/12/30 14:11:17 ET]
Table 'Halley' 6-max Seat #1 is the button
Seat 1: tekkkk1 ($2.09 in chips)
Seat 2: Agneobr ($2.28 in chips)
Seat 3: LLregs ($2.24 in chips)
Seat 4: plak69 ($2.24 in chips)
Seat 5: jesterka20 ($0.58 in chips)
Seat 6: Mr.Alter3go ($2.03 in chips)
Agneobr: posts small blind $0.01
LLregs: posts big blind $0.02
*** HOLE CARDS ***
Dealt to LLregs [7h 2d]
plak69: folds
jesterka20: folds
Mr.Alter3go: folds
tekkkk1: calls $0.02
Agneobr: raises $0.04 to $0.06
LLregs: folds
tekkkk1: calls $0.04
*** FLOP *** [5d 6c 4s]
Agneobr: checks
tekkkk1: checks
*** TURN *** [5d 6c 4s] [Jd]
Agneobr: bets $0.06
tekkkk1: calls $0.06
*** RIVER *** [5d 6c 4s Jd] [2c]
Agneobr: checks
tekkkk1: checks
*** SHOW DOWN ***
Agneobr: shows [Kd 8d] (high card King)
tekkkk1: shows [Jh Qc] (a pair of Jacks)
tekkkk1 collected $0.25 from pot
*** SUMMARY ***
Total pot $0.26 | Rake $0.01
Board [5d 6c 4s Jd 2c]
Seat 1: tekkkk1 (button) showed [Jh Qc] and won ($0.25) with a pair of Jacks
Seat 2: Agneobr (small blind) showed [Kd 8d] and lost with high card King
Seat 3: LLregs (big blind) folded before Flop
Seat 4: plak69 folded before Flop (didn't bet)
Seat 5: jesterka20 folded before Flop (didn't bet)
Seat 6: Mr.Alter3go folded before Flop (didn't bet)

PokerStars Zoom Hand #247964321076:  Hold'em No Limit ($0.01/$0.02) - 2023/12/30 19:11:37 WET [2023/12/30 14:11:37 ET]
Table 'Halley' 6-max Seat #1 is the button
Seat 1: tisadaisy ($4.29 in chips)
Seat 2: jandsonpower ($2.75 in chips)
Seat 3: LLregs ($2.21 in chips)
Seat 4: Floggy73 ($1.45 in chips)
Seat 5: PRrey ($1.89 in chips)
Seat 6: Castiel_Ivy ($2.69 in chips)
jandsonpower: posts small blind $0.01
LLregs: posts big blind $0.02
*** HOLE CARDS ***
Dealt to LLregs [As Ad]
Floggy73: folds
PRrey: folds
Castiel_Ivy: folds
tisadaisy: raises $0.02 to $0.04
jandsonpower: folds
LLregs: raises $0.08 to $0.12
tisadaisy: calls $0.08
*** FLOP *** [3s Kc 7d]
LLregs: bets $0.05
tisadaisy: calls $0.05
*** TURN *** [3s Kc 7d] [Ks]
LLregs: bets $0.07
tisadaisy: folds
Uncalled bet ($0.07) returned to LLregs
LLregs collected $0.34 from pot
LLregs: doesn't show hand
*** SUMMARY ***
Total pot $0.35 | Rake $0.01
Board [3s Kc 7d Ks]
Seat 1: tisadaisy (button) folded on the Turn
Seat 2: jandsonpower (small blind) folded before Flop
Seat 3: LLregs (big blind) collected ($0.34)
Seat 4: Floggy73 folded before Flop (didn't bet)
Seat 5: PRrey folded before Flop (didn't bet)
Seat 6: Castiel_Ivy folded before Flop (didn't bet)

PokerStars Zoom Hand #247964345607:  Hold'em No Limit ($0.01/$0.02) - 2023/12/30 19:12:40 WET [2023/12/30 14:12:40 ET]
Table 'Halley' 6-max Seat #1 is the button
Seat 1: Castiel_Ivy ($2.06 in chips)
Seat 2: Dimoni797979 ($2.89 in chips)
Seat 3: MeisterJedah ($7.19 in chips)
Seat 4: jandsonpower ($2.75 in chips)
Seat 5: Shmatrixs ($5.84 in chips)
Seat 6: LLregs ($2.38 in chips)
Dimoni797979: posts small blind $0.01
MeisterJedah: posts big blind $0.02
*** HOLE CARDS ***
Dealt to LLregs [8s 9d]
jandsonpower: folds
Shmatrixs: raises $0.02 to $0.04
LLregs: folds
Castiel_Ivy: folds
Dimoni797979: folds
MeisterJedah: folds
Uncalled bet ($0.02) returned to Shmatrixs
Shmatrixs collected $0.05 from pot
Shmatrixs: doesn't show hand
*** SUMMARY ***
Total pot $0.05 | Rake $0
Seat 1: Castiel_Ivy (button) folded before Flop (didn't bet)
Seat 2: Dimoni797979 (small blind) folded before Flop
Seat 3: MeisterJedah (big blind) folded before Flop
Seat 4: jandsonpower folded before Flop (didn't bet)
Seat 5: Shmatrixs collected ($0.05)
Seat 6: LLregs folded before Flop (didn't bet)

PokerStars Zoom Hand #247964347055:  Hold'em No Limit ($0.01/$0.02) - 2023/12/30 19:12:44 WET [2023/12/30 14:12:44 ET]
Table 'Halley' 6-max Seat #1 is the button
Seat 1: LLregs ($2.38 in chips)
Seat 2: Arabescul ($2 in chips)
Seat 3: 010011100100 ($2.14 in chips)
Seat 4: batya1212 ($2.08 in chips)
Seat 5: LukeSoldier ($2.11 in chips)
Seat 6: HarryHaller77 ($2.06 in chips)
Arabescul: posts small blind $0.01
010011100100: posts big blind $0.02
*** HOLE CARDS ***
Dealt to LLregs [2s 3c]
batya1212: folds
LukeSoldier: folds
HarryHaller77: folds
LLregs: folds
Arabescul: raises $0.04 to $0.06
010011100100: folds
Uncalled bet ($0.04) returned to Arabescul
Arabescul collected $0.04 from pot
Arabescul: doesn't show hand
*** SUMMARY ***
Total pot $0.04 | Rake $0
Seat 1: LLregs (button) folded before Flop (didn't bet)
Seat 2: Arabescul (small blind) collected ($0.04)
Seat 3: 010011100100 (big blind) folded before Flop
Seat 4: batya1212 folded before Flop (didn't bet)
Seat 5: LukeSoldier folded before Flop (didn't bet)
Seat 6: HarryHaller77 folded before Flop (didn't bet)

PokerStars Zoom Hand #247964349812:  Hold'em No Limit ($0.01/$0.02) - 2023/12/30 19:12:51 WET [2023/12/30 14:12:51 ET]
Table 'Halley' 6-max Seat #1 is the button
Seat 1: McLaude669 ($0.95 in chips)
Seat 2: yuzu0921 ($1.47 in chips)
Seat 3: kalkulater ($3.17 in chips)
Seat 4: santogr893 ($4.18 in chips)
Seat 5: LLregs ($2.38 in chips)
Seat 6: hicmanboss ($2.47 in chips)
yuzu0921: posts small blind $0.01
kalkulater: posts big blind $0.02
*** HOLE CARDS ***
Dealt to LLregs [2d 5d]
santogr893: folds
LLregs: folds
hicmanboss: folds
McLaude669: raises $0.04 to $0.06
yuzu0921: folds
kalkulater: folds
Uncalled bet ($0.04) returned to McLaude669
McLaude669 collected $0.05 from pot
McLaude669: doesn't show hand
*** SUMMARY ***
Total pot $0.05 | Rake $0
Seat 1: McLaude669 (button) collected ($0.05)
Seat 2: yuzu0921 (small blind) folded before Flop
Seat 3: kalkulater (big blind) folded before Flop
Seat 4: santogr893 folded before Flop (didn't bet)
Seat 5: LLregs folded before Flop (didn't bet)
Seat 6: hicmanboss folded before Flop (didn't bet)

PokerStars Zoom Hand #247964353162:  Hold'em No Limit ($0.01/$0.02) - 2023/12/30 19:13:00 WET [2023/12/30 14:13:00 ET]
Table 'Halley' 6-max Seat #1 is the button
Seat 1: jandsonpower ($2.74 in chips)
Seat 2: LLregs ($2.38 in chips)
Seat 3: Snodzz ($1.67 in chips)
Seat 4: The hack ($3.48 in chips)
Seat 5: ungiwar ($0.88 in chips)
Seat 6: Alanxx77 ($2.92 in chips)
LLregs: posts small blind $0.01
Snodzz: posts big blind $0.02
*** HOLE CARDS ***
Dealt to LLregs [Ad Kc]
The hack: folds
ungiwar: folds
Alanxx77: raises $0.04 to $0.06
jandsonpower: folds
LLregs: raises $0.12 to $0.18
Snodzz: folds
Alanxx77: calls $0.12
*** FLOP *** [Qs 3c 2h]
LLregs: bets $0.08
Alanxx77: folds
Uncalled bet ($0.08) returned to LLregs
LLregs collected $0.37 from pot
LLregs: doesn't show hand
*** SUMMARY ***
Total pot $0.38 | Rake $0.01
Board [Qs 3c 2h]
Seat 1: jandsonpower (button) folded before Flop (didn't bet)
Seat 2: LLregs (small blind) collected ($0.37)
Seat 3: Snodzz (big blind) folded before Flop
Seat 4: The hack folded before Flop (didn't bet)
Seat 5: ungiwar folded before Flop (didn't bet)
Seat 6: Alanxx77 folded on the Flop

PokerStars Zoom Hand #247964351357:  Hold'em No Limit ($0.01/$0.02) - 2023/12/30 19:12:55 WET [2023/12/30 14:12:55 ET]
Table 'Halley' 6-max Seat #1 is the button
Seat 1: ds_pearce2 ($1.69 in chips)
Seat 2: ivan281011 ($1.24 in chips)
Seat 3: jandsonpower ($4.24 in chips)
Seat 4: darkhexxer ($3.58 in chips)
Seat 5: joanie1991 ($4.58 in chips)
Seat 6: LLregs ($2.38 in chips)
ivan281011: posts small blind $0.01
jandsonpower: posts big blind $0.02
*** HOLE CARDS ***
Dealt to LLregs [5c 4s]
darkhexxer: folds
joanie1991: folds
LLregs: folds
ds_pearce2: raises $0.03 to $0.05
ivan281011: raises $0.03 to $0.08
jandsonpower: calls $0.06
ds_pearce2: calls $0.03
*** FLOP *** [7s 2c Td]
ivan281011: bets $0.14
jandsonpower: folds
ds_pearce2: folds
Uncalled bet ($0.14) returned to ivan281011
ivan281011 collected $0.23 from pot
ivan281011: doesn't show hand
*** SUMMARY ***
Total pot $0.24 | Rake $0.01
Board [7s 2c Td]
Seat 1: ds_pearce2 (button) folded on the Flop
Seat 2: ivan281011 (small blind) collected ($0.23)
Seat 3: jandsonpower (big blind) folded on the Flop
Seat 4: darkhexxer folded before Flop (didn't bet)
Seat 5: joanie1991 folded before Flop (didn't bet)
Seat 6: LLregs folded before Flop (didn't bet)

PokerStars Zoom Hand #247964348671:  Hold'em No Limit ($0.01/$0.02) - 2023/12/30 19:12:48 WET [2023/12/30 14:12:48 ET]
Table 'Halley' 6-max Seat #1 is the button
Seat 1: N0tsobig ($3.05 in chips)
Seat 2: xxJesseGxx ($7.20 in chips)
Seat 3: nestor-ruso ($4.92 in chips)
Seat 4: OFSHOR ($2.05 in chips)
Seat 5: LLregs ($2.38 in chips)
Seat 6: pokertito109 ($1.65 in chips)
xxJesseGxx: posts small blind $0.01
nestor-ruso: posts big blind $0.02
*** HOLE CARDS ***
Dealt to LLregs [3c 9h]
OFSHOR: folds
LLregs: folds
pokertito109: folds
N0tsobig: folds
xxJesseGxx: raises $0.04 to $0.06
nestor-ruso: raises $0.12 to $0.18
xxJesseGxx: raises $0.32 to $0.50
nestor-ruso: calls $0.32
*** FLOP *** [5d Qc Qd]
xxJesseGxx: bets $0.24
nestor-ruso: calls $0.24
*** TURN *** [5d Qc Qd] [3d]
xxJesseGxx: checks
nestor-ruso: checks
*** RIVER *** [5d Qc Qd 3d] [9s]
xxJesseGxx: bets $0.42
nestor-ruso: calls $0.42
*** SHOW DOWN ***
xxJesseGxx: shows [5s As] (two pair, Queens and Fives)
nestor-ruso: shows [Kc Kh] (two pair, Kings and Queens)
nestor-ruso collected $2.24 from pot
*** SUMMARY ***
Total pot $2.32 | Rake $0.08
Board [5d Qc Qd 3d 9s]
Seat 1: N0tsobig (button) folded before Flop (didn't bet)
Seat 2: xxJesseGxx (small blind) showed [5s As] and lost with two pair, Queens and Fives
Seat 3: nestor-ruso (big blind) showed [Kc Kh] and won ($2.24) with two pair, Kings and Queens
Seat 4: OFSHOR folded before Flop (didn't bet)
Seat 5: LLregs folded before Flop (didn't bet)
Seat 6: pokertito109 folded before Flop (didn't bet)

PokerStars Zoom Hand #247964371954:  Hold'em No Limit ($0.01/$0.02) - 2023/12/30 19:13:48 WET [2023/12/30 14:13:48 ET]
Table 'Halley' 6-max Seat #1 is the button
Seat 1: tony_extreme ($1.51 in chips)
Seat 2: Arabescul ($2.40 in chips)
Seat 3: LLregs ($2.57 in chips)
Seat 4: nuttymuch ($3.94 in chips)
Seat 5: Cris0ner ($7.42 in chips)
Seat 6: 888lifeIS ($2 in chips)
Arabescul: posts small blind $0.01
LLregs: posts big blind $0.02
*** HOLE CARDS ***
Dealt to LLregs [Ks 4c]
nuttymuch: raises $0.03 to $0.05
Cris0ner: folds
888lifeIS: folds
tony_extreme: calls $0.05
Arabescul: folds
LLregs: folds
*** FLOP *** [4h Td 3s]
nuttymuch: bets $0.07
tony_extreme: folds
Uncalled bet ($0.07) returned to nuttymuch
nuttymuch collected $0.13 from pot
nuttymuch: doesn't show hand
*** SUMMARY ***
Total pot $0.13 | Rake $0
Board [4h Td 3s]
Seat 1: tony_extreme (button) folded on the Flop
Seat 2: Arabescul (small blind) folded before Flop
Seat 3: LLregs (big blind) folded before Flop
Seat 4: nuttymuch collected ($0.13)
Seat 5: Cris0ner folded before Flop (didn't bet)
Seat 6: 888lifeIS folded before Flop (didn't bet)

PokerStars Zoom Hand #247964375433:  Hold'em No Limit ($0.01/$0.02) - 2023/12/30 19:13:57 WET [2023/12/30 14:13:57 ET]
Table 'Halley' 6-max Seat #1 is the button
Seat 1: begona219 ($3.53 in chips)
Seat 2: goldwinm ($1.52 in chips)
Seat 3: batya1212 ($2.17 in chips)
Seat 4: LukeSoldier ($2.12 in chips)
Seat 5: LLregs ($2.55 in chips)
Seat 6: gDjambo ($3.55 in chips)
goldwinm: posts small blind $0.01
batya1212: posts big blind $0.02
*** HOLE CARDS ***
Dealt to LLregs [Ad 4d]
LukeSoldier: folds
LLregs: folds
gDjambo: folds
begona219: raises $0.03 to $0.05
goldwinm: folds
batya1212: folds
Uncalled bet ($0.03) returned to begona219
begona219 collected $0.05 from pot
begona219: doesn't show hand
*** SUMMARY ***
Total pot $0.05 | Rake $0
Seat 1: begona219 (button) collected ($0.05)
Seat 2: goldwinm (small blind) folded before Flop
Seat 3: batya1212 (big blind) folded before Flop
Seat 4: LukeSoldier folded before Flop (didn't bet)
Seat 5: LLregs folded before Flop (didn't bet)
Seat 6: gDjambo folded before Flop (didn't bet)

PokerStars Zoom Hand #247964378927:  Hold'em No Limit ($0.01/$0.02) - 2023/12/30 19:14:06 WET [2023/12/30 14:14:06 ET]
Table 'Halley' 6-max Seat #1 is the button
Seat 1: LLregs ($2.55 in chips)
Seat 2: dsousAA ($2.41 in chips)
Seat 3: lacost_blr ($2 in chips)
Seat 4: McLaude669 ($1.02 in chips)
Seat 5: CaptainB1ack ($1.71 in chips)
Seat 6: francomm123 ($1.95 in chips)
dsousAA: posts small blind $0.01
lacost_blr: posts big blind $0.02
*** HOLE CARDS ***
Dealt to LLregs [As Kd]
McLaude669: folds
CaptainB1ack: folds
francomm123: folds
LLregs: raises $0.04 to $0.06
dsousAA: folds
lacost_blr: folds
Uncalled bet ($0.04) returned to LLregs
LLregs collected $0.05 from pot
LLregs: doesn't show hand
*** SUMMARY ***
Total pot $0.05 | Rake $0
Seat 1: LLregs (button) collected ($0.05)
Seat 2: dsousAA (small blind) folded before Flop
Seat 3: lacost_blr (big blind) folded before Flop
Seat 4: McLaude669 folded before Flop (didn't bet)
Seat 5: CaptainB1ack folded before Flop (didn't bet)
Seat 6: francomm123 folded before Flop (didn't bet)

PokerStars Zoom Hand #247964387823:  Hold'em No Limit ($0.01/$0.02) - 2023/12/30 19:14:29 WET [2023/12/30 14:14:29 ET]
Table 'Halley' 6-max Seat #1 is the button
Seat 1: micdik ($1.71 in chips)
Seat 2: Shizukas104 ($2.19 in chips)
Seat 3: Tricks969 ($0.79 in chips)
Seat 4: LLregs ($2.58 in chips)
Seat 5: Tutunn ($2.48 in chips)
Seat 6: CrazyFairfox ($3.68 in chips)
Shizukas104: posts small blind $0.01
Tricks969: posts big blind $0.02
*** HOLE CARDS ***
Dealt to LLregs [Th As]
LLregs: raises $0.04 to $0.06
Tutunn: folds
CrazyFairfox: folds
micdik: calls $0.06
Shizukas104: folds
Tricks969: calls $0.04
*** FLOP *** [3d 6c Qh]
Tricks969: checks
LLregs: checks
micdik: checks
*** TURN *** [3d 6c Qh] [2d]
Tricks969: checks
LLregs: bets $0.04
micdik: folds
Tricks969: calls $0.04
*** RIVER *** [3d 6c Qh 2d] [7s]
Tricks969: checks
LLregs: checks
*** SHOW DOWN ***
Tricks969: shows [7h 4h] (a pair of Sevens)
LLregs: mucks hand
Tricks969 collected $0.26 from pot
*** SUMMARY ***
Total pot $0.27 | Rake $0.01
Board [3d 6c Qh 2d 7s]
Seat 1: micdik (button) folded on the Turn
Seat 2: Shizukas104 (small blind) folded before Flop
Seat 3: Tricks969 (big blind) showed [7h 4h] and won ($0.26) with a pair of Sevens
Seat 4: LLregs mucked [Th As]
Seat 5: Tutunn folded before Flop (didn't bet)
Seat 6: CrazyFairfox folded before Flop (didn't bet)

PokerStars Zoom Hand #247964370415:  Hold'em No Limit ($0.01/$0.02) - 2023/12/30 19:13:44 WET [2023/12/30 14:13:44 ET]
Table 'Halley' 6-max Seat #1 is the button
Seat 1: marcegring ($1.74 in chips)
Seat 2: 888lifeIS ($2 in chips)
Seat 3: pillopk ($2.07 in chips)
Seat 4: LLregs ($2.57 in chips)
Seat 5: steph7208 ($1.29 in chips)
Seat 6: sorokin21 ($2.04 in chips)
888lifeIS: posts small blind $0.01
pillopk: posts big blind $0.02
*** HOLE CARDS ***
Dealt to LLregs [Kd 6c]
LLregs: folds
steph7208: folds
sorokin21: folds
marcegring: raises $0.04 to $0.06
888lifeIS: folds
pillopk: raises $0.18 to $0.24
marcegring: calls $0.18
*** FLOP *** [8s 6s 9h]
pillopk: bets $0.20
marcegring: folds
Uncalled bet ($0.20) returned to pillopk
pillopk collected $0.47 from pot
pillopk: doesn't show hand
*** SUMMARY ***
Total pot $0.49 | Rake $0.02
Board [8s 6s 9h]
Seat 1: marcegring (button) folded on the Flop
Seat 2: 888lifeIS (small blind) folded before Flop
Seat 3: pillopk (big blind) collected ($0.47)
Seat 4: LLregs folded before Flop (didn't bet)
Seat 5: steph7208 folded before Flop (didn't bet)
Seat 6: sorokin21 folded before Flop (didn't bet)

PokerStars Zoom Hand #247964402798:  Hold'em No Limit ($0.01/$0.02) - 2023/12/30 19:15:08 WET [2023/12/30 14:15:08 ET]
Table 'Halley' 6-max Seat #1 is the button
Seat 1: Ukr Troll ($7.55 in chips)
Seat 2: LLregs ($2.46 in chips)
Seat 3: pillopk ($2.42 in chips)
Seat 4: cr@sh test ($2.48 in chips)
Seat 5: Fig0uu ($4.47 in chips)
Seat 6: pawelllo1 ($5.60 in chips)
LLregs: posts small blind $0.01
pillopk: posts big blind $0.02
*** HOLE CARDS ***
Dealt to LLregs [Kd Ah]
cr@sh test: folds
Fig0uu: folds
pawelllo1: folds
Ukr Troll: folds
LLregs: raises $0.04 to $0.06
pillopk: folds
Uncalled bet ($0.04) returned to LLregs
LLregs collected $0.04 from pot
LLregs: doesn't show hand
*** SUMMARY ***
Total pot $0.04 | Rake $0
Seat 1: Ukr Troll (button) folded before Flop (didn't bet)
Seat 2: LLregs (small blind) collected ($0.04)
Seat 3: pillopk (big blind) folded before Flop
Seat 4: cr@sh test folded before Flop (didn't bet)
Seat 5: Fig0uu folded before Flop (didn't bet)
Seat 6: pawelllo1 folded before Flop (didn't bet)

PokerStars Zoom Hand #247964399390:  Hold'em No Limit ($0.01/$0.02) - 2023/12/30 19:14:59 WET [2023/12/30 14:14:59 ET]
Table 'Halley' 6-max Seat #1 is the button
Seat 1: Arabescul ($2.34 in chips)
Seat 2: ajimvr ($5.76 in chips)
Seat 3: LLregs ($2.48 in chips)
Seat 4: piterpank31 ($2.74 in chips)
Seat 5: RTedeschi19 ($3.11 in chips)
Seat 6: zielony ($2 in chips)
ajimvr: posts small blind $0.01
LLregs: posts big blind $0.02
*** HOLE CARDS ***
Dealt to LLregs [9d 8s]
piterpank31: folds
RTedeschi19: raises $0.02 to $0.04
zielony: folds
Arabescul: raises $0.18 to $0.22
ajimvr: folds
LLregs: folds
RTedeschi19: calls $0.18
*** FLOP *** [9c Ah 4s]
RTedeschi19: checks
Arabescul: bets $0.23
RTedeschi19: calls $0.23
*** TURN *** [9c Ah 4s] [Kh]
RTedeschi19: checks
Arabescul: checks
*** RIVER *** [9c Ah 4s Kh] [8d]
RTedeschi19: bets $0.90
Arabescul: folds
Uncalled bet ($0.90) returned to RTedeschi19
RTedeschi19 collected $0.90 from pot
RTedeschi19: doesn't show hand
*** SUMMARY ***
Total pot $0.93 | Rake $0.03
Board [9c Ah 4s Kh 8d]
Seat 1: Arabescul (button) folded on the River
Seat 2: ajimvr (small blind) folded before Flop
Seat 3: LLregs (big blind) folded before Flop
Seat 4: piterpank31 folded before Flop (didn't bet)
Seat 5: RTedeschi19 collected ($0.90)
Seat 6: zielony folded before Flop (didn't bet)

PokerStars Zoom Hand #247964416845:  Hold'em No Limit ($0.01/$0.02) - 2023/12/30 19:15:44 WET [2023/12/30 14:15:44 ET]
Table 'Halley' 6-max Seat #1 is the button
Seat 1: jandsonpower ($4.11 in chips)
Seat 2: gallpap ($2.76 in chips)
Seat 3: 888lifeIS ($2.15 in chips)
Seat 4: LLregs ($2.48 in chips)
Seat 5: lapoleka ($2.15 in chips)
Seat 6: olsekpoker ($2.26 in chips)
gallpap: posts small blind $0.01
888lifeIS: posts big blind $0.02
*** HOLE CARDS ***
Dealt to LLregs [4c Ah]
LLregs: folds
lapoleka: folds
olsekpoker: folds
jandsonpower: folds
gallpap: folds
Uncalled bet ($0.01) returned to 888lifeIS
888lifeIS collected $0.02 from pot
888lifeIS: doesn't show hand
*** SUMMARY ***
Total pot $0.02 | Rake $0
Seat 1: jandsonpower (button) folded before Flop (didn't bet)
Seat 2: gallpap (small blind) folded before Flop
Seat 3: 888lifeIS (big blind) collected ($0.02)
Seat 4: LLregs folded before Flop (didn't bet)
Seat 5: lapoleka folded before Flop (didn't bet)
Seat 6: olsekpoker folded before Flop (didn't bet)

PokerStars Zoom Hand #247964415690:  Hold'em No Limit ($0.01/$0.02) - 2023/12/30 19:15:41 WET [2023/12/30 14:15:41 ET]
Table 'Halley' 6-max Seat #1 is the button
Seat 1: wee_smurf23 ($2.47 in chips)
Seat 2: ALEXAN-OLEX ($2.14 in chips)
Seat 3: BadBeat Bert ($1.15 in chips)
Seat 4: cachusky ($2 in chips)
Seat 5: LLregs ($2.48 in chips)
Seat 6: zote800 ($1.26 in chips)
ALEXAN-OLEX: posts small blind $0.01
BadBeat Bert: posts big blind $0.02
*** HOLE CARDS ***
Dealt to LLregs [3h Td]
cachusky: folds
LLregs: folds
zote800: folds
wee_smurf23: folds
ALEXAN-OLEX: raises $0.02 to $0.04
BadBeat Bert: folds
Uncalled bet ($0.02) returned to ALEXAN-OLEX
ALEXAN-OLEX collected $0.04 from pot
ALEXAN-OLEX: doesn't show hand
*** SUMMARY ***
Total pot $0.04 | Rake $0
Seat 1: wee_smurf23 (button) folded before Flop (didn't bet)
Seat 2: ALEXAN-OLEX (small blind) collected ($0.04)
Seat 3: BadBeat Bert (big blind) folded before Flop
Seat 4: cachusky folded before Flop (didn't bet)
Seat 5: LLregs folded before Flop (didn't bet)
Seat 6: zote800 folded before Flop (didn't bet)

PokerStars Zoom Hand #247964414163:  Hold'em No Limit ($0.01/$0.02) - 2023/12/30 19:15:37 WET [2023/12/30 14:15:37 ET]
Table 'Halley' 6-max Seat #1 is the button
Seat 1: mangalisa ($2 in chips)
Seat 2: batya1212 ($2.13 in chips)
Seat 3: Alanxx77 ($2.92 in chips)
Seat 4: plak69 ($2.26 in chips)
Seat 5: zote800 ($1.26 in chips)
Seat 6: LLregs ($2.48 in chips)
batya1212: posts small blind $0.01
Alanxx77: posts big blind $0.02
*** HOLE CARDS ***
Dealt to LLregs [8h Ac]
plak69: folds
zote800: folds
LLregs: folds
mangalisa: folds
batya1212: folds
Uncalled bet ($0.01) returned to Alanxx77
Alanxx77 collected $0.02 from pot
Alanxx77: doesn't show hand
*** SUMMARY ***
Total pot $0.02 | Rake $0
Seat 1: mangalisa (button) folded before Flop (didn't bet)
Seat 2: batya1212 (small blind) folded before Flop
Seat 3: Alanxx77 (big blind) collected ($0.02)
Seat 4: plak69 folded before Flop (didn't bet)
Seat 5: zote800 folded before Flop (didn't bet)
Seat 6: LLregs folded before Flop (didn't bet)

PokerStars Zoom Hand #247964408403:  Hold'em No Limit ($0.01/$0.02) - 2023/12/30 19:15:22 WET [2023/12/30 14:15:22 ET]
Table 'Halley' 6-max Seat #1 is the button
Seat 1: LLregs ($2.48 in chips)
Seat 2: zielony ($3.89 in chips)
Seat 3: sharike22 ($1.49 in chips)
Seat 4: Val'demar.ks ($1.12 in chips)
Seat 5: dsousAA ($2.40 in chips)
Seat 6: BsbFox ($4.41 in chips)
zielony: posts small blind $0.01
sharike22: posts big blind $0.02
*** HOLE CARDS ***
Dealt to LLregs [6s 3d]
Val'demar.ks: folds
dsousAA: folds
BsbFox: raises $0.04 to $0.06
LLregs: folds
zielony: calls $0.05
sharike22: calls $0.04
*** FLOP *** [Th 5s 4c]
zielony: checks
sharike22: checks
BsbFox: bets $0.09
zielony: calls $0.09
sharike22: folds
*** TURN *** [Th 5s 4c] [6h]
zielony: checks
BsbFox: bets $0.18
zielony: calls $0.18
*** RIVER *** [Th 5s 4c 6h] [Jc]
zielony: checks
BsbFox: checks
*** SHOW DOWN ***
zielony: shows [4h Ah] (a pair of Fours)
BsbFox: shows [7d 7s] (a pair of Sevens)
BsbFox collected $0.69 from pot
*** SUMMARY ***
Total pot $0.72 | Rake $0.03
Board [Th 5s 4c 6h Jc]
Seat 1: LLregs (button) folded before Flop (didn't bet)
Seat 2: zielony (small blind) showed [4h Ah] and lost with a pair of Fours
Seat 3: sharike22 (big blind) folded on the Flop
Seat 4: Val'demar.ks folded before Flop (didn't bet)
Seat 5: dsousAA folded before Flop (didn't bet)
Seat 6: BsbFox showed [7d 7s] and won ($0.69) with a pair of Sevens

PokerStars Zoom Hand #247964426553:  Hold'em No Limit ($0.01/$0.02) - 2023/12/30 19:16:09 WET [2023/12/30 14:16:09 ET]
Table 'Halley' 6-max Seat #1 is the button
Seat 1: LLregs ($2.47 in chips)
Seat 2: YhwachBach ($2.15 in chips)
Seat 3: lapoleka ($2.18 in chips)
Seat 4: scurvy idler ($2.20 in chips)
Seat 5: mauchin ($1.17 in chips)
Seat 6: Ruslan_hra ($0.30 in chips)
YhwachBach: posts small blind $0.01
lapoleka: posts big blind $0.02
*** HOLE CARDS ***
Dealt to LLregs [4c 7d]
scurvy idler: folds
mauchin: folds
Ruslan_hra: folds
LLregs: folds
YhwachBach: raises $0.04 to $0.06
lapoleka: folds
Uncalled bet ($0.04) returned to YhwachBach
YhwachBach collected $0.04 from pot
YhwachBach: doesn't show hand
*** SUMMARY ***
Total pot $0.04 | Rake $0
Seat 1: LLregs (button) folded before Flop (didn't bet)
Seat 2: YhwachBach (small blind) collected ($0.04)
Seat 3: lapoleka (big blind) folded before Flop
Seat 4: scurvy idler folded before Flop (didn't bet)
Seat 5: mauchin folded before Flop (didn't bet)
Seat 6: Ruslan_hra folded before Flop (didn't bet)

PokerStars Zoom Hand #247964418439:  Hold'em No Limit ($0.01/$0.02) - 2023/12/30 19:15:48 WET [2023/12/30 14:15:48 ET]
Table 'Halley' 6-max Seat #1 is the button
Seat 1: francomm123 ($1.94 in chips)
Seat 2: LLregs ($2.48 in chips)
Seat 3: TeshioRiver ($2.17 in chips)
Seat 4: davidbarrels ($2.09 in chips)
Seat 5: enekiii ($1.56 in chips)
Seat 6: Kamylo20 ($2.39 in chips)
LLregs: posts small blind $0.01
TeshioRiver: posts big blind $0.02
*** HOLE CARDS ***
Dealt to LLregs [6h Kd]
davidbarrels: raises $0.04 to $0.06
enekiii: folds
Kamylo20: calls $0.06
francomm123: folds
LLregs: folds
TeshioRiver: calls $0.04
*** FLOP *** [8s Qh 9c]
TeshioRiver: checks
davidbarrels: checks
Kamylo20: checks
*** TURN *** [8s Qh 9c] [7d]
TeshioRiver: bets $0.05
davidbarrels: calls $0.05
Kamylo20: calls $0.05
*** RIVER *** [8s Qh 9c 7d] [Ah]
TeshioRiver: checks
davidbarrels: checks
Kamylo20: checks
*** SHOW DOWN ***
TeshioRiver: shows [8h 7h] (two pair, Eights and Sevens)
davidbarrels: mucks hand
Kamylo20: mucks hand
TeshioRiver collected $0.33 from pot
*** SUMMARY ***
Total pot $0.34 | Rake $0.01
Board [8s Qh 9c 7d Ah]
Seat 1: francomm123 (button) folded before Flop (didn't bet)
Seat 2: LLregs (small blind) folded before Flop
Seat 3: TeshioRiver (big blind) showed [8h 7h] and won ($0.33) with two pair, Eights and Sevens
Seat 4: davidbarrels mucked [6c 4c]
Seat 5: enekiii folded before Flop (didn't bet)
Seat 6: Kamylo20 mucked [Ts Td]

PokerStars Zoom Hand #247964428095:  Hold'em No Limit ($0.01/$0.02) - 2023/12/30 19:16:13 WET [2023/12/30 14:16:13 ET]
Table 'Halley' 6-max Seat #1 is the button
Seat 1: Balonas ($6.77 in chips)
Seat 2: goldwinm ($1 in chips)
Seat 3: LLregs ($2.47 in chips)
Seat 4: xTheBulletsx ($3.94 in chips)
Seat 5: francomm123 ($1.94 in chips)
Seat 6: Ryg_89 ($2.21 in chips)
goldwinm: posts small blind $0.01
LLregs: posts big blind $0.02
*** HOLE CARDS ***
Dealt to LLregs [As Td]
xTheBulletsx: folds
francomm123: folds
Ryg_89: raises $0.04 to $0.06
Balonas: folds
goldwinm: calls $0.05
LLregs: calls $0.04
*** FLOP *** [5h Tc Jd]
goldwinm: checks
LLregs: checks
Ryg_89: checks
*** TURN *** [5h Tc Jd] [Js]
goldwinm: checks
LLregs: bets $0.06
Ryg_89: folds
goldwinm: calls $0.06
*** RIVER *** [5h Tc Jd Js] [Qd]
goldwinm: checks
LLregs: bets $0.14
goldwinm: calls $0.14
*** SHOW DOWN ***
LLregs: shows [As Td] (two pair, Jacks and Tens)
goldwinm: mucks hand
LLregs collected $0.56 from pot
*** SUMMARY ***
Total pot $0.58 | Rake $0.02
Board [5h Tc Jd Js Qd]
Seat 1: Balonas (button) folded before Flop (didn't bet)
Seat 2: goldwinm (small blind) mucked [9h Th]
Seat 3: LLregs (big blind) showed [As Td] and won ($0.56) with two pair, Jacks and Tens
Seat 4: xTheBulletsx folded before Flop (didn't bet)
Seat 5: francomm123 folded before Flop (didn't bet)
Seat 6: Ryg_89 folded on the Turn

PokerStars Zoom Hand #247964448461:  Hold'em No Limit ($0.01/$0.02) - 2023/12/30 19:17:06 WET [2023/12/30 14:17:06 ET]
Table 'Halley' 6-max Seat #1 is the button
Seat 1: Alanxx77 ($4.98 in chips)
Seat 2: RocketFir271 ($2.87 in chips)
Seat 3: micdik ($1.88 in chips)
Seat 4: thiah_b14 ($1.71 in chips)
Seat 5: Kamylo20 ($2 in chips)
Seat 6: LLregs ($2.77 in chips)
RocketFir271: posts small blind $0.01
micdik: posts big blind $0.02
*** HOLE CARDS ***
Dealt to LLregs [2h 7d]
thiah_b14: raises $0.03 to $0.05
Kamylo20: folds
LLregs: folds
Alanxx77: folds
RocketFir271: folds
micdik: calls $0.03
*** FLOP *** [Qc 8h 6s]
micdik: checks
thiah_b14: checks
*** TURN *** [Qc 8h 6s] [Kc]
micdik: checks
thiah_b14: checks
*** RIVER *** [Qc 8h 6s Kc] [8d]
micdik: checks
thiah_b14: checks
*** SHOW DOWN ***
micdik: shows [5h 5d] (two pair, Eights and Fives)
thiah_b14: mucks hand
micdik collected $0.11 from pot
*** SUMMARY ***
Total pot $0.11 | Rake $0
Board [Qc 8h 6s Kc 8d]
Seat 1: Alanxx77 (button) folded before Flop (didn't bet)
Seat 2: RocketFir271 (small blind) folded before Flop
Seat 3: micdik (big blind) showed [5h 5d] and won ($0.11) with two pair, Eights and Fives
Seat 4: thiah_b14 mucked [As Ts]
Seat 5: Kamylo20 folded before Flop (didn't bet)
Seat 6: LLregs folded before Flop (didn't bet)

PokerStars Zoom Hand #247964455108:  Hold'em No Limit ($0.01/$0.02) - 2023/12/30 19:17:23 WET [2023/12/30 14:17:23 ET]
Table 'Halley' 6-max Seat #1 is the button
Seat 1: ZorroZoltan ($1.94 in chips)
Seat 2: Cris0ner ($6.99 in chips)
Seat 3: jamp2325 ($2.12 in chips)
Seat 4: sharike22 ($1.23 in chips)
Seat 5: LLregs ($2.76 in chips)
Seat 6: minc85 ($2.01 in chips)
Cris0ner: posts small blind $0.01
jamp2325: posts big blind $0.02
*** HOLE CARDS ***
Dealt to LLregs [5s Ts]
sharike22: folds
LLregs: folds
minc85: folds
ZorroZoltan: raises $0.04 to $0.06
Cris0ner: folds
jamp2325: folds
Uncalled bet ($0.04) returned to ZorroZoltan
ZorroZoltan collected $0.05 from pot
ZorroZoltan: doesn't show hand
*** SUMMARY ***
Total pot $0.05 | Rake $0
Seat 1: ZorroZoltan (button) collected ($0.05)
Seat 2: Cris0ner (small blind) folded before Flop
Seat 3: jamp2325 (big blind) folded before Flop
Seat 4: sharike22 folded before Flop (didn't bet)
Seat 5: LLregs folded before Flop (didn't bet)
Seat 6: minc85 folded before Flop (didn't bet)

PokerStars Zoom Hand #247964450449:  Hold'em No Limit ($0.01/$0.02) - 2023/12/30 19:17:11 WET [2023/12/30 14:17:11 ET]
Table 'Halley' 6-max Seat #1 is the button
Seat 1: 888lifeIS ($2.08 in chips)
Seat 2: ivan281011 ($1.22 in chips)
Seat 3: piterpank31 ($2.07 in chips)
Seat 4: 2plateado2 ($2.08 in chips)
Seat 5: LLregs ($2.77 in chips)
Seat 6: #1spoon ($1.76 in chips)
ivan281011: posts small blind $0.01
piterpank31: posts big blind $0.02
*** HOLE CARDS ***
Dealt to LLregs [3d Kh]
2plateado2: folds
LLregs: folds
#1spoon: calls $0.02
888lifeIS: folds
ivan281011: folds
piterpank31: checks
*** FLOP *** [Qc 5c 7h]
piterpank31: checks
#1spoon: bets $0.04
piterpank31: folds
Uncalled bet ($0.04) returned to #1spoon
#1spoon collected $0.05 from pot
#1spoon: doesn't show hand
*** SUMMARY ***
Total pot $0.05 | Rake $0
Board [Qc 5c 7h]
Seat 1: 888lifeIS (button) folded before Flop (didn't bet)
Seat 2: ivan281011 (small blind) folded before Flop
Seat 3: piterpank31 (big blind) folded on the Flop
Seat 4: 2plateado2 folded before Flop (didn't bet)
Seat 5: LLregs folded before Flop (didn't bet)
Seat 6: #1spoon collected ($0.05)

PokerStars Zoom Hand #247964456579:  Hold'em No Limit ($0.01/$0.02) - 2023/12/30 19:17:27 WET [2023/12/30 14:17:27 ET]
Table 'Halley' 6-max Seat #1 is the button
Seat 1: rowingboy ($2.23 in chips)
Seat 2: cr@sh test ($2.43 in chips)
Seat 3: 888lifeIS ($2.03 in chips)
Seat 4: minc85 ($2.01 in chips)
Seat 5: xTheBulletsx ($2.04 in chips)
Seat 6: LLregs ($2.76 in chips)
cr@sh test: posts small blind $0.01
888lifeIS: posts big blind $0.02
*** HOLE CARDS ***
Dealt to LLregs [Ks Ah]
minc85: folds
xTheBulletsx: folds
LLregs: raises $0.04 to $0.06
rowingboy: folds
cr@sh test: folds
888lifeIS: folds
Uncalled bet ($0.04) returned to LLregs
LLregs collected $0.05 from pot
LLregs: doesn't show hand
*** SUMMARY ***
Total pot $0.05 | Rake $0
Seat 1: rowingboy (button) folded before Flop (didn't bet)
Seat 2: cr@sh test (small blind) folded before Flop
Seat 3: 888lifeIS (big blind) folded before Flop
Seat 4: minc85 folded before Flop (didn't bet)
Seat 5: xTheBulletsx folded before Flop (didn't bet)
Seat 6: LLregs collected ($0.05)

PokerStars Zoom Hand #247964451973:  Hold'em No Limit ($0.01/$0.02) - 2023/12/30 19:17:15 WET [2023/12/30 14:17:15 ET]
Table 'Halley' 6-max Seat #1 is the button
Seat 1: jandsonpower ($4.03 in chips)
Seat 2: LLregs ($2.77 in chips)
Seat 3: pillopk ($2.12 in chips)
Seat 4: enilno rats ($4.67 in chips)
Seat 5: Ninjafuturo123 ($2.29 in chips)
Seat 6: Arabescul ($2.21 in chips)
LLregs: posts small blind $0.01
pillopk: posts big blind $0.02
*** HOLE CARDS ***
Dealt to LLregs [2c 7c]
enilno rats: raises $0.02 to $0.04
Ninjafuturo123: folds
Arabescul: folds
jandsonpower: folds
LLregs: folds
pillopk: calls $0.02
*** FLOP *** [Qd Jh 3d]
pillopk: checks
enilno rats: checks
*** TURN *** [Qd Jh 3d] [Jc]
pillopk: bets $0.04
enilno rats: calls $0.04
*** RIVER *** [Qd Jh 3d Jc] [4s]
pillopk: bets $0.12
enilno rats: calls $0.12
*** SHOW DOWN ***
pillopk: shows [Td 7d] (a pair of Jacks)
enilno rats: shows [Ad Ac] (two pair, Aces and Jacks)
enilno rats collected $0.40 from pot
*** SUMMARY ***
Total pot $0.41 | Rake $0.01
Board [Qd Jh 3d Jc 4s]
Seat 1: jandsonpower (button) folded before Flop (didn't bet)
Seat 2: LLregs (small blind) folded before Flop
Seat 3: pillopk (big blind) showed [Td 7d] and lost with a pair of Jacks
Seat 4: enilno rats showed [Ad Ac] and won ($0.40) with two pair, Aces and Jacks
Seat 5: Ninjafuturo123 folded before Flop (didn't bet)
Seat 6: Arabescul folded before Flop (didn't bet)

PokerStars Zoom Hand #247964463536:  Hold'em No Limit ($0.01/$0.02) - 2023/12/30 19:17:45 WET [2023/12/30 14:17:45 ET]
Table 'Halley' 6-max Seat #1 is the button
Seat 1: RocketFir271 ($2.97 in chips)
Seat 2: leedsrounder ($2 in chips)
Seat 3: LLregs ($2.79 in chips)
Seat 4: Caiko16 ($1.99 in chips)
Seat 5: tisadaisy ($2.44 in chips)
Seat 6: kuelas ($2.08 in chips)
leedsrounder: posts small blind $0.01
LLregs: posts big blind $0.02
*** HOLE CARDS ***
Dealt to LLregs [Qs 2d]
Caiko16: folds
tisadaisy: folds
kuelas: raises $0.02 to $0.04
RocketFir271: folds
leedsrounder: folds
LLregs: folds
Uncalled bet ($0.02) returned to kuelas
kuelas collected $0.05 from pot
kuelas: doesn't show hand
*** SUMMARY ***
Total pot $0.05 | Rake $0
Seat 1: RocketFir271 (button) folded before Flop (didn't bet)
Seat 2: leedsrounder (small blind) folded before Flop
Seat 3: LLregs (big blind) folded before Flop
Seat 4: Caiko16 folded before Flop (didn't bet)
Seat 5: tisadaisy folded before Flop (didn't bet)
Seat 6: kuelas collected ($0.05)

PokerStars Zoom Hand #247964453550:  Hold'em No Limit ($0.01/$0.02) - 2023/12/30 19:17:19 WET [2023/12/30 14:17:19 ET]
Table 'Halley' 6-max Seat #1 is the button
Seat 1: katrapila ($2 in chips)
Seat 2: zielony ($3.52 in chips)
Seat 3: steen3839 ($2 in chips)
Seat 4: LLregs ($2.76 in chips)
Seat 5: Timo_H922 ($2.41 in chips)
Seat 6: goldwinm ($1.43 in chips)
zielony: posts small blind $0.01
steen3839: posts big blind $0.02
*** HOLE CARDS ***
Dealt to LLregs [5d 6h]
LLregs: folds
Timo_H922: folds
goldwinm: folds
katrapila: raises $0.03 to $0.05
zielony: folds
steen3839: calls $0.03
*** FLOP *** [6d Ks 4c]
steen3839: checks
katrapila: bets $0.04
steen3839: calls $0.04
*** TURN *** [6d Ks 4c] [8h]
steen3839: checks
katrapila: bets $0.15
steen3839: raises $0.15 to $0.30
katrapila: calls $0.15
*** RIVER *** [6d Ks 4c 8h] [9s]
steen3839: bets $0.18
katrapila: raises $1.43 to $1.61 and is all-in
steen3839: calls $1.43 and is all-in
*** SHOW DOWN ***
katrapila: shows [8d Ah] (a pair of Eights)
steen3839: shows [Kc 5s] (a pair of Kings)
steen3839 collected $3.87 from pot
*** SUMMARY ***
Total pot $4.01 | Rake $0.14
Board [6d Ks 4c 8h 9s]
Seat 1: katrapila (button) showed [8d Ah] and lost with a pair of Eights
Seat 2: zielony (small blind) folded before Flop
Seat 3: steen3839 (big blind) showed [Kc 5s] and won ($3.87) with a pair of Kings
Seat 4: LLregs folded before Flop (didn't bet)
Seat 5: Timo_H922 folded before Flop (didn't bet)
Seat 6: goldwinm folded before Flop (didn't bet)

PokerStars Zoom Hand #247964474710:  Hold'em No Limit ($0.01/$0.02) - 2023/12/30 19:18:14 WET [2023/12/30 14:18:14 ET]
Table 'Halley' 6-max Seat #1 is the button
Seat 1: mauchin ($0.64 in chips)
Seat 2: Ukr Troll ($7.59 in chips)
Seat 3: pillopk ($2.21 in chips)
Seat 4: fukazapam ($2.49 in chips)
Seat 5: LLregs ($2.77 in chips)
Seat 6: MeisterJedah ($6.97 in chips)
Ukr Troll: posts small blind $0.01
pillopk: posts big blind $0.02
*** HOLE CARDS ***
Dealt to LLregs [Th 2h]
fukazapam: folds
LLregs: folds
MeisterJedah: folds
mauchin: folds
Ukr Troll: folds
Uncalled bet ($0.01) returned to pillopk
pillopk collected $0.02 from pot
pillopk: doesn't show hand
*** SUMMARY ***
Total pot $0.02 | Rake $0
Seat 1: mauchin (button) folded before Flop (didn't bet)
Seat 2: Ukr Troll (small blind) folded before Flop
Seat 3: pillopk (big blind) collected ($0.02)
Seat 4: fukazapam folded before Flop (didn't bet)
Seat 5: LLregs folded before Flop (didn't bet)
Seat 6: MeisterJedah folded before Flop (didn't bet)

PokerStars Zoom Hand #247964475948:  Hold'em No Limit ($0.01/$0.02) - 2023/12/30 19:18:18 WET [2023/12/30 14:18:18 ET]
Table 'Halley' 6-max Seat #1 is the button
Seat 1: LLregs ($2.77 in chips)
Seat 2: ginobili666 ($5.30 in chips)
Seat 3: enekiii ($1.50 in chips)
Seat 4: Tutunn ($2.58 in chips)
Seat 5: Arabescul ($2.58 in chips)
Seat 6: Prof. Znaika ($1.90 in chips)
ginobili666: posts small blind $0.01
enekiii: posts big blind $0.02
*** HOLE CARDS ***
Dealt to LLregs [7s 2h]
Tutunn: folds
Arabescul: folds
Prof. Znaika: raises $0.04 to $0.06
LLregs: folds
ginobili666: folds
enekiii: folds
Uncalled bet ($0.04) returned to Prof. Znaika
Prof. Znaika collected $0.05 from pot
Prof. Znaika: doesn't show hand
*** SUMMARY ***
Total pot $0.05 | Rake $0
Seat 1: LLregs (button) folded before Flop (didn't bet)
Seat 2: ginobili666 (small blind) folded before Flop
Seat 3: enekiii (big blind) folded before Flop
Seat 4: Tutunn folded before Flop (didn't bet)
Seat 5: Arabescul folded before Flop (didn't bet)
Seat 6: Prof. Znaika collected ($0.05)

PokerStars Zoom Hand #247964469767:  Hold'em No Limit ($0.01/$0.02) - 2023/12/30 19:18:01 WET [2023/12/30 14:18:01 ET]
Table 'Halley' 6-max Seat #1 is the button
Seat 1: LLregs ($2.77 in chips)
Seat 2: 888lifeIS ($2.09 in chips)
Seat 3: batya1212 ($2.82 in chips)
Seat 4: RocketFir271 ($2.95 in chips)
Seat 5: hai69 ($2.95 in chips)
Seat 6: piterpank31 ($2.04 in chips)
888lifeIS: posts small blind $0.01
batya1212: posts big blind $0.02
*** HOLE CARDS ***
Dealt to LLregs [Qh 8h]
RocketFir271: folds
hai69: folds
piterpank31: raises $0.04 to $0.06
LLregs: folds
888lifeIS: folds
batya1212: calls $0.04
*** FLOP *** [3c 5s 2s]
batya1212: checks
piterpank31: bets $0.05
batya1212: raises $0.14 to $0.19
piterpank31: calls $0.14
*** TURN *** [3c 5s 2s] [5c]
batya1212: bets $0.68
piterpank31: calls $0.68
*** RIVER *** [3c 5s 2s 5c] [Ac]
batya1212: bets $1.89 and is all-in
piterpank31: folds
Uncalled bet ($1.89) returned to batya1212
batya1212 collected $1.80 from pot
batya1212: doesn't show hand
*** SUMMARY ***
Total pot $1.87 | Rake $0.07
Board [3c 5s 2s 5c Ac]
Seat 1: LLregs (button) folded before Flop (didn't bet)
Seat 2: 888lifeIS (small blind) folded before Flop
Seat 3: batya1212 (big blind) collected ($1.80)
Seat 4: RocketFir271 folded before Flop (didn't bet)
Seat 5: hai69 folded before Flop (didn't bet)
Seat 6: piterpank31 folded on the River

PokerStars Zoom Hand #247964477282:  Hold'em No Limit ($0.01/$0.02) - 2023/12/30 19:18:21 WET [2023/12/30 14:18:21 ET]
Table 'Halley' 6-max Seat #1 is the button
Seat 1: Cpt_Price_67 ($1.97 in chips)
Seat 2: LLregs ($2.77 in chips)
Seat 3: Forever smile3 ($3.72 in chips)
Seat 4: Arabescul ($2.58 in chips)
Seat 5: nuttymuch ($3.68 in chips)
Seat 6: jandsonpower ($3.56 in chips)
LLregs: posts small blind $0.01
Forever smile3: posts big blind $0.02
*** HOLE CARDS ***
Dealt to LLregs [Jc 6c]
Arabescul: folds
nuttymuch: folds
jandsonpower: folds
Cpt_Price_67: folds
LLregs: raises $0.04 to $0.06
Forever smile3: calls $0.04
*** FLOP *** [6s 8h Th]
LLregs: bets $0.04
Forever smile3: calls $0.04
*** TURN *** [6s 8h Th] [Td]
LLregs: checks
Forever smile3: checks
*** RIVER *** [6s 8h Th Td] [9h]
LLregs: bets $0.06
Forever smile3: folds
Uncalled bet ($0.06) returned to LLregs
LLregs collected $0.19 from pot
LLregs: doesn't show hand
*** SUMMARY ***
Total pot $0.20 | Rake $0.01
Board [6s 8h Th Td 9h]
Seat 1: Cpt_Price_67 (button) folded before Flop (didn't bet)
Seat 2: LLregs (small blind) collected ($0.19)
Seat 3: Forever smile3 (big blind) folded on the River
Seat 4: Arabescul folded before Flop (didn't bet)
Seat 5: nuttymuch folded before Flop (didn't bet)
Seat 6: jandsonpower folded before Flop (didn't bet)

PokerStars Zoom Hand #247964490910:  Hold'em No Limit ($0.01/$0.02) - 2023/12/30 19:18:56 WET [2023/12/30 14:18:56 ET]
Table 'Halley' 6-max Seat #1 is the button
Seat 1: dsousAA ($2.21 in chips)
Seat 2: Devilfishtheone ($2.10 in chips)
Seat 3: LLregs ($2.86 in chips)
Seat 4: lapoleka ($2.17 in chips)
Seat 5: Agneobr ($1.94 in chips)
Seat 6: fukazapam ($2.46 in chips)
Devilfishtheone: posts small blind $0.01
LLregs: posts big blind $0.02
*** HOLE CARDS ***
Dealt to LLregs [Ac 7d]
lapoleka: raises $0.02 to $0.04
Agneobr: folds
fukazapam: folds
dsousAA: folds
Devilfishtheone: calls $0.03
LLregs: calls $0.02
*** FLOP *** [Qs As 7h]
Devilfishtheone: checks
LLregs: checks
lapoleka: bets $0.04
Devilfishtheone: calls $0.04
LLregs: calls $0.04
*** TURN *** [Qs As 7h] [Qd]
Devilfishtheone: checks
LLregs: checks
lapoleka: checks
*** RIVER *** [Qs As 7h Qd] [Th]
Devilfishtheone: bets $0.12
LLregs: calls $0.12
lapoleka: folds
*** SHOW DOWN ***
Devilfishtheone: shows [4s Ah] (two pair, Aces and Queens)
LLregs: shows [Ac 7d] (two pair, Aces and Queens)
Devilfishtheone collected $0.23 from pot
LLregs collected $0.23 from pot
*** SUMMARY ***
Total pot $0.48 | Rake $0.02
Board [Qs As 7h Qd Th]
Seat 1: dsousAA (button) folded before Flop (didn't bet)
Seat 2: Devilfishtheone (small blind) showed [4s Ah] and won ($0.23) with two pair, Aces and Queens
Seat 3: LLregs (big blind) showed [Ac 7d] and won ($0.23) with two pair, Aces and Queens
Seat 4: lapoleka folded on the River
Seat 5: Agneobr folded before Flop (didn't bet)
Seat 6: fukazapam folded before Flop (didn't bet)

PokerStars Zoom Hand #247964516740:  Hold'em No Limit ($0.01/$0.02) - 2023/12/30 19:20:03 WET [2023/12/30 14:20:03 ET]
Table 'Halley' 6-max Seat #1 is the button
Seat 1: Shizukas104 ($2.11 in chips)
Seat 2: pillopk ($2.31 in chips)
Seat 3: 50 vs 50 ($2.09 in chips)
Seat 4: LLregs ($2.89 in chips)
Seat 5: NovatoHn ($2.90 in chips)
Seat 6: Kamylo20 ($2.58 in chips)
pillopk: posts small blind $0.01
50 vs 50: posts big blind $0.02
*** HOLE CARDS ***
Dealt to LLregs [Ac Td]
LLregs: raises $0.04 to $0.06
NovatoHn: folds
Kamylo20: calls $0.06
Shizukas104: folds
pillopk: folds
50 vs 50: folds
*** FLOP *** [5c 4h 3s]
LLregs: checks
Kamylo20: bets $0.11
LLregs: folds
Uncalled bet ($0.11) returned to Kamylo20
Kamylo20 collected $0.14 from pot
Kamylo20: doesn't show hand
*** SUMMARY ***
Total pot $0.15 | Rake $0.01
Board [5c 4h 3s]
Seat 1: Shizukas104 (button) folded before Flop (didn't bet)
Seat 2: pillopk (small blind) folded before Flop
Seat 3: 50 vs 50 (big blind) folded before Flop
Seat 4: LLregs folded on the Flop
Seat 5: NovatoHn folded before Flop (didn't bet)
Seat 6: Kamylo20 collected ($0.14)

PokerStars Zoom Hand #247964532867:  Hold'em No Limit ($0.01/$0.02) - 2023/12/30 19:20:44 WET [2023/12/30 14:20:44 ET]
Table 'Halley' 6-max Seat #1 is the button
Seat 1: yuzu0921 ($1.94 in chips)
Seat 2: Niinowa ($1.15 in chips)
Seat 3: Shizukas104 ($2.44 in chips)
Seat 4: LLregs ($2.83 in chips)
Seat 5: xTheBulletsx ($2.44 in chips)
Seat 6: napoli222 ($2.73 in chips)
Niinowa: posts small blind $0.01
Shizukas104: posts big blind $0.02
*** HOLE CARDS ***
Dealt to LLregs [Qs 4s]
LLregs: folds
xTheBulletsx: folds
napoli222: folds
yuzu0921: folds
Niinowa: folds
Uncalled bet ($0.01) returned to Shizukas104
Shizukas104 collected $0.02 from pot
Shizukas104: doesn't show hand
*** SUMMARY ***
Total pot $0.02 | Rake $0
Seat 1: yuzu0921 (button) folded before Flop (didn't bet)
Seat 2: Niinowa (small blind) folded before Flop
Seat 3: Shizukas104 (big blind) collected ($0.02)
Seat 4: LLregs folded before Flop (didn't bet)
Seat 5: xTheBulletsx folded before Flop (didn't bet)
Seat 6: napoli222 folded before Flop (didn't bet)

PokerStars Zoom Hand #247964534411:  Hold'em No Limit ($0.01/$0.02) - 2023/12/30 19:20:48 WET [2023/12/30 14:20:48 ET]
Table 'Halley' 6-max Seat #1 is the button
Seat 1: tony_extreme ($1.75 in chips)
Seat 2: nuttymuch ($5.24 in chips)
Seat 3: mangalisa ($2 in chips)
Seat 4: RocketFir271 ($2.20 in chips)
Seat 5: JOG@DOR1013 ($2.06 in chips)
Seat 6: LLregs ($2.83 in chips)
nuttymuch: posts small blind $0.01
mangalisa: posts big blind $0.02
*** HOLE CARDS ***
Dealt to LLregs [9c Ac]
RocketFir271: folds
JOG@DOR1013: folds
LLregs: raises $0.02 to $0.04
tony_extreme: calls $0.04
nuttymuch: folds
mangalisa: calls $0.02
*** FLOP *** [Qs Kh Qh]
mangalisa: checks
LLregs: checks
tony_extreme: checks
*** TURN *** [Qs Kh Qh] [Ad]
mangalisa: bets $0.13
LLregs: calls $0.13
tony_extreme: folds
*** RIVER *** [Qs Kh Qh Ad] [2d]
mangalisa: bets $0.19
LLregs: calls $0.19
*** SHOW DOWN ***
mangalisa: shows [Jc Qd] (three of a kind, Queens)
LLregs: mucks hand
mangalisa collected $0.74 from pot
*** SUMMARY ***
Total pot $0.77 | Rake $0.03
Board [Qs Kh Qh Ad 2d]
Seat 1: tony_extreme (button) folded on the Turn
Seat 2: nuttymuch (small blind) folded before Flop
Seat 3: mangalisa (big blind) showed [Jc Qd] and won ($0.74) with three of a kind, Queens
Seat 4: RocketFir271 folded before Flop (didn't bet)
Seat 5: JOG@DOR1013 folded before Flop (didn't bet)
Seat 6: LLregs mucked [9c Ac]

PokerStars Zoom Hand #247964552636:  Hold'em No Limit ($0.01/$0.02) - 2023/12/30 19:21:36 WET [2023/12/30 14:21:36 ET]
Table 'Halley' 6-max Seat #1 is the button
Seat 1: Dr.Erguen ($2.15 in chips)
Seat 2: PRrey ($3.37 in chips)
Seat 3: conspy84 ($1.47 in chips)
Seat 4: LucasLMdS ($4.98 in chips)
Seat 5: LLregs ($2.46 in chips)
Seat 6: ginobili666 ($3.04 in chips)
PRrey: posts small blind $0.01
conspy84: posts big blind $0.02
*** HOLE CARDS ***
Dealt to LLregs [2s Jh]
LucasLMdS: raises $0.03 to $0.05
LLregs: folds
ginobili666: folds
Dr.Erguen: folds
PRrey: folds
conspy84: folds
Uncalled bet ($0.03) returned to LucasLMdS
LucasLMdS collected $0.05 from pot
LucasLMdS: doesn't show hand
*** SUMMARY ***
Total pot $0.05 | Rake $0
Seat 1: Dr.Erguen (button) folded before Flop (didn't bet)
Seat 2: PRrey (small blind) folded before Flop
Seat 3: conspy84 (big blind) folded before Flop
Seat 4: LucasLMdS collected ($0.05)
Seat 5: LLregs folded before Flop (didn't bet)
Seat 6: ginobili666 folded before Flop (didn't bet)

PokerStars Zoom Hand #247964554924:  Hold'em No Limit ($0.01/$0.02) - 2023/12/30 19:21:42 WET [2023/12/30 14:21:42 ET]
Table 'Halley' 6-max Seat #1 is the button
Seat 1: lacost_blr ($2.96 in chips)
Seat 2: Lezcano101 ($2.11 in chips)
Seat 3: JaUm_V ($6.16 in chips)
Seat 4: LLregs ($2.46 in chips)
Seat 5: Balonas ($2.70 in chips)
Seat 6: lapoleka ($2.06 in chips)
Lezcano101: posts small blind $0.01
JaUm_V: posts big blind $0.02
*** HOLE CARDS ***
Dealt to LLregs [8h 2h]
LLregs: folds
Balonas: folds
lapoleka: folds
lacost_blr: folds
Lezcano101: folds
Uncalled bet ($0.01) returned to JaUm_V
JaUm_V collected $0.02 from pot
JaUm_V: doesn't show hand
*** SUMMARY ***
Total pot $0.02 | Rake $0
Seat 1: lacost_blr (button) folded before Flop (didn't bet)
Seat 2: Lezcano101 (small blind) folded before Flop
Seat 3: JaUm_V (big blind) collected ($0.02)
Seat 4: LLregs folded before Flop (didn't bet)
Seat 5: Balonas folded before Flop (didn't bet)
Seat 6: lapoleka folded before Flop (didn't bet)

PokerStars Zoom Hand #247964556793:  Hold'em No Limit ($0.01/$0.02) - 2023/12/30 19:21:46 WET [2023/12/30 14:21:46 ET]
Table 'Halley' 6-max Seat #1 is the button
Seat 1: LLregs ($2.46 in chips)
Seat 2: SKV_1985 ($2 in chips)
Seat 3: Dimoni797979 ($0.76 in chips)
Seat 4: ds_pearce2 ($3.02 in chips)
Seat 5: sorokin21 ($2.01 in chips)
Seat 6: hicmanboss ($3.71 in chips)
SKV_1985: posts small blind $0.01
Dimoni797979: posts big blind $0.02
*** HOLE CARDS ***
Dealt to LLregs [Jc Js]
ds_pearce2: folds
sorokin21: folds
hicmanboss: folds
LLregs: raises $0.04 to $0.06
SKV_1985: folds
Dimoni797979: folds
Uncalled bet ($0.04) returned to LLregs
LLregs collected $0.05 from pot
LLregs: doesn't show hand
*** SUMMARY ***
Total pot $0.05 | Rake $0
Seat 1: LLregs (button) collected ($0.05)
Seat 2: SKV_1985 (small blind) folded before Flop
Seat 3: Dimoni797979 (big blind) folded before Flop
Seat 4: ds_pearce2 folded before Flop (didn't bet)
Seat 5: sorokin21 folded before Flop (didn't bet)
Seat 6: hicmanboss folded before Flop (didn't bet)

PokerStars Zoom Hand #247964550381:  Hold'em No Limit ($0.01/$0.02) - 2023/12/30 19:21:30 WET [2023/12/30 14:21:30 ET]
Table 'Halley' 6-max Seat #1 is the button
Seat 1: timsah70 ($1.70 in chips)
Seat 2: LLregs ($2.47 in chips)
Seat 3: 888lifeIS ($2.03 in chips)
Seat 4: Naildey ($2.83 in chips)
Seat 5: 010011100100 ($2 in chips)
Seat 6: Devilfishtheone ($2.39 in chips)
LLregs: posts small blind $0.01
888lifeIS: posts big blind $0.02
*** HOLE CARDS ***
Dealt to LLregs [Qc 8h]
Naildey: folds
010011100100: raises $0.03 to $0.05
Devilfishtheone: folds
timsah70: calls $0.05
LLregs: folds
888lifeIS: folds
*** FLOP *** [Tc 7h 3d]
010011100100: bets $0.10
timsah70: folds
Uncalled bet ($0.10) returned to 010011100100
010011100100 collected $0.13 from pot
010011100100: doesn't show hand
*** SUMMARY ***
Total pot $0.13 | Rake $0
Board [Tc 7h 3d]
Seat 1: timsah70 (button) folded on the Flop
Seat 2: LLregs (small blind) folded before Flop
Seat 3: 888lifeIS (big blind) folded before Flop
Seat 4: Naildey folded before Flop (didn't bet)
Seat 5: 010011100100 collected ($0.13)
Seat 6: Devilfishtheone folded before Flop (didn't bet)

PokerStars Zoom Hand #247964562590:  Hold'em No Limit ($0.01/$0.02) - 2023/12/30 19:22:02 WET [2023/12/30 14:22:02 ET]
Table 'Halley' 6-max Seat #1 is the button
Seat 1: xTheBulletsx ($2.58 in chips)
Seat 2: Loucomeloo ($2.22 in chips)
Seat 3: LLregs ($2.49 in chips)
Seat 4: GeRA XG ($2.01 in chips)
Seat 5: CaptainB1ack ($2.23 in chips)
Seat 6: Gibsondelux ($1.04 in chips)
Loucomeloo: posts small blind $0.01
LLregs: posts big blind $0.02
*** HOLE CARDS ***
Dealt to LLregs [4h 6h]
GeRA XG: folds
CaptainB1ack: folds
Gibsondelux: folds
xTheBulletsx: raises $0.03 to $0.05
Loucomeloo: folds
LLregs: folds
Uncalled bet ($0.03) returned to xTheBulletsx
xTheBulletsx collected $0.05 from pot
xTheBulletsx: doesn't show hand
*** SUMMARY ***
Total pot $0.05 | Rake $0
Seat 1: xTheBulletsx (button) collected ($0.05)
Seat 2: Loucomeloo (small blind) folded before Flop
Seat 3: LLregs (big blind) folded before Flop
Seat 4: GeRA XG folded before Flop (didn't bet)
Seat 5: CaptainB1ack folded before Flop (didn't bet)
Seat 6: Gibsondelux folded before Flop (didn't bet)

PokerStars Zoom Hand #247964580064:  Hold'em No Limit ($0.01/$0.02) - 2023/12/30 19:22:47 WET [2023/12/30 14:22:47 ET]
Table 'Halley' 6-max Seat #1 is the button
Seat 1: Shizukas104 ($2.51 in chips)
Seat 2: Balonas ($3.35 in chips)
Seat 3: nestor-ruso ($5.64 in chips)
Seat 4: Slava Gvozdev ($1.50 in chips)
Seat 5: 50 vs 50 ($2.72 in chips)
Seat 6: LLregs ($2.46 in chips)
Balonas: posts small blind $0.01
nestor-ruso: posts big blind $0.02
*** HOLE CARDS ***
Dealt to LLregs [4h Ks]
Slava Gvozdev: folds
50 vs 50: folds
LLregs: folds
Shizukas104: folds
Balonas: folds
Uncalled bet ($0.01) returned to nestor-ruso
nestor-ruso collected $0.02 from pot
nestor-ruso: doesn't show hand
*** SUMMARY ***
Total pot $0.02 | Rake $0
Seat 1: Shizukas104 (button) folded before Flop (didn't bet)
Seat 2: Balonas (small blind) folded before Flop
Seat 3: nestor-ruso (big blind) collected ($0.02)
Seat 4: Slava Gvozdev folded before Flop (didn't bet)
Seat 5: 50 vs 50 folded before Flop (didn't bet)
Seat 6: LLregs folded before Flop (didn't bet)

PokerStars Zoom Hand #247964568415:  Hold'em No Limit ($0.01/$0.02) - 2023/12/30 19:22:17 WET [2023/12/30 14:22:17 ET]
Table 'Halley' 6-max Seat #1 is the button
Seat 1: Alanxx77 ($5.52 in chips)
Seat 2: kosatkazostravy ($2.28 in chips)
Seat 3: jcousin79 ($1 in chips)
Seat 4: Loucomeloo ($2.19 in chips)
Seat 5: jandsonpower ($3.74 in chips)
Seat 6: LLregs ($2.47 in chips)
kosatkazostravy: posts small blind $0.01
jcousin79: posts big blind $0.02
*** HOLE CARDS ***
Dealt to LLregs [Ad 6d]
Loucomeloo: raises $0.03 to $0.05
jandsonpower: folds
LLregs: folds
Alanxx77: folds
kosatkazostravy: folds
jcousin79: calls $0.03
*** FLOP *** [9s Ah 6s]
jcousin79: bets $0.02
Loucomeloo: raises $0.10 to $0.12
jcousin79: calls $0.10
*** TURN *** [9s Ah 6s] [7h]
jcousin79: bets $0.02
Loucomeloo: calls $0.02
*** RIVER *** [9s Ah 6s 7h] [8c]
jcousin79: bets $0.02
Loucomeloo: calls $0.02
*** SHOW DOWN ***
jcousin79: shows [Kc As] (a pair of Aces)
Loucomeloo: shows [Ac 6c] (two pair, Aces and Sixes)
Loucomeloo collected $0.41 from pot
*** SUMMARY ***
Total pot $0.43 | Rake $0.02
Board [9s Ah 6s 7h 8c]
Seat 1: Alanxx77 (button) folded before Flop (didn't bet)
Seat 2: kosatkazostravy (small blind) folded before Flop
Seat 3: jcousin79 (big blind) showed [Kc As] and lost with a pair of Aces
Seat 4: Loucomeloo showed [Ac 6c] and won ($0.41) with two pair, Aces and Sixes
Seat 5: jandsonpower folded before Flop (didn't bet)
Seat 6: LLregs folded before Flop (didn't bet)

PokerStars Zoom Hand #247964581584:  Hold'em No Limit ($0.01/$0.02) - 2023/12/30 19:22:51 WET [2023/12/30 14:22:51 ET]
Table 'Halley' 6-max Seat #1 is the button
Seat 1: LDenisL ($2.17 in chips)
Seat 2: alexad05 ($2.09 in chips)
Seat 3: cachusky ($2 in chips)
Seat 4: piterpank31 ($2.15 in chips)
Seat 5: LLregs ($2.46 in chips)
Seat 6: Fig0uu ($2.99 in chips)
alexad05: posts small blind $0.01
cachusky: posts big blind $0.02
*** HOLE CARDS ***
Dealt to LLregs [3s Ks]
piterpank31: folds
LLregs: folds
Fig0uu: folds
LDenisL: raises $0.02 to $0.04
alexad05: folds
cachusky: folds
Uncalled bet ($0.02) returned to LDenisL
LDenisL collected $0.05 from pot
LDenisL: doesn't show hand
*** SUMMARY ***
Total pot $0.05 | Rake $0
Seat 1: LDenisL (button) collected ($0.05)
Seat 2: alexad05 (small blind) folded before Flop
Seat 3: cachusky (big blind) folded before Flop
Seat 4: piterpank31 folded before Flop (didn't bet)
Seat 5: LLregs folded before Flop (didn't bet)
Seat 6: Fig0uu folded before Flop (didn't bet)

PokerStars Zoom Hand #247964576591:  Hold'em No Limit ($0.01/$0.02) - 2023/12/30 19:22:38 WET [2023/12/30 14:22:38 ET]
Table 'Halley' 6-max Seat #1 is the button
Seat 1: Arabescul ($2.31 in chips)
Seat 2: LLregs ($2.47 in chips)
Seat 3: JaUm_V ($3.75 in chips)
Seat 4: Ceesel ($1.83 in chips)
Seat 5: akima777 ($1.94 in chips)
Seat 6: dsousAA ($2.09 in chips)
LLregs: posts small blind $0.01
JaUm_V: posts big blind $0.02
*** HOLE CARDS ***
Dealt to LLregs [3s Qd]
Ceesel: folds
akima777: folds
dsousAA: folds
Arabescul: raises $0.03 to $0.05
LLregs: folds
JaUm_V: folds
Uncalled bet ($0.03) returned to Arabescul
Arabescul collected $0.05 from pot
Arabescul: doesn't show hand
*** SUMMARY ***
Total pot $0.05 | Rake $0
Seat 1: Arabescul (button) collected ($0.05)
Seat 2: LLregs (small blind) folded before Flop
Seat 3: JaUm_V (big blind) folded before Flop
Seat 4: Ceesel folded before Flop (didn't bet)
Seat 5: akima777 folded before Flop (didn't bet)
Seat 6: dsousAA folded before Flop (didn't bet)

PokerStars Zoom Hand #247964578740:  Hold'em No Limit ($0.01/$0.02) - 2023/12/30 19:22:43 WET [2023/12/30 14:22:43 ET]
Table 'Halley' 6-max Seat #1 is the button
Seat 1: LLregs ($2.46 in chips)
Seat 2: davidbarrels ($2.89 in chips)
Seat 3: rowingboy ($4.63 in chips)
Seat 4: zielony ($3.40 in chips)
Seat 5: napoli222 ($2.03 in chips)
Seat 6: cubaflash1 ($1.90 in chips)
davidbarrels: posts small blind $0.01
rowingboy: posts big blind $0.02
*** HOLE CARDS ***
Dealt to LLregs [Tc 5s]
zielony: folds
napoli222: folds
cubaflash1: folds
LLregs: folds
davidbarrels: raises $0.04 to $0.06
rowingboy: calls $0.04
*** FLOP *** [8d Ah 7h]
davidbarrels: bets $0.06
rowingboy: folds
Uncalled bet ($0.06) returned to davidbarrels
davidbarrels collected $0.12 from pot
davidbarrels: doesn't show hand
*** SUMMARY ***
Total pot $0.12 | Rake $0
Board [8d Ah 7h]
Seat 1: LLregs (button) folded before Flop (didn't bet)
Seat 2: davidbarrels (small blind) collected ($0.12)
Seat 3: rowingboy (big blind) folded on the Flop
Seat 4: zielony folded before Flop (didn't bet)
Seat 5: napoli222 folded before Flop (didn't bet)
Seat 6: cubaflash1 folded before Flop (didn't bet)

PokerStars Zoom Hand #247964583498:  Hold'em No Limit ($0.01/$0.02) - 2023/12/30 19:22:56 WET [2023/12/30 14:22:56 ET]
Table 'Halley' 6-max Seat #1 is the button
Seat 1: conspy84 ($2 in chips)
Seat 2: LLregs ($2.46 in chips)
Seat 3: begui150507 ($3.40 in chips)
Seat 4: 888lifeIS ($2.29 in chips)
Seat 5: TEDDYHOT69 ($3.84 in chips)
Seat 6: Balonas ($3.34 in chips)
LLregs: posts small blind $0.01
begui150507: posts big blind $0.02
*** HOLE CARDS ***
Dealt to LLregs [Ad 3d]
888lifeIS: raises $0.02 to $0.04
TEDDYHOT69: folds
Balonas: folds
conspy84: folds
LLregs: raises $0.08 to $0.12
begui150507: folds
888lifeIS: calls $0.08
*** FLOP *** [Jh 8d 8s]
LLregs: bets $0.12
888lifeIS: folds
Uncalled bet ($0.12) returned to LLregs
LLregs collected $0.25 from pot
LLregs: doesn't show hand
*** SUMMARY ***
Total pot $0.26 | Rake $0.01
Board [Jh 8d 8s]
Seat 1: conspy84 (button) folded before Flop (didn't bet)
Seat 2: LLregs (small blind) collected ($0.25)
Seat 3: begui150507 (big blind) folded before Flop
Seat 4: 888lifeIS folded on the Flop
Seat 5: TEDDYHOT69 folded before Flop (didn't bet)
Seat 6: Balonas folded before Flop (didn't bet)

PokerStars Zoom Hand #247964594842:  Hold'em No Limit ($0.01/$0.02) - 2023/12/30 19:23:25 WET [2023/12/30 14:23:25 ET]
Table 'Halley' 6-max Seat #1 is the button
Seat 1: sharike22 ($1.68 in chips)
Seat 2: G1olight ($2.63 in chips)
Seat 3: LLregs ($2.59 in chips)
Seat 4: 888lifeIS ($3.21 in chips)
Seat 5: Kamylo20 ($2.53 in chips)
Seat 6: scurvy idler ($2.83 in chips)
G1olight: posts small blind $0.01
LLregs: posts big blind $0.02
*** HOLE CARDS ***
Dealt to LLregs [4s Ac]
888lifeIS: folds
Kamylo20: folds
scurvy idler: folds
sharike22: folds
G1olight: folds
Uncalled bet ($0.01) returned to LLregs
LLregs collected $0.02 from pot
LLregs: doesn't show hand
*** SUMMARY ***
Total pot $0.02 | Rake $0
Seat 1: sharike22 (button) folded before Flop (didn't bet)
Seat 2: G1olight (small blind) folded before Flop
Seat 3: LLregs (big blind) collected ($0.02)
Seat 4: 888lifeIS folded before Flop (didn't bet)
Seat 5: Kamylo20 folded before Flop (didn't bet)
Seat 6: scurvy idler folded before Flop (didn't bet)

PokerStars Zoom Hand #247964575071:  Hold'em No Limit ($0.01/$0.02) - 2023/12/30 19:22:34 WET [2023/12/30 14:22:34 ET]
Table 'Halley' 6-max Seat #1 is the button
Seat 1: Timo_H922 ($2.25 in chips)
Seat 2: pawelllo1 ($5.30 in chips)
Seat 3: mangalisa ($3.32 in chips)
Seat 4: LLregs ($2.47 in chips)
Seat 5: malytiger ($2.17 in chips)
Seat 6: Shizukas104 ($2.24 in chips)
pawelllo1: posts small blind $0.01
mangalisa: posts big blind $0.02
*** HOLE CARDS ***
Dealt to LLregs [4c 7c]
LLregs: folds
malytiger: folds
Shizukas104: raises $0.03 to $0.05
Timo_H922: calls $0.05
pawelllo1: folds
mangalisa: calls $0.03
*** FLOP *** [Tc 7s Ac]
mangalisa: checks
Shizukas104: checks
Timo_H922: checks
*** TURN *** [Tc 7s Ac] [3s]
mangalisa: checks
Shizukas104: checks
Timo_H922: checks
*** RIVER *** [Tc 7s Ac 3s] [7h]
mangalisa: checks
Shizukas104: checks
Timo_H922: checks
*** SHOW DOWN ***
mangalisa: shows [2h 2s] (two pair, Sevens and Deuces)
Shizukas104: mucks hand
Timo_H922: shows [6d 6s] (two pair, Sevens and Sixes)
Timo_H922 collected $0.15 from pot
*** SUMMARY ***
Total pot $0.16 | Rake $0.01
Board [Tc 7s Ac 3s 7h]
Seat 1: Timo_H922 (button) showed [6d 6s] and won ($0.15) with two pair, Sevens and Sixes
Seat 2: pawelllo1 (small blind) folded before Flop
Seat 3: mangalisa (big blind) showed [2h 2s] and lost with two pair, Sevens and Deuces
Seat 4: LLregs folded before Flop (didn't bet)
Seat 5: malytiger folded before Flop (didn't bet)
Seat 6: Shizukas104 mucked [Jd Qs]

PokerStars Zoom Hand #247964599448:  Hold'em No Limit ($0.01/$0.02) - 2023/12/30 19:23:37 WET [2023/12/30 14:23:37 ET]
Table 'Halley' 6-max Seat #1 is the button
Seat 1: LLregs ($2.60 in chips)
Seat 2: Lezcano101 ($2.12 in chips)
Seat 3: 5let dr ($4.11 in chips)
Seat 4: Kamylo20 ($2.28 in chips)
Seat 5: Tricks969 ($1.41 in chips)
Seat 6: HarryHaller77 ($2.03 in chips)
Lezcano101: posts small blind $0.01
5let dr: posts big blind $0.02
*** HOLE CARDS ***
Dealt to LLregs [3c Td]
Kamylo20: folds
Tricks969: calls $0.02
HarryHaller77: raises $0.07 to $0.09
LLregs: folds
Lezcano101: folds
5let dr: folds
Tricks969: calls $0.07
*** FLOP *** [3h 4d 8d]
Tricks969: checks
HarryHaller77: bets $0.07
Tricks969: folds
Uncalled bet ($0.07) returned to HarryHaller77
HarryHaller77 collected $0.20 from pot
HarryHaller77: doesn't show hand
*** SUMMARY ***
Total pot $0.21 | Rake $0.01
Board [3h 4d 8d]
Seat 1: LLregs (button) folded before Flop (didn't bet)
Seat 2: Lezcano101 (small blind) folded before Flop
Seat 3: 5let dr (big blind) folded before Flop
Seat 4: Kamylo20 folded before Flop (didn't bet)
Seat 5: Tricks969 folded on the Flop
Seat 6: HarryHaller77 collected ($0.20)

PokerStars Zoom Hand #247964600986:  Hold'em No Limit ($0.01/$0.02) - 2023/12/30 19:23:41 WET [2023/12/30 14:23:41 ET]
Table 'Halley' 6-max Seat #1 is the button
Seat 1: piterpank31 ($2 in chips)
Seat 2: 888lifeIS ($2.25 in chips)
Seat 3: LLregs ($2.60 in chips)
Seat 4: batya1212 ($3.12 in chips)
Seat 5: McLaude669 ($1.62 in chips)
Seat 6: ssolruoy ($1.66 in chips)
888lifeIS: posts small blind $0.01
LLregs: posts big blind $0.02
*** HOLE CARDS ***
Dealt to LLregs [Ad 8s]
batya1212: folds
McLaude669: raises $0.02 to $0.04
ssolruoy: folds
piterpank31: folds
888lifeIS: folds
LLregs: calls $0.02
*** FLOP *** [Ks Td 5s]
LLregs: checks
McLaude669: bets $0.04
LLregs: folds
Uncalled bet ($0.04) returned to McLaude669
McLaude669 collected $0.09 from pot
McLaude669: doesn't show hand
*** SUMMARY ***
Total pot $0.09 | Rake $0
Board [Ks Td 5s]
Seat 1: piterpank31 (button) folded before Flop (didn't bet)
Seat 2: 888lifeIS (small blind) folded before Flop
Seat 3: LLregs (big blind) folded on the Flop
Seat 4: batya1212 folded before Flop (didn't bet)
Seat 5: McLaude669 collected ($0.09)
Seat 6: ssolruoy folded before Flop (didn't bet)

PokerStars Zoom Hand #247964597877:  Hold'em No Limit ($0.01/$0.02) - 2023/12/30 19:23:33 WET [2023/12/30 14:23:33 ET]
Table 'Halley' 6-max Seat #1 is the button
Seat 1: aricast19 ($2 in chips)
Seat 2: Agneobr ($1.78 in chips)
Seat 3: zielony ($3.80 in chips)
Seat 4: Ukr Troll ($7.02 in chips)
Seat 5: LLregs ($2.60 in chips)
Seat 6: Tricks969 ($1.41 in chips)
Agneobr: posts small blind $0.01
zielony: posts big blind $0.02
*** HOLE CARDS ***
Dealt to LLregs [6d Ks]
Ukr Troll: raises $0.02 to $0.04
LLregs: folds
Tricks969: folds
aricast19: raises $0.12 to $0.16
Agneobr: folds
zielony: folds
Ukr Troll: calls $0.12
*** FLOP *** [6h 3h Ac]
Ukr Troll: checks
aricast19: checks
*** TURN *** [6h 3h Ac] [3d]
Ukr Troll: checks
aricast19: checks
*** RIVER *** [6h 3h Ac 3d] [4d]
Ukr Troll: checks
aricast19: checks
*** SHOW DOWN ***
Ukr Troll: shows [2c 4c] (two pair, Fours and Threes)
aricast19: mucks hand
Ukr Troll collected $0.34 from pot
*** SUMMARY ***
Total pot $0.35 | Rake $0.01
Board [6h 3h Ac 3d 4d]
Seat 1: aricast19 (button) mucked [Kd Qd]
Seat 2: Agneobr (small blind) folded before Flop
Seat 3: zielony (big blind) folded before Flop
Seat 4: Ukr Troll showed [2c 4c] and won ($0.34) with two pair, Fours and Threes
Seat 5: LLregs folded before Flop (didn't bet)
Seat 6: Tricks969 folded before Flop (didn't bet)

PokerStars Zoom Hand #247964610954:  Hold'em No Limit ($0.01/$0.02) - 2023/12/30 19:24:06 WET [2023/12/30 14:24:06 ET]
Table 'Halley' 6-max Seat #1 is the button
Seat 1: allia_cz ($5.89 in chips)
Seat 2: dgage8 ($2.01 in chips)
Seat 3: TheOliver ($8.49 in chips)
Seat 4: LLregs ($2.56 in chips)
Seat 5: Ceesel ($1.95 in chips)
Seat 6: MeisterJedah ($6.21 in chips)
dgage8: posts small blind $0.01
TheOliver: posts big blind $0.02
*** HOLE CARDS ***
Dealt to LLregs [5h Jd]
LLregs: folds
Ceesel: raises $0.03 to $0.05
MeisterJedah: folds
allia_cz: folds
dgage8: raises $0.13 to $0.18
TheOliver: folds
Ceesel: folds
Uncalled bet ($0.13) returned to dgage8
dgage8 collected $0.12 from pot
dgage8: doesn't show hand
*** SUMMARY ***
Total pot $0.12 | Rake $0
Seat 1: allia_cz (button) folded before Flop (didn't bet)
Seat 2: dgage8 (small blind) collected ($0.12)
Seat 3: TheOliver (big blind) folded before Flop
Seat 4: LLregs folded before Flop (didn't bet)
Seat 5: Ceesel folded before Flop
Seat 6: MeisterJedah folded before Flop (didn't bet)

PokerStars Zoom Hand #247964614009:  Hold'em No Limit ($0.01/$0.02) - 2023/12/30 19:24:14 WET [2023/12/30 14:24:14 ET]
Table 'Halley' 6-max Seat #1 is the button
Seat 1: marcegring ($2.64 in chips)
Seat 2: LLregs ($2.56 in chips)
Seat 3: thiah_b14 ($0.88 in chips)
Seat 4: dgage8 ($2.13 in chips)
Seat 5: broks01 ($2.53 in chips)
Seat 6: Cigarrinh0 ($2 in chips)
LLregs: posts small blind $0.01
thiah_b14: posts big blind $0.02
*** HOLE CARDS ***
Dealt to LLregs [2d Ks]
dgage8: folds
broks01: folds
Cigarrinh0: folds
marcegring: folds
LLregs: folds
Uncalled bet ($0.01) returned to thiah_b14
thiah_b14 collected $0.02 from pot
thiah_b14: doesn't show hand
*** SUMMARY ***
Total pot $0.02 | Rake $0
Seat 1: marcegring (button) folded before Flop (didn't bet)
Seat 2: LLregs (small blind) folded before Flop
Seat 3: thiah_b14 (big blind) collected ($0.02)
Seat 4: dgage8 folded before Flop (didn't bet)
Seat 5: broks01 folded before Flop (didn't bet)
Seat 6: Cigarrinh0 folded before Flop (didn't bet)

PokerStars Zoom Hand #247964612449:  Hold'em No Limit ($0.01/$0.02) - 2023/12/30 19:24:10 WET [2023/12/30 14:24:10 ET]
Table 'Halley' 6-max Seat #1 is the button
Seat 1: 50 vs 50 ($2.68 in chips)
Seat 2: nuttymuch ($3.89 in chips)
Seat 3: leedsrounder ($2.55 in chips)
Seat 4: Shmatrixs ($1.78 in chips)
Seat 5: KrenkySpenky ($1.65 in chips)
Seat 6: LLregs ($2.56 in chips)
nuttymuch: posts small blind $0.01
leedsrounder: posts big blind $0.02
*** HOLE CARDS ***
Dealt to LLregs [6c Kh]
Shmatrixs: folds
KrenkySpenky: folds
LLregs: folds
50 vs 50: folds
nuttymuch: raises $0.04 to $0.06
leedsrounder: folds
Uncalled bet ($0.04) returned to nuttymuch
nuttymuch collected $0.04 from pot
nuttymuch: doesn't show hand
*** SUMMARY ***
Total pot $0.04 | Rake $0
Seat 1: 50 vs 50 (button) folded before Flop (didn't bet)
Seat 2: nuttymuch (small blind) collected ($0.04)
Seat 3: leedsrounder (big blind) folded before Flop
Seat 4: Shmatrixs folded before Flop (didn't bet)
Seat 5: KrenkySpenky folded before Flop (didn't bet)
Seat 6: LLregs folded before Flop (didn't bet)

PokerStars Zoom Hand #247964617927:  Hold'em No Limit ($0.01/$0.02) - 2023/12/30 19:24:24 WET [2023/12/30 14:24:24 ET]
Table 'Halley' 6-max Seat #1 is the button
Seat 1: LLregs ($2.55 in chips)
Seat 2: LionKing2330 ($3.56 in chips)
Seat 3: frankquanki ($1.51 in chips)
Seat 4: N0tsobig ($3.96 in chips)
Seat 5: SniperMurph ($2.03 in chips)
Seat 6: GeRA XG ($0.50 in chips)
LionKing2330: posts small blind $0.01
frankquanki: posts big blind $0.02
*** HOLE CARDS ***
Dealt to LLregs [5s Jh]
N0tsobig: folds
SniperMurph: folds
GeRA XG: folds
LLregs: folds
LionKing2330: raises $0.02 to $0.04
frankquanki: folds
Uncalled bet ($0.02) returned to LionKing2330
LionKing2330 collected $0.04 from pot
LionKing2330: doesn't show hand
*** SUMMARY ***
Total pot $0.04 | Rake $0
Seat 1: LLregs (button) folded before Flop (didn't bet)
Seat 2: LionKing2330 (small blind) collected ($0.04)
Seat 3: frankquanki (big blind) folded before Flop
Seat 4: N0tsobig folded before Flop (didn't bet)
Seat 5: SniperMurph folded before Flop (didn't bet)
Seat 6: GeRA XG folded before Flop (didn't bet)

PokerStars Zoom Hand #247964622028:  Hold'em No Limit ($0.01/$0.02) - 2023/12/30 19:24:35 WET [2023/12/30 14:24:35 ET]
Table 'Halley' 6-max Seat #1 is the button
Seat 1: SKV_1985 ($2.92 in chips)
Seat 2: Arabescul ($2.35 in chips)
Seat 3: BadBeat Bert ($1.05 in chips)
Seat 4: Balonas ($3.36 in chips)
Seat 5: LLregs ($2.55 in chips)
Seat 6: JaUm_V ($7.43 in chips)
Arabescul: posts small blind $0.01
BadBeat Bert: posts big blind $0.02
*** HOLE CARDS ***
Dealt to LLregs [Ks Ad]
Balonas: folds
LLregs: raises $0.04 to $0.06
JaUm_V: folds
SKV_1985: folds
Arabescul: folds
BadBeat Bert: folds
Uncalled bet ($0.04) returned to LLregs
LLregs collected $0.05 from pot
LLregs: doesn't show hand
*** SUMMARY ***
Total pot $0.05 | Rake $0
Seat 1: SKV_1985 (button) folded before Flop (didn't bet)
Seat 2: Arabescul (small blind) folded before Flop
Seat 3: BadBeat Bert (big blind) folded before Flop
Seat 4: Balonas folded before Flop (didn't bet)
Seat 5: LLregs collected ($0.05)
Seat 6: JaUm_V folded before Flop (didn't bet)

PokerStars Zoom Hand #247964627220:  Hold'em No Limit ($0.01/$0.02) - 2023/12/30 19:24:48 WET [2023/12/30 14:24:48 ET]
Table 'Halley' 6-max Seat #1 is the button
Seat 1: djmcool ($2 in chips)
Seat 2: alexad05 ($2.22 in chips)
Seat 3: 1977Beno ($2 in chips)
Seat 4: Swordfish_31 ($2.18 in chips)
Seat 5: nestor-ruso ($5.68 in chips)
Seat 6: LLregs ($2.58 in chips)
alexad05: posts small blind $0.01
1977Beno: posts big blind $0.02
*** HOLE CARDS ***
Dealt to LLregs [3s 3d]
Swordfish_31: folds
nestor-ruso: folds
LLregs: raises $0.04 to $0.06
djmcool: folds
alexad05: folds
1977Beno: calls $0.04
*** FLOP *** [7h Jd 4c]
1977Beno: checks
LLregs: checks
*** TURN *** [7h Jd 4c] [4s]
1977Beno: checks
LLregs: bets $0.03
1977Beno: calls $0.03
*** RIVER *** [7h Jd 4c 4s] [7s]
1977Beno: checks
LLregs: checks
*** SHOW DOWN ***
1977Beno: shows [Qh Ks] (two pair, Sevens and Fours)
LLregs: mucks hand
1977Beno collected $0.18 from pot
*** SUMMARY ***
Total pot $0.19 | Rake $0.01
Board [7h Jd 4c 4s 7s]
Seat 1: djmcool (button) folded before Flop (didn't bet)
Seat 2: alexad05 (small blind) folded before Flop
Seat 3: 1977Beno (big blind) showed [Qh Ks] and won ($0.18) with two pair, Sevens and Fours
Seat 4: Swordfish_31 folded before Flop (didn't bet)
Seat 5: nestor-ruso folded before Flop (didn't bet)
Seat 6: LLregs mucked [3s 3d]

PokerStars Zoom Hand #247964647131:  Hold'em No Limit ($0.01/$0.02) - 2023/12/30 19:25:39 WET [2023/12/30 14:25:39 ET]
Table 'Halley' 6-max Seat #1 is the button
Seat 1: plak69 ($4.75 in chips)
Seat 2: Jonatandamian ($2.90 in chips)
Seat 3: LLregs ($2.49 in chips)
Seat 4: djmcool ($2 in chips)
Seat 5: McLaude669 ($0.92 in chips)
Seat 6: JaUm_V ($3.63 in chips)
Jonatandamian: posts small blind $0.01
LLregs: posts big blind $0.02
*** HOLE CARDS ***
Dealt to LLregs [Ac 4h]
djmcool: folds
McLaude669: folds
JaUm_V: folds
plak69: raises $0.04 to $0.06
Jonatandamian: calls $0.05
LLregs: calls $0.04
*** FLOP *** [Kc Ts 7h]
Jonatandamian: checks
LLregs: checks
plak69: checks
*** TURN *** [Kc Ts 7h] [3s]
Jonatandamian: checks
LLregs: checks
plak69: bets $0.14
Jonatandamian: folds
LLregs: folds
Uncalled bet ($0.14) returned to plak69
plak69 collected $0.17 from pot
plak69: doesn't show hand
*** SUMMARY ***
Total pot $0.18 | Rake $0.01
Board [Kc Ts 7h 3s]
Seat 1: plak69 (button) collected ($0.17)
Seat 2: Jonatandamian (small blind) folded on the Turn
Seat 3: LLregs (big blind) folded on the Turn
Seat 4: djmcool folded before Flop (didn't bet)
Seat 5: McLaude669 folded before Flop (didn't bet)
Seat 6: JaUm_V folded before Flop (didn't bet)

PokerStars Zoom Hand #247964670452:  Hold'em No Limit ($0.01/$0.02) - 2023/12/30 19:26:39 WET [2023/12/30 14:26:39 ET]
Table 'Halley' 6-max Seat #1 is the button
Seat 1: krasivka416 ($1.22 in chips)
Seat 2: santogr893 ($4.09 in chips)
Seat 3: conspy84 ($1.57 in chips)
Seat 4: LLregs ($2.43 in chips)
Seat 5: GeRA XG ($2.14 in chips)
Seat 6: sharike22 ($1.75 in chips)
santogr893: posts small blind $0.01
conspy84: posts big blind $0.02
*** HOLE CARDS ***
Dealt to LLregs [9h 7c]
LLregs: folds
GeRA XG: folds
sharike22: folds
krasivka416: raises $0.04 to $0.06
santogr893: folds
conspy84: folds
Uncalled bet ($0.04) returned to krasivka416
krasivka416 collected $0.05 from pot
krasivka416: doesn't show hand
*** SUMMARY ***
Total pot $0.05 | Rake $0
Seat 1: krasivka416 (button) collected ($0.05)
Seat 2: santogr893 (small blind) folded before Flop
Seat 3: conspy84 (big blind) folded before Flop
Seat 4: LLregs folded before Flop (didn't bet)
Seat 5: GeRA XG folded before Flop (didn't bet)
Seat 6: sharike22 folded before Flop (didn't bet)

PokerStars Zoom Hand #247964671713:  Hold'em No Limit ($0.01/$0.02) - 2023/12/30 19:26:42 WET [2023/12/30 14:26:42 ET]
Table 'Halley' 6-max Seat #1 is the button
Seat 1: G1olight ($7.89 in chips)
Seat 2: napoli222 ($2.88 in chips)
Seat 3: plak69 ($4.86 in chips)
Seat 4: Japaixtos575 ($1.43 in chips)
Seat 5: LLregs ($2.43 in chips)
Seat 6: TheJunta ($2 in chips)
napoli222: posts small blind $0.01
plak69: posts big blind $0.02
*** HOLE CARDS ***
Dealt to LLregs [Td Tc]
Japaixtos575: folds
LLregs: raises $0.04 to $0.06
TheJunta: folds
G1olight: folds
napoli222: folds
plak69: folds
Uncalled bet ($0.04) returned to LLregs
LLregs collected $0.05 from pot
LLregs: doesn't show hand
*** SUMMARY ***
Total pot $0.05 | Rake $0
Seat 1: G1olight (button) folded before Flop (didn't bet)
Seat 2: napoli222 (small blind) folded before Flop
Seat 3: plak69 (big blind) folded before Flop
Seat 4: Japaixtos575 folded before Flop (didn't bet)
Seat 5: LLregs collected ($0.05)
Seat 6: TheJunta folded before Flop (didn't bet)

PokerStars Zoom Hand #247964678949:  Hold'em No Limit ($0.01/$0.02) - 2023/12/30 19:27:01 WET [2023/12/30 14:27:01 ET]
Table 'Halley' 6-max Seat #1 is the button
Seat 1: LLregs ($2.45 in chips)
Seat 2: joejordisson ($2.02 in chips)
Seat 3: Geneticgear ($0.27 in chips)
Seat 4: Plmax94 ($0.63 in chips)
Seat 5: Val'demar.ks ($0.82 in chips)
Seat 6: fukazapam ($4.17 in chips)
joejordisson: posts small blind $0.01
Geneticgear: posts big blind $0.02
*** HOLE CARDS ***
Dealt to LLregs [Tc 7s]
Plmax94: folds
Val'demar.ks: folds
fukazapam: folds
LLregs: raises $0.04 to $0.06
joejordisson: folds
Geneticgear: folds
Uncalled bet ($0.04) returned to LLregs
LLregs collected $0.05 from pot
LLregs: doesn't show hand
*** SUMMARY ***
Total pot $0.05 | Rake $0
Seat 1: LLregs (button) collected ($0.05)
Seat 2: joejordisson (small blind) folded before Flop
Seat 3: Geneticgear (big blind) folded before Flop
Seat 4: Plmax94 folded before Flop (didn't bet)
Seat 5: Val'demar.ks folded before Flop (didn't bet)
Seat 6: fukazapam folded before Flop (didn't bet)

PokerStars Zoom Hand #247964676843:  Hold'em No Limit ($0.01/$0.02) - 2023/12/30 19:26:56 WET [2023/12/30 14:26:56 ET]
Table 'Halley' 6-max Seat #1 is the button
Seat 1: djmcool ($2 in chips)
Seat 2: LLregs ($2.46 in chips)
Seat 3: A•R•D377™7 ($0.91 in chips)
Seat 4: SniperMurph ($2.31 in chips)
Seat 5: DarkRazer17 ($5.48 in chips)
Seat 6: jesterka20 ($0.96 in chips)
LLregs: posts small blind $0.01
A•R•D377™7: posts big blind $0.02
*** HOLE CARDS ***
Dealt to LLregs [8s 9h]
SniperMurph: raises $0.03 to $0.05
DarkRazer17: folds
jesterka20: folds
djmcool: calls $0.05
LLregs: folds
A•R•D377™7: calls $0.03
*** FLOP *** [6c 3h 2h]
A•R•D377™7: checks
SniperMurph: checks
djmcool: checks
*** TURN *** [6c 3h 2h] [3c]
A•R•D377™7: checks
SniperMurph: bets $0.11
djmcool: folds
A•R•D377™7: folds
Uncalled bet ($0.11) returned to SniperMurph
SniperMurph collected $0.15 from pot
SniperMurph: doesn't show hand
*** SUMMARY ***
Total pot $0.16 | Rake $0.01
Board [6c 3h 2h 3c]
Seat 1: djmcool (button) folded on the Turn
Seat 2: LLregs (small blind) folded before Flop
Seat 3: A•R•D377™7 (big blind) folded on the Turn
Seat 4: SniperMurph collected ($0.15)
Seat 5: DarkRazer17 folded before Flop (didn't bet)
Seat 6: jesterka20 folded before Flop (didn't bet)

PokerStars Zoom Hand #247964687599:  Hold'em No Limit ($0.01/$0.02) - 2023/12/30 19:27:23 WET [2023/12/30 14:27:23 ET]
Table 'Halley' 6-max Seat #1 is the button
Seat 1: Peresmehnik1 ($1.56 in chips)
Seat 2: Dranton73 ($2.07 in chips)
Seat 3: MassterD21 ($2.84 in chips)
Seat 4: LLregs ($2.48 in chips)
Seat 5: nuttymuch ($5.18 in chips)
Seat 6: pawelllo1 ($5.83 in chips)
Dranton73: posts small blind $0.01
MassterD21: posts big blind $0.02
*** HOLE CARDS ***
Dealt to LLregs [8h 5d]
LLregs: folds
nuttymuch: folds
pawelllo1: folds
Peresmehnik1: folds
Dranton73: raises $0.04 to $0.06
MassterD21: folds
Uncalled bet ($0.04) returned to Dranton73
Dranton73 collected $0.04 from pot
Dranton73: doesn't show hand
*** SUMMARY ***
Total pot $0.04 | Rake $0
Seat 1: Peresmehnik1 (button) folded before Flop (didn't bet)
Seat 2: Dranton73 (small blind) collected ($0.04)
Seat 3: MassterD21 (big blind) folded before Flop
Seat 4: LLregs folded before Flop (didn't bet)
Seat 5: nuttymuch folded before Flop (didn't bet)
Seat 6: pawelllo1 folded before Flop (didn't bet)

PokerStars Zoom Hand #247964689629:  Hold'em No Limit ($0.01/$0.02) - 2023/12/30 19:27:28 WET [2023/12/30 14:27:28 ET]
Table 'Halley' 6-max Seat #1 is the button
Seat 1: nuttymuch ($3.79 in chips)
Seat 2: Freshsplash ($1.94 in chips)
Seat 3: lazyG007605 ($1.99 in chips)
Seat 4: john oky ($1.07 in chips)
Seat 5: LLregs ($2.48 in chips)
Seat 6: Teflonmemory ($2 in chips)
Freshsplash: posts small blind $0.01
lazyG007605: posts big blind $0.02
*** HOLE CARDS ***
Dealt to LLregs [4h 6d]
john oky: raises $0.06 to $0.08
LLregs: folds
Teflonmemory: folds
nuttymuch: folds
Freshsplash: folds
lazyG007605: folds
Uncalled bet ($0.06) returned to john oky
john oky collected $0.05 from pot
john oky: doesn't show hand
*** SUMMARY ***
Total pot $0.05 | Rake $0
Seat 1: nuttymuch (button) folded before Flop (didn't bet)
Seat 2: Freshsplash (small blind) folded before Flop
Seat 3: lazyG007605 (big blind) folded before Flop
Seat 4: john oky collected ($0.05)
Seat 5: LLregs folded before Flop (didn't bet)
Seat 6: Teflonmemory folded before Flop (didn't bet)

PokerStars Zoom Hand #247964692945:  Hold'em No Limit ($0.01/$0.02) - 2023/12/30 19:27:37 WET [2023/12/30 14:27:37 ET]
Table 'Halley' 6-max Seat #1 is the button
Seat 1: TEDDYHOT69 ($1.92 in chips)
Seat 2: N0tsobig ($3.39 in chips)
Seat 3: LLregs ($2.48 in chips)
Seat 4: Tutunn ($2.47 in chips)
Seat 5: jamp2325 ($6.52 in chips)
Seat 6: piterpank31 ($2 in chips)
N0tsobig: posts small blind $0.01
LLregs: posts big blind $0.02
*** HOLE CARDS ***
Dealt to LLregs [Jd 6c]
Tutunn: folds
jamp2325: folds
piterpank31: folds
TEDDYHOT69: raises $0.04 to $0.06
N0tsobig: folds
LLregs: folds
Uncalled bet ($0.04) returned to TEDDYHOT69
TEDDYHOT69 collected $0.05 from pot
TEDDYHOT69: doesn't show hand
*** SUMMARY ***
Total pot $0.05 | Rake $0
Seat 1: TEDDYHOT69 (button) collected ($0.05)
Seat 2: N0tsobig (small blind) folded before Flop
Seat 3: LLregs (big blind) folded before Flop
Seat 4: Tutunn folded before Flop (didn't bet)
Seat 5: jamp2325 folded before Flop (didn't bet)
Seat 6: piterpank31 folded before Flop (didn't bet)

PokerStars Zoom Hand #247964702767:  Hold'em No Limit ($0.01/$0.02) - 2023/12/30 19:28:02 WET [2023/12/30 14:28:02 ET]
Table 'Halley' 6-max Seat #1 is the button
Seat 1: LucasLMdS ($3.48 in chips)
Seat 2: LLregs ($2.46 in chips)
Seat 3: disus11 ($2.27 in chips)
Seat 4: rjana165 ($1.34 in chips)
Seat 5: cala23 ($0.73 in chips)
Seat 6: N0tsobig ($3.41 in chips)
LLregs: posts small blind $0.01
disus11: posts big blind $0.02
*** HOLE CARDS ***
Dealt to LLregs [Ac 5h]
rjana165: calls $0.02
cala23: folds
N0tsobig: raises $0.07 to $0.09
LucasLMdS: folds
LLregs: folds
disus11: folds
rjana165: folds
Uncalled bet ($0.07) returned to N0tsobig
N0tsobig collected $0.07 from pot
N0tsobig: doesn't show hand
*** SUMMARY ***
Total pot $0.07 | Rake $0
Seat 1: LucasLMdS (button) folded before Flop (didn't bet)
Seat 2: LLregs (small blind) folded before Flop
Seat 3: disus11 (big blind) folded before Flop
Seat 4: rjana165 folded before Flop
Seat 5: cala23 folded before Flop (didn't bet)
Seat 6: N0tsobig collected ($0.07)

PokerStars Zoom Hand #247964701026:  Hold'em No Limit ($0.01/$0.02) - 2023/12/30 19:27:58 WET [2023/12/30 14:27:58 ET]
Table 'Halley' 6-max Seat #1 is the button
Seat 1: rjana165 ($1.34 in chips)
Seat 2: #1spoon ($1.98 in chips)
Seat 3: Cris0ner ($2.21 in chips)
Seat 4: JaUm_V ($2.40 in chips)
Seat 5: dmitriy2426 ($1.17 in chips)
Seat 6: LLregs ($2.46 in chips)
#1spoon: posts small blind $0.01
Cris0ner: posts big blind $0.02
*** HOLE CARDS ***
Dealt to LLregs [2c Kc]
JaUm_V: folds
dmitriy2426: folds
LLregs: folds
rjana165: folds
#1spoon: calls $0.01
Cris0ner: checks
*** FLOP *** [9s Kh Ad]
#1spoon: checks
Cris0ner: checks
*** TURN *** [9s Kh Ad] [Th]
#1spoon: checks
Cris0ner: bets $0.04
#1spoon: folds
Uncalled bet ($0.04) returned to Cris0ner
Cris0ner collected $0.04 from pot
Cris0ner: doesn't show hand
*** SUMMARY ***
Total pot $0.04 | Rake $0
Board [9s Kh Ad Th]
Seat 1: rjana165 (button) folded before Flop (didn't bet)
Seat 2: #1spoon (small blind) folded on the Turn
Seat 3: Cris0ner (big blind) collected ($0.04)
Seat 4: JaUm_V folded before Flop (didn't bet)
Seat 5: dmitriy2426 folded before Flop (didn't bet)
Seat 6: LLregs folded before Flop (didn't bet)

PokerStars Zoom Hand #247964711953:  Hold'em No Limit ($0.01/$0.02) - 2023/12/30 19:28:26 WET [2023/12/30 14:28:26 ET]
Table 'Halley' 6-max Seat #1 is the button
Seat 1: LLregs ($2.45 in chips)
Seat 2: darkhexxer ($3.50 in chips)
Seat 3: conspy84 ($1.51 in chips)
Seat 4: steph7208 ($0.86 in chips)
Seat 5: Kludtz21 ($2 in chips)
Seat 6: Balonas ($2.12 in chips)
darkhexxer: posts small blind $0.01
conspy84: posts big blind $0.02
*** HOLE CARDS ***
Dealt to LLregs [4d 8d]
steph7208: folds
Kludtz21: folds
Balonas: raises $0.03 to $0.05
LLregs: folds
darkhexxer: folds
conspy84: folds
Uncalled bet ($0.03) returned to Balonas
Balonas collected $0.05 from pot
Balonas: doesn't show hand
*** SUMMARY ***
Total pot $0.05 | Rake $0
Seat 1: LLregs (button) folded before Flop (didn't bet)
Seat 2: darkhexxer (small blind) folded before Flop
Seat 3: conspy84 (big blind) folded before Flop
Seat 4: steph7208 folded before Flop (didn't bet)
Seat 5: Kludtz21 folded before Flop (didn't bet)
Seat 6: Balonas collected ($0.05)

PokerStars Zoom Hand #247964710392:  Hold'em No Limit ($0.01/$0.02) - 2023/12/30 19:28:22 WET [2023/12/30 14:28:22 ET]
Table 'Halley' 6-max Seat #1 is the button
Seat 1: dsousAA ($2.12 in chips)
Seat 2: disus11 ($2.25 in chips)
Seat 3: Gohaku ($2 in chips)
Seat 4: LLregs ($2.45 in chips)
Seat 5: nuttymuch ($4.66 in chips)
Seat 6: GeRA XG ($2.25 in chips)
disus11: posts small blind $0.01
Gohaku: posts big blind $0.02
*** HOLE CARDS ***
Dealt to LLregs [Qh 9d]
LLregs: folds
nuttymuch: raises $0.03 to $0.05
GeRA XG: folds
dsousAA: folds
disus11: calls $0.04
Gohaku: folds
*** FLOP *** [Qd 8s Ts]
disus11: checks
nuttymuch: checks
*** TURN *** [Qd 8s Ts] [Kc]
disus11: checks
nuttymuch: checks
*** RIVER *** [Qd 8s Ts Kc] [9c]
disus11: bets $0.12
nuttymuch: calls $0.12
*** SHOW DOWN ***
disus11: shows [Ks Jh] (a straight, Nine to King)
nuttymuch: mucks hand
disus11 collected $0.35 from pot
*** SUMMARY ***
Total pot $0.36 | Rake $0.01
Board [Qd 8s Ts Kc 9c]
Seat 1: dsousAA (button) folded before Flop (didn't bet)
Seat 2: disus11 (small blind) showed [Ks Jh] and won ($0.35) with a straight, Nine to King
Seat 3: Gohaku (big blind) folded before Flop
Seat 4: LLregs folded before Flop (didn't bet)
Seat 5: nuttymuch mucked [9h 9s]
Seat 6: GeRA XG folded before Flop (didn't bet)

PokerStars Zoom Hand #247964714812:  Hold'em No Limit ($0.01/$0.02) - 2023/12/30 19:28:33 WET [2023/12/30 14:28:33 ET]
Table 'Halley' 6-max Seat #1 is the button
Seat 1: Cris0ner ($2.23 in chips)
Seat 2: Tricks969 ($1.48 in chips)
Seat 3: LLregs ($2.45 in chips)
Seat 4: G1olight ($8.61 in chips)
Seat 5: Wouzie ($2.31 in chips)
Seat 6: Kamylo20 ($2.02 in chips)
Tricks969: posts small blind $0.01
LLregs: posts big blind $0.02
*** HOLE CARDS ***
Dealt to LLregs [Th 4c]
G1olight: folds
Wouzie: folds
Kamylo20: raises $0.03 to $0.05
Cris0ner: calls $0.05
Tricks969: folds
LLregs: folds
*** FLOP *** [9s 2c Td]
Kamylo20: checks
Cris0ner: checks
*** TURN *** [9s 2c Td] [Qd]
Kamylo20: checks
Cris0ner: bets $0.07
Kamylo20: folds
Uncalled bet ($0.07) returned to Cris0ner
Cris0ner collected $0.13 from pot
Cris0ner: doesn't show hand
*** SUMMARY ***
Total pot $0.13 | Rake $0
Board [9s 2c Td Qd]
Seat 1: Cris0ner (button) collected ($0.13)
Seat 2: Tricks969 (small blind) folded before Flop
Seat 3: LLregs (big blind) folded before Flop
Seat 4: G1olight folded before Flop (didn't bet)
Seat 5: Wouzie folded before Flop (didn't bet)
Seat 6: Kamylo20 folded on the Turn

PokerStars Zoom Hand #247964713519:  Hold'em No Limit ($0.01/$0.02) - 2023/12/30 19:28:30 WET [2023/12/30 14:28:30 ET]
Table 'Halley' 6-max Seat #1 is the button
Seat 1: Geneticgear ($0.40 in chips)
Seat 2: Juonez ($2.03 in chips)
Seat 3: joejordisson ($1.87 in chips)
Seat 4: darkhexxer ($3.49 in chips)
Seat 5: LLregs ($2.45 in chips)
Seat 6: 2plateado2 ($2.25 in chips)
Juonez: posts small blind $0.01
joejordisson: posts big blind $0.02
*** HOLE CARDS ***
Dealt to LLregs [Jd 7s]
darkhexxer: folds
LLregs: folds
2plateado2: raises $0.04 to $0.06
Geneticgear: folds
Juonez: folds
joejordisson: raises $0.13 to $0.19
2plateado2: raises $0.24 to $0.43
joejordisson: calls $0.24
*** FLOP *** [8d 6s 4d]
joejordisson: checks
2plateado2: checks
*** TURN *** [8d 6s 4d] [9c]
joejordisson: bets $0.42
2plateado2: folds
Uncalled bet ($0.42) returned to joejordisson
joejordisson collected $0.84 from pot
joejordisson: doesn't show hand
*** SUMMARY ***
Total pot $0.87 | Rake $0.03
Board [8d 6s 4d 9c]
Seat 1: Geneticgear (button) folded before Flop (didn't bet)
Seat 2: Juonez (small blind) folded before Flop
Seat 3: joejordisson (big blind) collected ($0.84)
Seat 4: darkhexxer folded before Flop (didn't bet)
Seat 5: LLregs folded before Flop (didn't bet)
Seat 6: 2plateado2 folded on the Turn

PokerStars Zoom Hand #247964717272:  Hold'em No Limit ($0.01/$0.02) - 2023/12/30 19:28:40 WET [2023/12/30 14:28:40 ET]
Table 'Halley' 6-max Seat #1 is the button
Seat 1: A•R•D377™7 ($0.59 in chips)
Seat 2: napoli222 ($2.82 in chips)
Seat 3: 2plateado2 ($2.02 in chips)
Seat 4: LLregs ($2.43 in chips)
Seat 5: mauchin ($0.61 in chips)
Seat 6: 50 vs 50 ($2.01 in chips)
napoli222: posts small blind $0.01
2plateado2: posts big blind $0.02
*** HOLE CARDS ***
Dealt to LLregs [Th Ac]
LLregs: raises $0.04 to $0.06
mauchin: folds
50 vs 50: raises $0.15 to $0.21
A•R•D377™7: folds
napoli222: folds
2plateado2: raises $0.26 to $0.47
LLregs: folds
50 vs 50: calls $0.26
*** FLOP *** [4h 3h 2c]
2plateado2: bets $0.24
50 vs 50: raises $1.30 to $1.54 and is all-in
2plateado2: calls $1.30
*** TURN *** [4h 3h 2c] [Ks]
*** RIVER *** [4h 3h 2c Ks] [Qh]
*** SHOW DOWN ***
2plateado2: shows [Qd Qc] (three of a kind, Queens)
50 vs 50: shows [Ad Kc] (a pair of Kings)
2plateado2 collected $3.95 from pot
*** SUMMARY ***
Total pot $4.09 | Rake $0.14
Board [4h 3h 2c Ks Qh]
Seat 1: A•R•D377™7 (button) folded before Flop (didn't bet)
Seat 2: napoli222 (small blind) folded before Flop
Seat 3: 2plateado2 (big blind) showed [Qd Qc] and won ($3.95) with three of a kind, Queens
Seat 4: LLregs folded before Flop
Seat 5: mauchin folded before Flop (didn't bet)
Seat 6: 50 vs 50 showed [Ad Kc] and lost with a pair of Kings

PokerStars Zoom Hand #247964738822:  Hold'em No Limit ($0.01/$0.02) - 2023/12/30 19:29:37 WET [2023/12/30 14:29:37 ET]
Table 'Halley' 6-max Seat #1 is the button
Seat 1: Andre_Agassi80 ($1.94 in chips)
Seat 2: LLregs ($2.37 in chips)
Seat 3: scurvy idler ($2.26 in chips)
Seat 4: VIDOPRO23 ($3.59 in chips)
Seat 5: RafaCartaxo ($2 in chips)
Seat 6: Ceesel ($2.48 in chips)
LLregs: posts small blind $0.01
scurvy idler: posts big blind $0.02
*** HOLE CARDS ***
Dealt to LLregs [7s Ts]
VIDOPRO23: raises $0.05 to $0.07
RafaCartaxo: folds
Ceesel: folds
Andre_Agassi80: folds
LLregs: folds
scurvy idler: folds
Uncalled bet ($0.05) returned to VIDOPRO23
VIDOPRO23 collected $0.05 from pot
VIDOPRO23: doesn't show hand
*** SUMMARY ***
Total pot $0.05 | Rake $0
Seat 1: Andre_Agassi80 (button) folded before Flop (didn't bet)
Seat 2: LLregs (small blind) folded before Flop
Seat 3: scurvy idler (big blind) folded before Flop
Seat 4: VIDOPRO23 collected ($0.05)
Seat 5: RafaCartaxo folded before Flop (didn't bet)
Seat 6: Ceesel folded before Flop (didn't bet)

PokerStars Zoom Hand #247964751629:  Hold'em No Limit ($0.01/$0.02) - 2023/12/30 19:30:10 WET [2023/12/30 14:30:10 ET]
Table 'Halley' 6-max Seat #1 is the button
Seat 1: Juonez ($2 in chips)
Seat 2: Flake1821 ($1.45 in chips)
Seat 3: LLregs ($2.36 in chips)
Seat 4: Kamylo20 ($2 in chips)
Seat 5: lapoleka ($2.05 in chips)
Seat 6: gDjambo ($2.32 in chips)
Flake1821: posts small blind $0.01
LLregs: posts big blind $0.02
*** HOLE CARDS ***
Dealt to LLregs [8s Td]
Kamylo20: folds
lapoleka: folds
gDjambo: folds
Juonez: folds
Flake1821: folds
Uncalled bet ($0.01) returned to LLregs
LLregs collected $0.02 from pot
LLregs: doesn't show hand
*** SUMMARY ***
Total pot $0.02 | Rake $0
Seat 1: Juonez (button) folded before Flop (didn't bet)
Seat 2: Flake1821 (small blind) folded before Flop
Seat 3: LLregs (big blind) collected ($0.02)
Seat 4: Kamylo20 folded before Flop (didn't bet)
Seat 5: lapoleka folded before Flop (didn't bet)
Seat 6: gDjambo folded before Flop (didn't bet)

PokerStars Zoom Hand #247964749826:  Hold'em No Limit ($0.01/$0.02) - 2023/12/30 19:30:06 WET [2023/12/30 14:30:06 ET]
Table 'Halley' 6-max Seat #1 is the button
Seat 1: McLaude669 ($1.15 in chips)
Seat 2: kalkulater ($2.30 in chips)
Seat 3: Alanxx77 ($5.20 in chips)
Seat 4: VIDOPRO23 ($1.55 in chips)
Seat 5: LLregs ($2.36 in chips)
Seat 6: LukeSoldier ($2.57 in chips)
kalkulater: posts small blind $0.01
Alanxx77: posts big blind $0.02
*** HOLE CARDS ***
Dealt to LLregs [6d 5s]
VIDOPRO23: folds
LLregs: folds
LukeSoldier: raises $0.02 to $0.04
McLaude669: folds
kalkulater: folds
Alanxx77: folds
Uncalled bet ($0.02) returned to LukeSoldier
LukeSoldier collected $0.05 from pot
LukeSoldier: doesn't show hand
*** SUMMARY ***
Total pot $0.05 | Rake $0
Seat 1: McLaude669 (button) folded before Flop (didn't bet)
Seat 2: kalkulater (small blind) folded before Flop
Seat 3: Alanxx77 (big blind) folded before Flop
Seat 4: VIDOPRO23 folded before Flop (didn't bet)
Seat 5: LLregs folded before Flop (didn't bet)
Seat 6: LukeSoldier collected ($0.05)

PokerStars Zoom Hand #247964747923:  Hold'em No Limit ($0.01/$0.02) - 2023/12/30 19:30:01 WET [2023/12/30 14:30:01 ET]
Table 'Halley' 6-max Seat #1 is the button
Seat 1: xTheBulletsx ($2.12 in chips)
Seat 2: 5let dr ($4.99 in chips)
Seat 3: panosarg88 ($2 in chips)
Seat 4: 2plateado2 ($4.45 in chips)
Seat 5: cachusky ($2.68 in chips)
Seat 6: LLregs ($2.36 in chips)
5let dr: posts small blind $0.01
panosarg88: posts big blind $0.02
*** HOLE CARDS ***
Dealt to LLregs [8s Jd]
2plateado2: folds
cachusky: raises $0.02 to $0.04
LLregs: folds
xTheBulletsx: folds
5let dr: folds
panosarg88: raises $0.09 to $0.13
cachusky: folds
Uncalled bet ($0.09) returned to panosarg88
panosarg88 collected $0.09 from pot
panosarg88: doesn't show hand
*** SUMMARY ***
Total pot $0.09 | Rake $0
Seat 1: xTheBulletsx (button) folded before Flop (didn't bet)
Seat 2: 5let dr (small blind) folded before Flop
Seat 3: panosarg88 (big blind) collected ($0.09)
Seat 4: 2plateado2 folded before Flop (didn't bet)
Seat 5: cachusky folded before Flop
Seat 6: LLregs folded before Flop (didn't bet)

PokerStars Zoom Hand #247964746416:  Hold'em No Limit ($0.01/$0.02) - 2023/12/30 19:29:57 WET [2023/12/30 14:29:57 ET]
Table 'Halley' 6-max Seat #1 is the button
Seat 1: LLregs ($2.36 in chips)
Seat 2: JaUm_V ($7.45 in chips)
Seat 3: ONIPIKA ($2 in chips)
Seat 4: napoli222 ($2.23 in chips)
Seat 5: Weymick ($1.82 in chips)
Seat 6: kalkulater ($3.64 in chips)
JaUm_V: posts small blind $0.01
ONIPIKA: posts big blind $0.02
*** HOLE CARDS ***
Dealt to LLregs [9h 6d]
napoli222: raises $0.04 to $0.06
Weymick: folds
kalkulater: folds
LLregs: folds
JaUm_V: folds
ONIPIKA: folds
Uncalled bet ($0.04) returned to napoli222
napoli222 collected $0.05 from pot
napoli222: doesn't show hand
*** SUMMARY ***
Total pot $0.05 | Rake $0
Seat 1: LLregs (button) folded before Flop (didn't bet)
Seat 2: JaUm_V (small blind) folded before Flop
Seat 3: ONIPIKA (big blind) folded before Flop
Seat 4: napoli222 collected ($0.05)
Seat 5: Weymick folded before Flop (didn't bet)
Seat 6: kalkulater folded before Flop (didn't bet)

PokerStars Zoom Hand #247964765564:  Hold'em No Limit ($0.01/$0.02) - 2023/12/30 19:30:47 WET [2023/12/30 14:30:47 ET]
Table 'Halley' 6-max Seat #1 is the button
Seat 1: Cris0ner ($2.43 in chips)
Seat 2: Vory963 ($2.04 in chips)
Seat 3: Forever smile3 ($3.69 in chips)
Seat 4: LLregs ($2.36 in chips)
Seat 5: Thooorrr ($2 in chips)
Seat 6: Val'demar.ks ($0.95 in chips)
Vory963: posts small blind $0.01
Forever smile3: posts big blind $0.02
*** HOLE CARDS ***
Dealt to LLregs [4d Ad]
LLregs: folds
Thooorrr: raises $0.03 to $0.05
Val'demar.ks: folds
Cris0ner: folds
Vory963: folds
Forever smile3: calls $0.03
*** FLOP *** [2s 9c Js]
Forever smile3: bets $0.06
Thooorrr: folds
Uncalled bet ($0.06) returned to Forever smile3
Forever smile3 collected $0.11 from pot
Forever smile3: doesn't show hand
*** SUMMARY ***
Total pot $0.11 | Rake $0
Board [2s 9c Js]
Seat 1: Cris0ner (button) folded before Flop (didn't bet)
Seat 2: Vory963 (small blind) folded before Flop
Seat 3: Forever smile3 (big blind) collected ($0.11)
Seat 4: LLregs folded before Flop (didn't bet)
Seat 5: Thooorrr folded on the Flop
Seat 6: Val'demar.ks folded before Flop (didn't bet)

PokerStars Zoom Hand #247964755210:  Hold'em No Limit ($0.01/$0.02) - 2023/12/30 19:30:19 WET [2023/12/30 14:30:19 ET]
Table 'Halley' 6-max Seat #1 is the button
Seat 1: BigReenOne ($2.36 in chips)
Seat 2: LLregs ($2.37 in chips)
Seat 3: POOMPlT ($2 in chips)
Seat 4: gDjambo ($2.32 in chips)
Seat 5: mangalisa ($2.11 in chips)
Seat 6: jeanclaude5949 ($2.28 in chips)
LLregs: posts small blind $0.01
POOMPlT: posts big blind $0.02
*** HOLE CARDS ***
Dealt to LLregs [Ks 8s]
gDjambo has timed out
gDjambo: folds
mangalisa: folds
jeanclaude5949: calls $0.02
BigReenOne: raises $0.04 to $0.06
LLregs: folds
POOMPlT: calls $0.04
jeanclaude5949: calls $0.04
*** FLOP *** [Qh Jc Qs]
POOMPlT: checks
jeanclaude5949: bets $0.09
BigReenOne: calls $0.09
POOMPlT: folds
*** TURN *** [Qh Jc Qs] [3d]
jeanclaude5949: checks
BigReenOne: bets $0.20
jeanclaude5949: folds
Uncalled bet ($0.20) returned to BigReenOne
BigReenOne collected $0.36 from pot
BigReenOne: doesn't show hand
*** SUMMARY ***
Total pot $0.37 | Rake $0.01
Board [Qh Jc Qs 3d]
Seat 1: BigReenOne (button) collected ($0.36)
Seat 2: LLregs (small blind) folded before Flop
Seat 3: POOMPlT (big blind) folded on the Flop
Seat 4: gDjambo folded before Flop (didn't bet)
Seat 5: mangalisa folded before Flop (didn't bet)
Seat 6: jeanclaude5949 folded on the Turn

PokerStars Zoom Hand #247964767844:  Hold'em No Limit ($0.01/$0.02) - 2023/12/30 19:30:52 WET [2023/12/30 14:30:52 ET]
Table 'Halley' 6-max Seat #1 is the button
Seat 1: LLregs ($2.36 in chips)
Seat 2: Otnor ($1.98 in chips)
Seat 3: Thooorrr ($2 in chips)
Seat 4: conspy84 ($1.96 in chips)
Seat 5: renkun177 ($3.17 in chips)
Seat 6: mauchin ($1.22 in chips)
Otnor: posts small blind $0.01
Thooorrr: posts big blind $0.02
*** HOLE CARDS ***
Dealt to LLregs [8c Kc]
conspy84: folds
renkun177: folds
mauchin is disconnected
mauchin has timed out while disconnected
mauchin: folds
LLregs: raises $0.04 to $0.06
Otnor: calls $0.05
Thooorrr: calls $0.04
*** FLOP *** [4s 7s 7h]
Otnor: checks
Thooorrr: checks
LLregs: bets $0.04
Otnor: folds
Thooorrr: raises $0.12 to $0.16
LLregs: folds
Uncalled bet ($0.12) returned to Thooorrr
Thooorrr collected $0.25 from pot
Thooorrr: doesn't show hand
*** SUMMARY ***
Total pot $0.26 | Rake $0.01
Board [4s 7s 7h]
Seat 1: LLregs (button) folded on the Flop
Seat 2: Otnor (small blind) folded on the Flop
Seat 3: Thooorrr (big blind) collected ($0.25)
Seat 4: conspy84 folded before Flop (didn't bet)
Seat 5: renkun177 folded before Flop (didn't bet)
Seat 6: mauchin folded before Flop (didn't bet)

PokerStars Zoom Hand #247964792305:  Hold'em No Limit ($0.01/$0.02) - 2023/12/30 19:31:56 WET [2023/12/30 14:31:56 ET]
Table 'Halley' 6-max Seat #1 is the button
Seat 1: Vory963 ($2.06 in chips)
Seat 2: Swordfish_31 ($2.75 in chips)
Seat 3: mixi08 ($2.54 in chips)
Seat 4: conspy84 ($1.92 in chips)
Seat 5: jamp2325 ($1.97 in chips)
Seat 6: LLregs ($2.26 in chips)
Swordfish_31: posts small blind $0.01
mixi08: posts big blind $0.02
*** HOLE CARDS ***
Dealt to LLregs [Qs Kc]
conspy84: folds
jamp2325: folds
LLregs: raises $0.04 to $0.06
Vory963: folds
Swordfish_31: folds
mixi08: folds
Uncalled bet ($0.04) returned to LLregs
LLregs collected $0.05 from pot
LLregs: doesn't show hand
*** SUMMARY ***
Total pot $0.05 | Rake $0
Seat 1: Vory963 (button) folded before Flop (didn't bet)
Seat 2: Swordfish_31 (small blind) folded before Flop
Seat 3: mixi08 (big blind) folded before Flop
Seat 4: conspy84 folded before Flop (didn't bet)
Seat 5: jamp2325 folded before Flop (didn't bet)
Seat 6: LLregs collected ($0.05)

PokerStars Zoom Hand #247964797295:  Hold'em No Limit ($0.01/$0.02) - 2023/12/30 19:32:09 WET [2023/12/30 14:32:09 ET]
Table 'Halley' 6-max Seat #1 is the button
Seat 1: 50 vs 50 ($3.06 in chips)
Seat 2: gDjambo ($2.36 in chips)
Seat 3: fernandokonno ($2.23 in chips)
Seat 4: Kamylo20 ($2.03 in chips)
Seat 5: yuzu0921 ($2.39 in chips)
Seat 6: LLregs ($2.29 in chips)
gDjambo: posts small blind $0.01
fernandokonno: posts big blind $0.02
*** HOLE CARDS ***
Dealt to LLregs [Jh 9s]
Kamylo20: folds
yuzu0921: raises $0.03 to $0.05
LLregs: folds
50 vs 50: folds
gDjambo: folds
fernandokonno: folds
Uncalled bet ($0.03) returned to yuzu0921
yuzu0921 collected $0.05 from pot
yuzu0921: doesn't show hand
*** SUMMARY ***
Total pot $0.05 | Rake $0
Seat 1: 50 vs 50 (button) folded before Flop (didn't bet)
Seat 2: gDjambo (small blind) folded before Flop
Seat 3: fernandokonno (big blind) folded before Flop
Seat 4: Kamylo20 folded before Flop (didn't bet)
Seat 5: yuzu0921 collected ($0.05)
Seat 6: LLregs folded before Flop (didn't bet)

PokerStars Zoom Hand #247964799592:  Hold'em No Limit ($0.01/$0.02) - 2023/12/30 19:32:15 WET [2023/12/30 14:32:15 ET]
Table 'Halley' 6-max Seat #1 is the button
Seat 1: LucasLMdS ($5.30 in chips)
Seat 2: nuttymuch ($4.25 in chips)
Seat 3: LLregs ($2.29 in chips)
Seat 4: TERUROS ($1.70 in chips)
Seat 5: Kludtz21 ($2.27 in chips)
Seat 6: Dimoni797979 ($1.85 in chips)
nuttymuch: posts small blind $0.01
LLregs: posts big blind $0.02
*** HOLE CARDS ***
Dealt to LLregs [5s 5d]
TERUROS: raises $0.03 to $0.05
Kludtz21: folds
Dimoni797979: folds
LucasLMdS: folds
nuttymuch: calls $0.04
LLregs: raises $0.09 to $0.14
TERUROS: calls $0.09
nuttymuch: calls $0.09
*** FLOP *** [Qh 6d Js]
nuttymuch: checks
LLregs: checks
TERUROS: checks
*** TURN *** [Qh 6d Js] [7h]
nuttymuch: checks
LLregs: checks
TERUROS: checks
*** RIVER *** [Qh 6d Js 7h] [5c]
nuttymuch: bets $0.14
LLregs: raises $0.23 to $0.37
TERUROS: folds
nuttymuch: folds
Uncalled bet ($0.23) returned to LLregs
LLregs collected $0.68 from pot
LLregs: doesn't show hand
*** SUMMARY ***
Total pot $0.70 | Rake $0.02
Board [Qh 6d Js 7h 5c]
Seat 1: LucasLMdS (button) folded before Flop (didn't bet)
Seat 2: nuttymuch (small blind) folded on the River
Seat 3: LLregs (big blind) collected ($0.68)
Seat 4: TERUROS folded on the River
Seat 5: Kludtz21 folded before Flop (didn't bet)
Seat 6: Dimoni797979 folded before Flop (didn't bet)

PokerStars Zoom Hand #247964823525:  Hold'em No Limit ($0.01/$0.02) - 2023/12/30 19:33:17 WET [2023/12/30 14:33:17 ET]
Table 'Halley' 6-max Seat #1 is the button
Seat 1: Chrigra03 ($1.97 in chips)
Seat 2: scurvy idler ($2.30 in chips)
Seat 3: FTWLP ($2 in chips)
Seat 4: HarryHaller77 ($2.58 in chips)
Seat 5: LLregs ($2.69 in chips)
Seat 6: gyo98 ($1 in chips)
scurvy idler: posts small blind $0.01
FTWLP: posts big blind $0.02
*** HOLE CARDS ***
Dealt to LLregs [4h 8s]
HarryHaller77: raises $0.02 to $0.04
LLregs: folds
gyo98: calls $0.04
Chrigra03: folds
scurvy idler: folds
FTWLP: folds
*** FLOP *** [Qd Jh Kh]
HarryHaller77: bets $0.04
gyo98: raises $0.19 to $0.23
HarryHaller77: folds
Uncalled bet ($0.19) returned to gyo98
gyo98 collected $0.18 from pot
gyo98: doesn't show hand
*** SUMMARY ***
Total pot $0.19 | Rake $0.01
Board [Qd Jh Kh]
Seat 1: Chrigra03 (button) folded before Flop (didn't bet)
Seat 2: scurvy idler (small blind) folded before Flop
Seat 3: FTWLP (big blind) folded before Flop
Seat 4: HarryHaller77 folded on the Flop
Seat 5: LLregs folded before Flop (didn't bet)
Seat 6: gyo98 collected ($0.18)

PokerStars Zoom Hand #247964825025:  Hold'em No Limit ($0.01/$0.02) - 2023/12/30 19:33:21 WET [2023/12/30 14:33:21 ET]
Table 'Halley' 6-max Seat #1 is the button
Seat 1: napoli222 ($2.91 in chips)
Seat 2: LLregs ($2.69 in chips)
Seat 3: ivan281011 ($4.76 in chips)
Seat 4: Kamylo20 ($2.91 in chips)
Seat 5: Gattini37 ($2.57 in chips)
Seat 6: Juonez ($2.07 in chips)
LLregs: posts small blind $0.01
ivan281011: posts big blind $0.02
*** HOLE CARDS ***
Dealt to LLregs [Ad 4s]
Kamylo20: folds
Gattini37: folds
Juonez: folds
napoli222: raises $0.04 to $0.06
LLregs: folds
ivan281011: calls $0.04
*** FLOP *** [5s 4c 6c]
ivan281011: bets $0.08
napoli222: raises $0.16 to $0.24
ivan281011: folds
Uncalled bet ($0.16) returned to napoli222
napoli222 collected $0.28 from pot
napoli222: doesn't show hand
*** SUMMARY ***
Total pot $0.29 | Rake $0.01
Board [5s 4c 6c]
Seat 1: napoli222 (button) collected ($0.28)
Seat 2: LLregs (small blind) folded before Flop
Seat 3: ivan281011 (big blind) folded on the Flop
Seat 4: Kamylo20 folded before Flop (didn't bet)
Seat 5: Gattini37 folded before Flop (didn't bet)
Seat 6: Juonez folded before Flop (didn't bet)

PokerStars Zoom Hand #247964834221:  Hold'em No Limit ($0.01/$0.02) - 2023/12/30 19:33:45 WET [2023/12/30 14:33:45 ET]
Table 'Halley' 6-max Seat #1 is the button
Seat 1: LLregs ($2.68 in chips)
Seat 2: dgage8 ($3.48 in chips)
Seat 3: MeisterJedah ($5.19 in chips)
Seat 4: gDjambo ($5.22 in chips)
Seat 5: Odontfranzin ($2.12 in chips)
Seat 6: Balonas ($7.01 in chips)
dgage8: posts small blind $0.01
MeisterJedah: posts big blind $0.02
*** HOLE CARDS ***
Dealt to LLregs [8c Qc]
gDjambo: folds
Odontfranzin: folds
Balonas: folds
LLregs: raises $0.04 to $0.06
dgage8: folds
MeisterJedah: raises $0.19 to $0.25
LLregs: folds
Uncalled bet ($0.19) returned to MeisterJedah
MeisterJedah collected $0.13 from pot
MeisterJedah: doesn't show hand
*** SUMMARY ***
Total pot $0.13 | Rake $0
Seat 1: LLregs (button) folded before Flop
Seat 2: dgage8 (small blind) folded before Flop
Seat 3: MeisterJedah (big blind) collected ($0.13)
Seat 4: gDjambo folded before Flop (didn't bet)
Seat 5: Odontfranzin folded before Flop (didn't bet)
Seat 6: Balonas folded before Flop (didn't bet)

PokerStars Zoom Hand #247964845349:  Hold'em No Limit ($0.01/$0.02) - 2023/12/30 19:34:14 WET [2023/12/30 14:34:14 ET]
Table 'Halley' 6-max Seat #1 is the button
Seat 1: mangalisa ($2 in chips)
Seat 2: CrazyFairfox ($4.01 in chips)
Seat 3: Kludtz21 ($2.09 in chips)
Seat 4: LLregs ($2.62 in chips)
Seat 5: Thooorrr ($2.03 in chips)
Seat 6: POOMPlT ($2.25 in chips)
CrazyFairfox: posts small blind $0.01
Kludtz21: posts big blind $0.02
*** HOLE CARDS ***
Dealt to LLregs [4c Ad]
LLregs: folds
Thooorrr: raises $0.03 to $0.05
POOMPlT: folds
mangalisa: folds
CrazyFairfox: folds
Kludtz21: calls $0.03
*** FLOP *** [Ac 9h 6s]
Kludtz21: checks
Thooorrr: bets $0.07
Kludtz21: calls $0.07
*** TURN *** [Ac 9h 6s] [2d]
Kludtz21: checks
Thooorrr: bets $0.15
Kludtz21: folds
Uncalled bet ($0.15) returned to Thooorrr
Thooorrr collected $0.24 from pot
Thooorrr: doesn't show hand
*** SUMMARY ***
Total pot $0.25 | Rake $0.01
Board [Ac 9h 6s 2d]
Seat 1: mangalisa (button) folded before Flop (didn't bet)
Seat 2: CrazyFairfox (small blind) folded before Flop
Seat 3: Kludtz21 (big blind) folded on the Turn
Seat 4: LLregs folded before Flop (didn't bet)
Seat 5: Thooorrr collected ($0.24)
Seat 6: POOMPlT folded before Flop (didn't bet)

PokerStars Zoom Hand #247964843527:  Hold'em No Limit ($0.01/$0.02) - 2023/12/30 19:34:10 WET [2023/12/30 14:34:10 ET]
Table 'Halley' 6-max Seat #1 is the button
Seat 1: ds_pearce2 ($3.66 in chips)
Seat 2: allergy2nuts ($1.96 in chips)
Seat 3: napoli222 ($2.68 in chips)
Seat 4: CaptainB1ack ($2.45 in chips)
Seat 5: LLregs ($2.62 in chips)
Seat 6: 888lifeIS ($2 in chips)
allergy2nuts: posts small blind $0.01
napoli222: posts big blind $0.02
*** HOLE CARDS ***
Dealt to LLregs [8s Qh]
CaptainB1ack: folds
LLregs: folds
888lifeIS: folds
ds_pearce2: folds
allergy2nuts: raises $0.04 to $0.06
napoli222: calls $0.04
*** FLOP *** [3h 4c 7c]
allergy2nuts: checks
napoli222: bets $0.06
allergy2nuts: calls $0.06
*** TURN *** [3h 4c 7c] [4s]
allergy2nuts: checks
napoli222: bets $0.18
allergy2nuts: calls $0.18
*** RIVER *** [3h 4c 7c 4s] [7s]
allergy2nuts: checks
napoli222: checks
*** SHOW DOWN ***
allergy2nuts: shows [7h 7d] (four of a kind, Sevens)
napoli222: mucks hand
allergy2nuts collected $0.58 from pot
*** SUMMARY ***
Total pot $0.60 | Rake $0.02
Board [3h 4c 7c 4s 7s]
Seat 1: ds_pearce2 (button) folded before Flop (didn't bet)
Seat 2: allergy2nuts (small blind) showed [7h 7d] and won ($0.58) with four of a kind, Sevens
Seat 3: napoli222 (big blind) mucked [9c Ac]
Seat 4: CaptainB1ack folded before Flop (didn't bet)
Seat 5: LLregs folded before Flop (didn't bet)
Seat 6: 888lifeIS folded before Flop (didn't bet)

PokerStars Zoom Hand #247964846851:  Hold'em No Limit ($0.01/$0.02) - 2023/12/30 19:34:18 WET [2023/12/30 14:34:18 ET]
Table 'Halley' 6-max Seat #1 is the button
Seat 1: napoli222 ($2.05 in chips)
Seat 2: xTheBulletsx ($2.25 in chips)
Seat 3: begui150507 ($2.60 in chips)
Seat 4: timsah70 ($1.78 in chips)
Seat 5: LLregs ($2.62 in chips)
Seat 6: prokop0410 ($2.12 in chips)
xTheBulletsx: posts small blind $0.01
begui150507: posts big blind $0.02
*** HOLE CARDS ***
Dealt to LLregs [Kc Ah]
timsah70: calls $0.02
LLregs: raises $0.04 to $0.06
prokop0410: folds
napoli222: folds
xTheBulletsx: folds
begui150507: calls $0.04
timsah70: calls $0.04
*** FLOP *** [Th 8c 9d]
begui150507: bets $0.10
timsah70: calls $0.10
LLregs: folds
*** TURN *** [Th 8c 9d] [2s]
begui150507: bets $0.16
timsah70: calls $0.16
*** RIVER *** [Th 8c 9d 2s] [2d]
begui150507: bets $0.26
timsah70: folds
Uncalled bet ($0.26) returned to begui150507
begui150507 collected $0.69 from pot
begui150507: doesn't show hand
*** SUMMARY ***
Total pot $0.71 | Rake $0.02
Board [Th 8c 9d 2s 2d]
Seat 1: napoli222 (button) folded before Flop (didn't bet)
Seat 2: xTheBulletsx (small blind) folded before Flop
Seat 3: begui150507 (big blind) collected ($0.69)
Seat 4: timsah70 folded on the River
Seat 5: LLregs folded on the Flop
Seat 6: prokop0410 folded before Flop (didn't bet)

PokerStars Zoom Hand #247964870280:  Hold'em No Limit ($0.01/$0.02) - 2023/12/30 19:35:19 WET [2023/12/30 14:35:19 ET]
Table 'Halley' 6-max Seat #1 is the button
Seat 1: 888lifeIS ($2 in chips)
Seat 2: LLregs ($2.53 in chips)
Seat 3: joanie1991 ($7.91 in chips)
Seat 4: Alanxx77 ($5.30 in chips)
Seat 5: HarryHaller77 ($2 in chips)
Seat 6: MeisterJedah ($3.99 in chips)
LLregs: posts small blind $0.01
joanie1991: posts big blind $0.02
*** HOLE CARDS ***
Dealt to LLregs [Qs Qc]
Alanxx77: folds
HarryHaller77: raises $0.02 to $0.04
MeisterJedah: folds
888lifeIS: folds
LLregs: raises $0.08 to $0.12
joanie1991: folds
HarryHaller77: folds
Uncalled bet ($0.08) returned to LLregs
LLregs collected $0.10 from pot
LLregs: doesn't show hand
*** SUMMARY ***
Total pot $0.10 | Rake $0
Seat 1: 888lifeIS (button) folded before Flop (didn't bet)
Seat 2: LLregs (small blind) collected ($0.10)
Seat 3: joanie1991 (big blind) folded before Flop
Seat 4: Alanxx77 folded before Flop (didn't bet)
Seat 5: HarryHaller77 folded before Flop
Seat 6: MeisterJedah folded before Flop (didn't bet)

PokerStars Zoom Hand #247964866054:  Hold'em No Limit ($0.01/$0.02) - 2023/12/30 19:35:08 WET [2023/12/30 14:35:08 ET]
Table 'Halley' 6-max Seat #1 is the button
Seat 1: Gaigel ($2.26 in chips)
Seat 2: Odontfranzin ($2.53 in chips)
Seat 3: tankos56 ($1.44 in chips)
Seat 4: Loucomeloo ($2.11 in chips)
Seat 5: lacost_blr ($3.30 in chips)
Seat 6: LLregs ($2.53 in chips)
Odontfranzin: posts small blind $0.01
tankos56: posts big blind $0.02
*** HOLE CARDS ***
Dealt to LLregs [9h Kd]
Loucomeloo: folds
lacost_blr: folds
LLregs: folds
Gaigel: folds
Odontfranzin: raises $0.02 to $0.04
tankos56: calls $0.02
*** FLOP *** [6c 8s As]
Odontfranzin: checks
tankos56: bets $0.02
Odontfranzin: calls $0.02
*** TURN *** [6c 8s As] [9d]
Odontfranzin: checks
tankos56: bets $0.06
Odontfranzin: calls $0.06
*** RIVER *** [6c 8s As 9d] [3s]
Odontfranzin: checks
tankos56: checks
*** SHOW DOWN ***
Odontfranzin: shows [Th 9s] (a pair of Nines)
tankos56: shows [5c 7s] (a straight, Five to Nine)
tankos56 collected $0.23 from pot
*** SUMMARY ***
Total pot $0.24 | Rake $0.01
Board [6c 8s As 9d 3s]
Seat 1: Gaigel (button) folded before Flop (didn't bet)
Seat 2: Odontfranzin (small blind) showed [Th 9s] and lost with a pair of Nines
Seat 3: tankos56 (big blind) showed [5c 7s] and won ($0.23) with a straight, Five to Nine
Seat 4: Loucomeloo folded before Flop (didn't bet)
Seat 5: lacost_blr folded before Flop (didn't bet)
Seat 6: LLregs folded before Flop (didn't bet)

PokerStars Zoom Hand #247964864507:  Hold'em No Limit ($0.01/$0.02) - 2023/12/30 19:35:04 WET [2023/12/30 14:35:04 ET]
Table 'Halley' 6-max Seat #1 is the button
Seat 1: pöbel23 ($1.32 in chips)
Seat 2: LLregs ($2.54 in chips)
Seat 3: Slava Gvozdev ($1.13 in chips)
Seat 4: cachusky ($2.83 in chips)
Seat 5: Plmax94 ($1.58 in chips)
Seat 6: tankos56 ($1.44 in chips)
LLregs: posts small blind $0.01
Slava Gvozdev: posts big blind $0.02
*** HOLE CARDS ***
Dealt to LLregs [5d Ks]
cachusky: folds
Plmax94: folds
tankos56: folds
pöbel23: calls $0.02
LLregs: folds
Slava Gvozdev: checks
*** FLOP *** [6h 2d Ah]
Slava Gvozdev: checks
pöbel23: checks
*** TURN *** [6h 2d Ah] [7h]
Slava Gvozdev: checks
pöbel23: checks
*** RIVER *** [6h 2d Ah 7h] [Ad]
Slava Gvozdev: checks
pöbel23: checks
*** SHOW DOWN ***
Slava Gvozdev: shows [Qh Js] (a pair of Aces)
pöbel23: shows [Kd Jh] (a pair of Aces - King kicker)
pöbel23 collected $0.05 from pot
*** SUMMARY ***
Total pot $0.05 | Rake $0
Board [6h 2d Ah 7h Ad]
Seat 1: pöbel23 (button) showed [Kd Jh] and won ($0.05) with a pair of Aces
Seat 2: LLregs (small blind) folded before Flop
Seat 3: Slava Gvozdev (big blind) showed [Qh Js] and lost with a pair of Aces
Seat 4: cachusky folded before Flop (didn't bet)
Seat 5: Plmax94 folded before Flop (didn't bet)
Seat 6: tankos56 folded before Flop (didn't bet)

PokerStars Zoom Hand #247964878912:  Hold'em No Limit ($0.01/$0.02) - 2023/12/30 19:35:42 WET [2023/12/30 14:35:42 ET]
Table 'Halley' 6-max Seat #1 is the button
Seat 1: joanie1991 ($7.88 in chips)
Seat 2: joejordisson ($6.19 in chips)
Seat 3: Thooorrr ($2.05 in chips)
Seat 4: panosarg88 ($4.27 in chips)
Seat 5: LLregs ($2.59 in chips)
Seat 6: broks01 ($2.08 in chips)
joejordisson: posts small blind $0.01
Thooorrr: posts big blind $0.02
*** HOLE CARDS ***
Dealt to LLregs [3h 8d]
panosarg88: folds
LLregs: folds
broks01: raises $0.03 to $0.05
joanie1991: folds
joejordisson: folds
Thooorrr: folds
Uncalled bet ($0.03) returned to broks01
broks01 collected $0.05 from pot
broks01: doesn't show hand
*** SUMMARY ***
Total pot $0.05 | Rake $0
Seat 1: joanie1991 (button) folded before Flop (didn't bet)
Seat 2: joejordisson (small blind) folded before Flop
Seat 3: Thooorrr (big blind) folded before Flop
Seat 4: panosarg88 folded before Flop (didn't bet)
Seat 5: LLregs folded before Flop (didn't bet)
Seat 6: broks01 collected ($0.05)

PokerStars Zoom Hand #247964868649:  Hold'em No Limit ($0.01/$0.02) - 2023/12/30 19:35:15 WET [2023/12/30 14:35:15 ET]
Table 'Halley' 6-max Seat #1 is the button
Seat 1: LLregs ($2.53 in chips)
Seat 2: CANYA_V ($1.90 in chips)
Seat 3: raymond310 ($1.31 in chips)
Seat 4: Freshsplash ($2 in chips)
Seat 5: Devilfishtheone ($3.33 in chips)
Seat 6: scurvy idler ($2.31 in chips)
CANYA_V: posts small blind $0.01
raymond310: posts big blind $0.02
*** HOLE CARDS ***
Dealt to LLregs [8c 5c]
Freshsplash: folds
Devilfishtheone: calls $0.02
scurvy idler: folds
LLregs: folds
CANYA_V: raises $0.02 to $0.04
raymond310: calls $0.02
Devilfishtheone: calls $0.02
*** FLOP *** [2s 3s 4s]
CANYA_V: bets $0.08
raymond310: calls $0.08
Devilfishtheone: folds
*** TURN *** [2s 3s 4s] [2d]
CANYA_V: bets $0.18
raymond310: calls $0.18
*** RIVER *** [2s 3s 4s 2d] [Td]
CANYA_V: bets $0.41
raymond310: calls $0.41
*** SHOW DOWN ***
CANYA_V: shows [Ks Ts] (a flush, King high)
raymond310: mucks hand
CANYA_V collected $1.41 from pot
*** SUMMARY ***
Total pot $1.46 | Rake $0.05
Board [2s 3s 4s 2d Td]
Seat 1: LLregs (button) folded before Flop (didn't bet)
Seat 2: CANYA_V (small blind) showed [Ks Ts] and won ($1.41) with a flush, King high
Seat 3: raymond310 (big blind) mucked [3d 8d]
Seat 4: Freshsplash folded before Flop (didn't bet)
Seat 5: Devilfishtheone folded on the Flop
Seat 6: scurvy idler folded before Flop (didn't bet)

PokerStars Zoom Hand #247964880789:  Hold'em No Limit ($0.01/$0.02) - 2023/12/30 19:35:47 WET [2023/12/30 14:35:47 ET]
Table 'Halley' 6-max Seat #1 is the button
Seat 1: Ninjafuturo123 ($2.33 in chips)
Seat 2: Ilikefossil ($2.01 in chips)
Seat 3: LLregs ($2.59 in chips)
Seat 4: panosarg88 ($4.27 in chips)
Seat 5: Fasteddie35 ($2.01 in chips)
Seat 6: zoran445 ($0.70 in chips)
Ilikefossil: posts small blind $0.01
LLregs: posts big blind $0.02
*** HOLE CARDS ***
Dealt to LLregs [Ah 4s]
panosarg88 has timed out
panosarg88: folds
Fasteddie35: raises $0.03 to $0.05
zoran445: folds
Ninjafuturo123: raises $0.15 to $0.20
Ilikefossil: folds
LLregs: folds
Fasteddie35: folds
Uncalled bet ($0.15) returned to Ninjafuturo123
Ninjafuturo123 collected $0.13 from pot
Ninjafuturo123: doesn't show hand
*** SUMMARY ***
Total pot $0.13 | Rake $0
Seat 1: Ninjafuturo123 (button) collected ($0.13)
Seat 2: Ilikefossil (small blind) folded before Flop
Seat 3: LLregs (big blind) folded before Flop
Seat 4: panosarg88 folded before Flop (didn't bet)
Seat 5: Fasteddie35 folded before Flop
Seat 6: zoran445 folded before Flop (didn't bet)

PokerStars Zoom Hand #247964860649:  Hold'em No Limit ($0.01/$0.02) - 2023/12/30 19:34:54 WET [2023/12/30 14:34:54 ET]
Table 'Halley' 6-max Seat #1 is the button
Seat 1: gDjambo ($2.14 in chips)
Seat 2: VIDOPRO23 ($3.52 in chips)
Seat 3: LLregs ($2.56 in chips)
Seat 4: Cris0ner ($8.01 in chips)
Seat 5: 888lifeIS ($2 in chips)
Seat 6: TheJunta ($2 in chips)
VIDOPRO23: posts small blind $0.01
LLregs: posts big blind $0.02
*** HOLE CARDS ***
Dealt to LLregs [5s 8c]
Cris0ner: raises $0.04 to $0.06
888lifeIS: folds
TheJunta: calls $0.06
gDjambo: folds
VIDOPRO23: folds
LLregs: folds
*** FLOP *** [6d 7h Jh]
Cris0ner: bets $0.11
TheJunta: calls $0.11
*** TURN *** [6d 7h Jh] [Qh]
Cris0ner: bets $0.20
TheJunta: calls $0.20
*** RIVER *** [6d 7h Jh Qh] [9s]
Cris0ner: checks
TheJunta: checks
*** SHOW DOWN ***
Cris0ner: shows [8d 8s] (a pair of Eights)
TheJunta: mucks hand
Cris0ner collected $0.74 from pot
*** SUMMARY ***
Total pot $0.77 | Rake $0.03
Board [6d 7h Jh Qh 9s]
Seat 1: gDjambo (button) folded before Flop (didn't bet)
Seat 2: VIDOPRO23 (small blind) folded before Flop
Seat 3: LLregs (big blind) folded before Flop
Seat 4: Cris0ner showed [8d 8s] and won ($0.74) with a pair of Eights
Seat 5: 888lifeIS folded before Flop (didn't bet)
Seat 6: TheJunta mucked [Kh Ad]

PokerStars Zoom Hand #247964897784:  Hold'em No Limit ($0.01/$0.02) - 2023/12/30 19:36:32 WET [2023/12/30 14:36:32 ET]
Table 'Halley' 6-max Seat #1 is the button
Seat 1: fukazapam ($6.06 in chips)
Seat 2: Andre_Agassi80 ($1.64 in chips)
Seat 3: Szklana.poker ($2.51 in chips)
Seat 4: LLregs ($2.57 in chips)
Seat 5: Floggy73 ($0.50 in chips)
Seat 6: Bardiyayaya ($2 in chips)
Andre_Agassi80: posts small blind $0.01
Szklana.poker: posts big blind $0.02
*** HOLE CARDS ***
Dealt to LLregs [2c 3d]
LLregs: folds
Floggy73: folds
Bardiyayaya: raises $0.02 to $0.04
fukazapam: folds
Andre_Agassi80: folds
Szklana.poker: folds
Uncalled bet ($0.02) returned to Bardiyayaya
Bardiyayaya collected $0.05 from pot
Bardiyayaya: doesn't show hand
*** SUMMARY ***
Total pot $0.05 | Rake $0
Seat 1: fukazapam (button) folded before Flop (didn't bet)
Seat 2: Andre_Agassi80 (small blind) folded before Flop
Seat 3: Szklana.poker (big blind) folded before Flop
Seat 4: LLregs folded before Flop (didn't bet)
Seat 5: Floggy73 folded before Flop (didn't bet)
Seat 6: Bardiyayaya collected ($0.05)

PokerStars Zoom Hand #247964899499:  Hold'em No Limit ($0.01/$0.02) - 2023/12/30 19:36:37 WET [2023/12/30 14:36:37 ET]
Table 'Halley' 6-max Seat #1 is the button
Seat 1: gyo98 ($1.63 in chips)
Seat 2: A•R•D377™7 ($1.01 in chips)
Seat 3: conspy84 ($2.23 in chips)
Seat 4: LLregs ($2.57 in chips)
Seat 5: Balonas ($4.24 in chips)
Seat 6: rjana165 ($1.23 in chips)
A•R•D377™7: posts small blind $0.01
conspy84: posts big blind $0.02
*** HOLE CARDS ***
Dealt to LLregs [7c Jh]
LLregs: folds
Balonas: folds
rjana165: folds
gyo98: folds
A•R•D377™7: folds
Uncalled bet ($0.01) returned to conspy84
conspy84 collected $0.02 from pot
conspy84: doesn't show hand
*** SUMMARY ***
Total pot $0.02 | Rake $0
Seat 1: gyo98 (button) folded before Flop (didn't bet)
Seat 2: A•R•D377™7 (small blind) folded before Flop
Seat 3: conspy84 (big blind) collected ($0.02)
Seat 4: LLregs folded before Flop (didn't bet)
Seat 5: Balonas folded before Flop (didn't bet)
Seat 6: rjana165 folded before Flop (didn't bet)

PokerStars Zoom Hand #247964901035:  Hold'em No Limit ($0.01/$0.02) - 2023/12/30 19:36:41 WET [2023/12/30 14:36:41 ET]
Table 'Halley' 6-max Seat #1 is the button
Seat 1: djmcool ($2.63 in chips)
Seat 2: Mr Jodan ($3.08 in chips)
Seat 3: bettanye ($2 in chips)
Seat 4: Ira Duchenko ($0.96 in chips)
Seat 5: gyo98 ($1.63 in chips)
Seat 6: LLregs ($2.57 in chips)
Mr Jodan: posts small blind $0.01
bettanye: posts big blind $0.02
*** HOLE CARDS ***
Dealt to LLregs [3d Ad]
Ira Duchenko: folds
gyo98: folds
LLregs: raises $0.04 to $0.06
djmcool: folds
Mr Jodan: folds
bettanye: folds
Uncalled bet ($0.04) returned to LLregs
LLregs collected $0.05 from pot
LLregs: doesn't show hand
*** SUMMARY ***
Total pot $0.05 | Rake $0
Seat 1: djmcool (button) folded before Flop (didn't bet)
Seat 2: Mr Jodan (small blind) folded before Flop
Seat 3: bettanye (big blind) folded before Flop
Seat 4: Ira Duchenko folded before Flop (didn't bet)
Seat 5: gyo98 folded before Flop (didn't bet)
Seat 6: LLregs collected ($0.05)

PokerStars Zoom Hand #247964896503:  Hold'em No Limit ($0.01/$0.02) - 2023/12/30 19:36:29 WET [2023/12/30 14:36:29 ET]
Table 'Halley' 6-max Seat #1 is the button
Seat 1: conspy84 ($1.80 in chips)
Seat 2: 888lifeIS ($2.71 in chips)
Seat 3: LucasLMdS ($3.12 in chips)
Seat 4: GeRA XG ($1.45 in chips)
Seat 5: aproximo ($2.10 in chips)
Seat 6: LLregs ($2.57 in chips)
888lifeIS: posts small blind $0.01
LucasLMdS: posts big blind $0.02
*** HOLE CARDS ***
Dealt to LLregs [5c As]
GeRA XG: calls $0.02
aproximo: calls $0.02
LLregs: folds
conspy84: folds
888lifeIS: folds
LucasLMdS: checks
*** FLOP *** [Td Qs 7h]
LucasLMdS: checks
GeRA XG: checks
aproximo: bets $0.04
LucasLMdS: folds
GeRA XG: calls $0.04
*** TURN *** [Td Qs 7h] [3d]
GeRA XG: bets $0.07
aproximo: folds
Uncalled bet ($0.07) returned to GeRA XG
GeRA XG collected $0.14 from pot
GeRA XG: doesn't show hand
*** SUMMARY ***
Total pot $0.15 | Rake $0.01
Board [Td Qs 7h 3d]
Seat 1: conspy84 (button) folded before Flop (didn't bet)
Seat 2: 888lifeIS (small blind) folded before Flop
Seat 3: LucasLMdS (big blind) folded on the Flop
Seat 4: GeRA XG collected ($0.14)
Seat 5: aproximo folded on the Turn
Seat 6: LLregs folded before Flop (didn't bet)

PokerStars Zoom Hand #247964889227:  Hold'em No Limit ($0.01/$0.02) - 2023/12/30 19:36:09 WET [2023/12/30 14:36:09 ET]
Table 'Halley' 6-max Seat #1 is the button
Seat 1: LLregs ($2.57 in chips)
Seat 2: djmcool ($2 in chips)
Seat 3: timsah70 ($1.53 in chips)
Seat 4: iliyan66 ($7.92 in chips)
Seat 5: PR3SUR3 ($2 in chips)
Seat 6: HarryHaller77 ($2.53 in chips)
djmcool: posts small blind $0.01
timsah70: posts big blind $0.02
*** HOLE CARDS ***
Dealt to LLregs [Qd 7s]
iliyan66: folds
PR3SUR3: raises $0.03 to $0.05
HarryHaller77: folds
LLregs: folds
djmcool: folds
timsah70: calls $0.03
*** FLOP *** [5d Th 2s]
timsah70: bets $0.10
PR3SUR3: calls $0.10
*** TURN *** [5d Th 2s] [Ts]
timsah70: checks
PR3SUR3: bets $0.10
timsah70: calls $0.10
*** RIVER *** [5d Th 2s Ts] [7h]
timsah70: checks
PR3SUR3: checks
*** SHOW DOWN ***
timsah70: shows [Tc Ah] (three of a kind, Tens)
PR3SUR3: mucks hand
timsah70 collected $0.49 from pot
*** SUMMARY ***
Total pot $0.51 | Rake $0.02
Board [5d Th 2s Ts 7h]
Seat 1: LLregs (button) folded before Flop (didn't bet)
Seat 2: djmcool (small blind) folded before Flop
Seat 3: timsah70 (big blind) showed [Tc Ah] and won ($0.49) with three of a kind, Tens
Seat 4: iliyan66 folded before Flop (didn't bet)
Seat 5: PR3SUR3 mucked [Qs As]
Seat 6: HarryHaller77 folded before Flop (didn't bet)

PokerStars Zoom Hand #247964905272:  Hold'em No Limit ($0.01/$0.02) - 2023/12/30 19:36:52 WET [2023/12/30 14:36:52 ET]
Table 'Halley' 6-max Seat #1 is the button
Seat 1: pietrek2 ($6.63 in chips)
Seat 2: Noah_D@vid ($0.90 in chips)
Seat 3: xTheBulletsx ($2 in chips)
Seat 4: raymond310 ($0.92 in chips)
Seat 5: LLregs ($2.60 in chips)
Seat 6: RafaCartaxo ($2.20 in chips)
Noah_D@vid: posts small blind $0.01
xTheBulletsx: posts big blind $0.02
*** HOLE CARDS ***
Dealt to LLregs [Ts 8h]
raymond310: calls $0.02
LLregs: folds
RafaCartaxo: folds
pietrek2: raises $0.04 to $0.06
Noah_D@vid: folds
xTheBulletsx: folds
raymond310: calls $0.04
*** FLOP *** [2s 2c 7d]
raymond310: checks
pietrek2: bets $0.07
raymond310: calls $0.07
*** TURN *** [2s 2c 7d] [3s]
raymond310: checks
pietrek2: bets $0.10
raymond310: raises $0.10 to $0.20
pietrek2: calls $0.10
*** RIVER *** [2s 2c 7d 3s] [Ac]
raymond310: bets $0.34
pietrek2: calls $0.34
*** SHOW DOWN ***
raymond310: shows [Kd 3d] (two pair, Threes and Deuces)
pietrek2: shows [As Js] (two pair, Aces and Deuces)
pietrek2 collected $1.32 from pot
*** SUMMARY ***
Total pot $1.37 | Rake $0.05
Board [2s 2c 7d 3s Ac]
Seat 1: pietrek2 (button) showed [As Js] and won ($1.32) with two pair, Aces and Deuces
Seat 2: Noah_D@vid (small blind) folded before Flop
Seat 3: xTheBulletsx (big blind) folded before Flop
Seat 4: raymond310 showed [Kd 3d] and lost with two pair, Threes and Deuces
Seat 5: LLregs folded before Flop (didn't bet)
Seat 6: RafaCartaxo folded before Flop (didn't bet)

PokerStars Zoom Hand #247964906757:  Hold'em No Limit ($0.01/$0.02) - 2023/12/30 19:36:56 WET [2023/12/30 14:36:56 ET]
Table 'Halley' 6-max Seat #1 is the button
Seat 1: VIDOPRO23 ($1.26 in chips)
Seat 2: LLregs ($2.60 in chips)
Seat 3: frankquanki ($2.50 in chips)
Seat 4: RafaCartaxo ($2.20 in chips)
Seat 5: rowingboy ($1.52 in chips)
Seat 6: Raymond322 ($5.50 in chips)
LLregs: posts small blind $0.01
frankquanki: posts big blind $0.02
*** HOLE CARDS ***
Dealt to LLregs [9s 7s]
RafaCartaxo: raises $0.04 to $0.06
rowingboy: folds
Raymond322: calls $0.06
VIDOPRO23: folds
LLregs: calls $0.05
frankquanki: calls $0.04
*** FLOP *** [Qh 8c 7d]
LLregs: checks
frankquanki: checks
RafaCartaxo: checks
Raymond322: checks
*** TURN *** [Qh 8c 7d] [9d]
LLregs: bets $0.05
frankquanki: folds
RafaCartaxo: folds
Raymond322: calls $0.05
*** RIVER *** [Qh 8c 7d 9d] [3d]
LLregs: checks
Raymond322: checks
*** SHOW DOWN ***
LLregs: shows [9s 7s] (two pair, Nines and Sevens)
Raymond322: mucks hand
LLregs collected $0.33 from pot
*** SUMMARY ***
Total pot $0.34 | Rake $0.01
Board [Qh 8c 7d 9d 3d]
Seat 1: VIDOPRO23 (button) folded before Flop (didn't bet)
Seat 2: LLregs (small blind) showed [9s 7s] and won ($0.33) with two pair, Nines and Sevens
Seat 3: frankquanki (big blind) folded on the Turn
Seat 4: RafaCartaxo folded on the Turn
Seat 5: rowingboy folded before Flop (didn't bet)
Seat 6: Raymond322 mucked [2h 2s]

PokerStars Zoom Hand #247964933415:  Hold'em No Limit ($0.01/$0.02) - 2023/12/30 19:38:05 WET [2023/12/30 14:38:05 ET]
Table 'Halley' 6-max Seat #1 is the button
Seat 1: pöbel23 ($1.40 in chips)
Seat 2: 888lifeIS ($2.07 in chips)
Seat 3: LLregs ($2.82 in chips)
Seat 4: Ira Duchenko ($0.91 in chips)
Seat 5: Raymond322 ($5.39 in chips)
Seat 6: Ilikefossil ($2 in chips)
888lifeIS: posts small blind $0.01
LLregs: posts big blind $0.02
*** HOLE CARDS ***
Dealt to LLregs [9s 8c]
Ira Duchenko: calls $0.02
Raymond322: folds
Ilikefossil: folds
pöbel23: folds
888lifeIS: folds
LLregs: checks
*** FLOP *** [8d 9c 2c]
LLregs: checks
Ira Duchenko: checks
*** TURN *** [8d 9c 2c] [Qd]
LLregs: checks
Ira Duchenko: checks
*** RIVER *** [8d 9c 2c Qd] [5s]
LLregs: bets $0.04
Ira Duchenko: folds
Uncalled bet ($0.04) returned to LLregs
LLregs collected $0.05 from pot
LLregs: doesn't show hand
*** SUMMARY ***
Total pot $0.05 | Rake $0
Board [8d 9c 2c Qd 5s]
Seat 1: pöbel23 (button) folded before Flop (didn't bet)
Seat 2: 888lifeIS (small blind) folded before Flop
Seat 3: LLregs (big blind) collected ($0.05)
Seat 4: Ira Duchenko folded on the River
Seat 5: Raymond322 folded before Flop (didn't bet)
Seat 6: Ilikefossil folded before Flop (didn't bet)

PokerStars Zoom Hand #247964948444:  Hold'em No Limit ($0.01/$0.02) - 2023/12/30 19:38:44 WET [2023/12/30 14:38:44 ET]
Table 'Halley' 6-max Seat #1 is the button
Seat 1: LLregs ($2.85 in chips)
Seat 2: GeRA XG ($1.63 in chips)
Seat 3: 888lifeIS ($2.10 in chips)
Seat 4: sorokin21 ($2.98 in chips)
Seat 5: gari-188 ($1.80 in chips)
Seat 6: CrazyFairfox ($4.32 in chips)
GeRA XG: posts small blind $0.01
888lifeIS: posts big blind $0.02
*** HOLE CARDS ***
Dealt to LLregs [Ts Tc]
sorokin21: raises $0.04 to $0.06
gari-188: folds
CrazyFairfox: folds
LLregs: raises $0.12 to $0.18
GeRA XG: folds
888lifeIS: folds
sorokin21: calls $0.12
*** FLOP *** [Js Ah 7h]
sorokin21: checks
LLregs: bets $0.18
sorokin21: calls $0.18
*** TURN *** [Js Ah 7h] [2h]
sorokin21: checks
LLregs: checks
*** RIVER *** [Js Ah 7h 2h] [5c]
sorokin21: bets $0.19
LLregs: calls $0.19
*** SHOW DOWN ***
sorokin21: shows [Kh Ks] (a pair of Kings)
LLregs: mucks hand
sorokin21 collected $1.09 from pot
*** SUMMARY ***
Total pot $1.13 | Rake $0.04
Board [Js Ah 7h 2h 5c]
Seat 1: LLregs (button) mucked [Ts Tc]
Seat 2: GeRA XG (small blind) folded before Flop
Seat 3: 888lifeIS (big blind) folded before Flop
Seat 4: sorokin21 showed [Kh Ks] and won ($1.09) with a pair of Kings
Seat 5: gari-188 folded before Flop (didn't bet)
Seat 6: CrazyFairfox folded before Flop (didn't bet)

PokerStars Zoom Hand #247964973075:  Hold'em No Limit ($0.01/$0.02) - 2023/12/30 19:39:48 WET [2023/12/30 14:39:48 ET]
Table 'Halley' 6-max Seat #1 is the button
Seat 1: Alanxx77 ($2 in chips)
Seat 2: POOMPlT ($2 in chips)
Seat 3: dmitriy2426 ($2.27 in chips)
Seat 4: TheJunta ($2.07 in chips)
Seat 5: LLregs ($2.30 in chips)
Seat 6: Henrysport ($5.57 in chips)
POOMPlT: posts small blind $0.01
dmitriy2426: posts big blind $0.02
*** HOLE CARDS ***
Dealt to LLregs [9h 5h]
TheJunta: folds
LLregs has timed out
LLregs: folds
Henrysport: raises $0.03 to $0.05
Alanxx77: raises $0.10 to $0.15
POOMPlT: folds
dmitriy2426: folds
Henrysport: folds
Uncalled bet ($0.10) returned to Alanxx77
Alanxx77 collected $0.13 from pot
Alanxx77: doesn't show hand
*** SUMMARY ***
Total pot $0.13 | Rake $0
Seat 1: Alanxx77 (button) collected ($0.13)
Seat 2: POOMPlT (small blind) folded before Flop
Seat 3: dmitriy2426 (big blind) folded before Flop
Seat 4: TheJunta folded before Flop (didn't bet)
Seat 5: LLregs folded before Flop (didn't bet)
Seat 6: Henrysport folded before Flop

PokerStars Zoom Hand #247964983544:  Hold'em No Limit ($0.01/$0.02) - 2023/12/30 19:40:15 WET [2023/12/30 14:40:15 ET]
Table 'Halley' 6-max Seat #1 is the button
Seat 1: AdilsonMI ($0.45 in chips)
Seat 2: kalkulater ($4.29 in chips)
Seat 3: LLregs ($2.30 in chips)
Seat 4: Dr.Erguen ($1.42 in chips)
Seat 5: kosatkazostravy ($2.01 in chips)
Seat 6: xTheBulletsx ($2.01 in chips)
kalkulater: posts small blind $0.01
LLregs: posts big blind $0.02
*** HOLE CARDS ***
Dealt to LLregs [8s Th]
Dr.Erguen: folds
kosatkazostravy: folds
xTheBulletsx: folds
AdilsonMI: folds
kalkulater: raises $0.04 to $0.06
LLregs: folds
Uncalled bet ($0.04) returned to kalkulater
kalkulater collected $0.04 from pot
kalkulater: doesn't show hand
*** SUMMARY ***
Total pot $0.04 | Rake $0
Seat 1: AdilsonMI (button) folded before Flop (didn't bet)
Seat 2: kalkulater (small blind) collected ($0.04)
Seat 3: LLregs (big blind) folded before Flop
Seat 4: Dr.Erguen folded before Flop (didn't bet)
Seat 5: kosatkazostravy folded before Flop (didn't bet)
Seat 6: xTheBulletsx folded before Flop (didn't bet)

PokerStars Zoom Hand #247964989725:  Hold'em No Limit ($0.01/$0.02) - 2023/12/30 19:40:31 WET [2023/12/30 14:40:31 ET]
Table 'Halley' 6-max Seat #1 is the button
Seat 1: Ceesel ($3.63 in chips)
Seat 2: LLregs ($2.28 in chips)
Seat 3: Swordfish_31 ($2.12 in chips)
Seat 4: jesterka20 ($0.95 in chips)
Seat 5: santogr893 ($4.15 in chips)
Seat 6: POOMPlT ($2 in chips)
LLregs: posts small blind $0.01
Swordfish_31: posts big blind $0.02
*** HOLE CARDS ***
Dealt to LLregs [8s 4c]
jesterka20: folds
santogr893: raises $0.05 to $0.07
POOMPlT: folds
Ceesel: folds
LLregs: folds
Swordfish_31: folds
Uncalled bet ($0.05) returned to santogr893
santogr893 collected $0.05 from pot
santogr893: doesn't show hand
*** SUMMARY ***
Total pot $0.05 | Rake $0
Seat 1: Ceesel (button) folded before Flop (didn't bet)
Seat 2: LLregs (small blind) folded before Flop
Seat 3: Swordfish_31 (big blind) folded before Flop
Seat 4: jesterka20 folded before Flop (didn't bet)
Seat 5: santogr893 collected ($0.05)
Seat 6: POOMPlT folded before Flop (didn't bet)

PokerStars Zoom Hand #247964980099:  Hold'em No Limit ($0.01/$0.02) - 2023/12/30 19:40:06 WET [2023/12/30 14:40:06 ET]
Table 'Halley' 6-max Seat #1 is the button
Seat 1: frankquanki ($3.30 in chips)
Seat 2: 888lifeIS ($2 in chips)
Seat 3: Cris0ner ($2.55 in chips)
Seat 4: ARES_312 ($2.54 in chips)
Seat 5: cachusky ($3.21 in chips)
Seat 6: LLregs ($2.30 in chips)
888lifeIS: posts small blind $0.01
Cris0ner: posts big blind $0.02
*** HOLE CARDS ***
Dealt to LLregs [2s 9c]
ARES_312: folds
cachusky: raises $0.02 to $0.04
LLregs: folds
frankquanki: folds
888lifeIS: calls $0.03
Cris0ner: folds
*** FLOP *** [9s Ad 2h]
888lifeIS: checks
cachusky: bets $0.03
888lifeIS: calls $0.03
*** TURN *** [9s Ad 2h] [4s]
888lifeIS: checks
cachusky: bets $0.22
888lifeIS: folds
Uncalled bet ($0.22) returned to cachusky
cachusky collected $0.15 from pot
cachusky: doesn't show hand
*** SUMMARY ***
Total pot $0.16 | Rake $0.01
Board [9s Ad 2h 4s]
Seat 1: frankquanki (button) folded before Flop (didn't bet)
Seat 2: 888lifeIS (small blind) folded on the Turn
Seat 3: Cris0ner (big blind) folded before Flop
Seat 4: ARES_312 folded before Flop (didn't bet)
Seat 5: cachusky collected ($0.15)
Seat 6: LLregs folded before Flop (didn't bet)

PokerStars Zoom Hand #247964991202:  Hold'em No Limit ($0.01/$0.02) - 2023/12/30 19:40:35 WET [2023/12/30 14:40:35 ET]
Table 'Halley' 6-max Seat #1 is the button
Seat 1: LLregs ($2.27 in chips)
Seat 2: Moersik ($2.19 in chips)
Seat 3: Juonez ($2 in chips)
Seat 4: jesterka20 ($0.95 in chips)
Seat 5: barmaley164 ($1.90 in chips)
Seat 6: Mr Jodan ($2.87 in chips)
Moersik: posts small blind $0.01
Juonez: posts big blind $0.02
*** HOLE CARDS ***
Dealt to LLregs [Kh Qs]
jesterka20: folds
barmaley164: folds
Mr Jodan: folds
LLregs: raises $0.04 to $0.06
Moersik: raises $0.06 to $0.12
Juonez: folds
LLregs: calls $0.06
*** FLOP *** [Ks Tc 8s]
Moersik: checks
LLregs: bets $0.12
Moersik: calls $0.12
*** TURN *** [Ks Tc 8s] [9c]
Moersik: checks
LLregs: bets $0.23
Moersik: calls $0.23
*** RIVER *** [Ks Tc 8s 9c] [Ah]
Moersik: checks
LLregs: checks
*** SHOW DOWN ***
Moersik: shows [As 7s] (a pair of Aces)
LLregs: mucks hand
Moersik collected $0.93 from pot
*** SUMMARY ***
Total pot $0.96 | Rake $0.03
Board [Ks Tc 8s 9c Ah]
Seat 1: LLregs (button) mucked [Kh Qs]
Seat 2: Moersik (small blind) showed [As 7s] and won ($0.93) with a pair of Aces
Seat 3: Juonez (big blind) folded before Flop
Seat 4: jesterka20 folded before Flop (didn't bet)
Seat 5: barmaley164 folded before Flop (didn't bet)
Seat 6: Mr Jodan folded before Flop (didn't bet)

PokerStars Zoom Hand #247965009276:  Hold'em No Limit ($0.01/$0.02) - 2023/12/30 19:41:22 WET [2023/12/30 14:41:22 ET]
Table 'Halley' 6-max Seat #1 is the button
Seat 1: Geneticgear ($1.03 in chips)
Seat 2: AdilsonMI ($0.43 in chips)
Seat 3: napoli222 ($2.42 in chips)
Seat 4: LLregs ($2 in chips)
Seat 5: batya1212 ($2.68 in chips)
Seat 6: Slava Gvozdev ($1.75 in chips)
AdilsonMI: posts small blind $0.01
napoli222: posts big blind $0.02
*** HOLE CARDS ***
Dealt to LLregs [Jh 3h]
LLregs: folds
batya1212 is disconnected
batya1212 has timed out while disconnected
batya1212: folds
Slava Gvozdev: folds
Geneticgear: folds
AdilsonMI: folds
Uncalled bet ($0.01) returned to napoli222
napoli222 collected $0.02 from pot
napoli222: doesn't show hand
*** SUMMARY ***
Total pot $0.02 | Rake $0
Seat 1: Geneticgear (button) folded before Flop (didn't bet)
Seat 2: AdilsonMI (small blind) folded before Flop
Seat 3: napoli222 (big blind) collected ($0.02)
Seat 4: LLregs folded before Flop (didn't bet)
Seat 5: batya1212 folded before Flop (didn't bet)
Seat 6: Slava Gvozdev folded before Flop (didn't bet)

PokerStars Zoom Hand #247965011991:  Hold'em No Limit ($0.01/$0.02) - 2023/12/30 19:41:29 WET [2023/12/30 14:41:29 ET]
Table 'Halley' 6-max Seat #1 is the button
Seat 1: batya1212 ($2.45 in chips)
Seat 2: Gibsondelux ($0.71 in chips)
Seat 3: A•R•D377™7 ($0.99 in chips)
Seat 4: MR.BUMFLUFF ($2.03 in chips)
Seat 5: LLregs ($2 in chips)
Seat 6: doggie_bollocks ($0.94 in chips)
Gibsondelux: posts small blind $0.01
A•R•D377™7: posts big blind $0.02
*** HOLE CARDS ***
Dealt to LLregs [Jc 3d]
MR.BUMFLUFF: raises $0.02 to $0.04
LLregs: folds
doggie_bollocks: folds
batya1212 is disconnected
batya1212 has timed out while disconnected
batya1212: folds
Gibsondelux: folds
A•R•D377™7: folds
Uncalled bet ($0.02) returned to MR.BUMFLUFF
MR.BUMFLUFF collected $0.05 from pot
MR.BUMFLUFF: doesn't show hand
*** SUMMARY ***
Total pot $0.05 | Rake $0
Seat 1: batya1212 (button) folded before Flop (didn't bet)
Seat 2: Gibsondelux (small blind) folded before Flop
Seat 3: A•R•D377™7 (big blind) folded before Flop
Seat 4: MR.BUMFLUFF collected ($0.05)
Seat 5: LLregs folded before Flop (didn't bet)
Seat 6: doggie_bollocks folded before Flop (didn't bet)

PokerStars Zoom Hand #247965014237:  Hold'em No Limit ($0.01/$0.02) - 2023/12/30 19:41:35 WET [2023/12/30 14:41:35 ET]
Table 'Halley' 6-max Seat #1 is the button
Seat 1: 888lifeIS ($2.01 in chips)
Seat 2: xTheBulletsx ($2.29 in chips)
Seat 3: pandapo3000 ($1.73 in chips)
Seat 4: LLregs ($2 in chips)
Seat 5: pöbel23 ($1.07 in chips)
Seat 6: darkhexxer ($5.76 in chips)
xTheBulletsx: posts small blind $0.01
pandapo3000: posts big blind $0.02
*** HOLE CARDS ***
Dealt to LLregs [Ad Th]
LLregs: raises $0.04 to $0.06
pöbel23: calls $0.06
darkhexxer: folds
888lifeIS: folds
xTheBulletsx: raises $0.19 to $0.25
pandapo3000: folds
LLregs: folds
pöbel23: calls $0.19
*** FLOP *** [Jh 5h 4c]
xTheBulletsx: bets $0.20
pöbel23: calls $0.20
*** TURN *** [Jh 5h 4c] [8s]
xTheBulletsx: bets $0.63
pöbel23: calls $0.62 and is all-in
Uncalled bet ($0.01) returned to xTheBulletsx
*** RIVER *** [Jh 5h 4c 8s] [6d]
*** SHOW DOWN ***
xTheBulletsx: shows [Ah Jc] (a pair of Jacks)
pöbel23: shows [8d 7d] (a straight, Four to Eight)
pöbel23 collected $2.12 from pot
*** SUMMARY ***
Total pot $2.22 | Rake $0.10
Board [Jh 5h 4c 8s 6d]
Seat 1: 888lifeIS (button) folded before Flop (didn't bet)
Seat 2: xTheBulletsx (small blind) showed [Ah Jc] and lost with a pair of Jacks
Seat 3: pandapo3000 (big blind) folded before Flop
Seat 4: LLregs folded before Flop
Seat 5: pöbel23 showed [8d 7d] and won ($2.12) with a straight, Four to Eight
Seat 6: darkhexxer folded before Flop (didn't bet)

PokerStars Zoom Hand #247965024614:  Hold'em No Limit ($0.01/$0.02) - 2023/12/30 19:42:02 WET [2023/12/30 14:42:02 ET]
Table 'Halley' 6-max Seat #1 is the button
Seat 1: FEROIZ ($1.98 in chips)
Seat 2: ssapperlott ($1.88 in chips)
Seat 3: LLregs ($2 in chips)
Seat 4: RickyPoker ($2.71 in chips)
Seat 5: kuelas ($1.82 in chips)
Seat 6: GeRA XG ($1.64 in chips)
ssapperlott: posts small blind $0.01
LLregs: posts big blind $0.02
*** HOLE CARDS ***
Dealt to LLregs [Jd 6s]
RickyPoker: folds
kuelas: folds
GeRA XG: raises $0.02 to $0.04
FEROIZ: folds
ssapperlott: folds
LLregs: calls $0.02
*** FLOP *** [8c 5s Ah]
LLregs: checks
GeRA XG: checks
*** TURN *** [8c 5s Ah] [5c]
LLregs: checks
GeRA XG: checks
*** RIVER *** [8c 5s Ah 5c] [Kc]
LLregs: bets $0.02
GeRA XG: calls $0.02
*** SHOW DOWN ***
LLregs: shows [Jd 6s] (a pair of Fives)
GeRA XG: shows [Js Kh] (two pair, Kings and Fives)
GeRA XG collected $0.13 from pot
*** SUMMARY ***
Total pot $0.13 | Rake $0
Board [8c 5s Ah 5c Kc]
Seat 1: FEROIZ (button) folded before Flop (didn't bet)
Seat 2: ssapperlott (small blind) folded before Flop
Seat 3: LLregs (big blind) showed [Jd 6s] and lost with a pair of Fives
Seat 4: RickyPoker folded before Flop (didn't bet)
Seat 5: kuelas folded before Flop (didn't bet)
Seat 6: GeRA XG showed [Js Kh] and won ($0.13) with two pair, Kings and Fives

PokerStars Zoom Hand #247965043338:  Hold'em No Limit ($0.01/$0.02) - 2023/12/30 19:42:51 WET [2023/12/30 14:42:51 ET]
Table 'Halley' 6-max Seat #1 is the button
Seat 1: Swordfish_31 ($3.38 in chips)
Seat 2: Loucomeloo ($2 in chips)
Seat 3: cachusky ($3.18 in chips)
Seat 4: djmcool ($4.18 in chips)
Seat 5: Juonez ($2.05 in chips)
Seat 6: LLregs ($2 in chips)
Loucomeloo: posts small blind $0.01
cachusky: posts big blind $0.02
*** HOLE CARDS ***
Dealt to LLregs [9c 2d]
djmcool: folds
Juonez: folds
LLregs: folds
Swordfish_31: folds
Loucomeloo: folds
Uncalled bet ($0.01) returned to cachusky
cachusky collected $0.02 from pot
cachusky: doesn't show hand
*** SUMMARY ***
Total pot $0.02 | Rake $0
Seat 1: Swordfish_31 (button) folded before Flop (didn't bet)
Seat 2: Loucomeloo (small blind) folded before Flop
Seat 3: cachusky (big blind) collected ($0.02)
Seat 4: djmcool folded before Flop (didn't bet)
Seat 5: Juonez folded before Flop (didn't bet)
Seat 6: LLregs folded before Flop (didn't bet)

PokerStars Zoom Hand #247965045635:  Hold'em No Limit ($0.01/$0.02) - 2023/12/30 19:42:57 WET [2023/12/30 14:42:57 ET]
Table 'Halley' 6-max Seat #1 is the button
Seat 1: RafaCartaxo ($2.09 in chips)
Seat 2: LLregs ($2 in chips)
Seat 3: frankquanki ($2.63 in chips)
Seat 4: 888lifeIS ($3.86 in chips)
Seat 5: Plmax94 ($1.60 in chips)
Seat 6: Cris0ner ($8.23 in chips)
LLregs: posts small blind $0.01
frankquanki: posts big blind $0.02
*** HOLE CARDS ***
Dealt to LLregs [Js Ks]
888lifeIS: folds
Plmax94: calls $0.02
Cris0ner: folds
RafaCartaxo: folds
LLregs: raises $0.04 to $0.06
frankquanki: folds
Plmax94: calls $0.04
*** FLOP *** [Ah Kc 8c]
LLregs: checks
Plmax94: checks
*** TURN *** [Ah Kc 8c] [Qc]
LLregs: bets $0.03
Plmax94: folds
Uncalled bet ($0.03) returned to LLregs
LLregs collected $0.14 from pot
LLregs: doesn't show hand
*** SUMMARY ***
Total pot $0.14 | Rake $0
Board [Ah Kc 8c Qc]
Seat 1: RafaCartaxo (button) folded before Flop (didn't bet)
Seat 2: LLregs (small blind) collected ($0.14)
Seat 3: frankquanki (big blind) folded before Flop
Seat 4: 888lifeIS folded before Flop (didn't bet)
Seat 5: Plmax94 folded on the Turn
Seat 6: Cris0ner folded before Flop (didn't bet)

PokerStars Zoom Hand #247965058141:  Hold'em No Limit ($0.01/$0.02) - 2023/12/30 19:43:30 WET [2023/12/30 14:43:30 ET]
Table 'Halley' 6-max Seat #1 is the button
Seat 1: carbonero59 ($4.11 in chips)
Seat 2: Shizukas104 ($2.01 in chips)
Seat 3: ARES_312 ($2.41 in chips)
Seat 4: steph7208 ($0.90 in chips)
Seat 5: LLregs ($2.08 in chips)
Seat 6: napoli222 ($2 in chips)
Shizukas104: posts small blind $0.01
ARES_312: posts big blind $0.02
*** HOLE CARDS ***
Dealt to LLregs [3s 9s]
steph7208: raises $0.02 to $0.04
LLregs: folds
napoli222: folds
carbonero59: folds
Shizukas104: folds
ARES_312: folds
Uncalled bet ($0.02) returned to steph7208
steph7208 collected $0.05 from pot
steph7208: doesn't show hand
*** SUMMARY ***
Total pot $0.05 | Rake $0
Seat 1: carbonero59 (button) folded before Flop (didn't bet)
Seat 2: Shizukas104 (small blind) folded before Flop
Seat 3: ARES_312 (big blind) folded before Flop
Seat 4: steph7208 collected ($0.05)
Seat 5: LLregs folded before Flop (didn't bet)
Seat 6: napoli222 folded before Flop (didn't bet)

PokerStars Zoom Hand #247965059642:  Hold'em No Limit ($0.01/$0.02) - 2023/12/30 19:43:34 WET [2023/12/30 14:43:34 ET]
Table 'Halley' 6-max Seat #1 is the button
Seat 1: LLregs ($2.08 in chips)
Seat 2: VIDOPRO23 ($1.49 in chips)
Seat 3: PAMEGERA ($2.06 in chips)
Seat 4: nestor-ruso ($2.21 in chips)
Seat 5: vannstarzz ($2.52 in chips)
Seat 6: Jhosmelmino ($1.78 in chips)
VIDOPRO23: posts small blind $0.01
PAMEGERA: posts big blind $0.02
*** HOLE CARDS ***
Dealt to LLregs [7c Ad]
nestor-ruso: folds
vannstarzz: folds
Jhosmelmino: folds
LLregs: raises $0.04 to $0.06
VIDOPRO23: folds
PAMEGERA: folds
Uncalled bet ($0.04) returned to LLregs
LLregs collected $0.05 from pot
LLregs: doesn't show hand
*** SUMMARY ***
Total pot $0.05 | Rake $0
Seat 1: LLregs (button) collected ($0.05)
Seat 2: VIDOPRO23 (small blind) folded before Flop
Seat 3: PAMEGERA (big blind) folded before Flop
Seat 4: nestor-ruso folded before Flop (didn't bet)
Seat 5: vannstarzz folded before Flop (didn't bet)
Seat 6: Jhosmelmino folded before Flop (didn't bet)

PokerStars Zoom Hand #247965068438:  Hold'em No Limit ($0.01/$0.02) - 2023/12/30 19:43:58 WET [2023/12/30 14:43:58 ET]
Table 'Halley' 6-max Seat #1 is the button
Seat 1: Balonas ($2.11 in chips)
Seat 2: Bair157 ($2 in chips)
Seat 3: Wouzie ($1.46 in chips)
Seat 4: LLregs ($2.11 in chips)
Seat 5: NGx_Wilson ($3.25 in chips)
Seat 6: tolias1979 ($0.16 in chips)
Bair157: posts small blind $0.01
Wouzie: posts big blind $0.02
*** HOLE CARDS ***
Dealt to LLregs [4s Kc]
LLregs: folds
NGx_Wilson: folds
tolias1979: folds
Balonas: raises $0.02 to $0.04
Bair157: folds
Wouzie: folds
Uncalled bet ($0.02) returned to Balonas
Balonas collected $0.05 from pot
Balonas: doesn't show hand
*** SUMMARY ***
Total pot $0.05 | Rake $0
Seat 1: Balonas (button) collected ($0.05)
Seat 2: Bair157 (small blind) folded before Flop
Seat 3: Wouzie (big blind) folded before Flop
Seat 4: LLregs folded before Flop (didn't bet)
Seat 5: NGx_Wilson folded before Flop (didn't bet)
Seat 6: tolias1979 folded before Flop (didn't bet)

PokerStars Zoom Hand #247965069877:  Hold'em No Limit ($0.01/$0.02) - 2023/12/30 19:44:01 WET [2023/12/30 14:44:01 ET]
Table 'Halley' 6-max Seat #1 is the button
Seat 1: Racketeer 92 ($2.13 in chips)
Seat 2: Slava Gvozdev ($1.98 in chips)
Seat 3: Henrysport ($5.16 in chips)
Seat 4: LLregs ($2.11 in chips)
Seat 5: IrishPheonix ($2 in chips)
Seat 6: shovetoi ($2 in chips)
Slava Gvozdev: posts small blind $0.01
Henrysport: posts big blind $0.02
*** HOLE CARDS ***
Dealt to LLregs [8d As]
LLregs: folds
IrishPheonix: folds
shovetoi: folds
Racketeer 92: folds
Slava Gvozdev: raises $0.02 to $0.04
Henrysport: calls $0.02
*** FLOP *** [Qd 7c 3s]
Slava Gvozdev: bets $0.04
Henrysport: folds
Uncalled bet ($0.04) returned to Slava Gvozdev
Slava Gvozdev collected $0.08 from pot
Slava Gvozdev: doesn't show hand
*** SUMMARY ***
Total pot $0.08 | Rake $0
Board [Qd 7c 3s]
Seat 1: Racketeer 92 (button) folded before Flop (didn't bet)
Seat 2: Slava Gvozdev (small blind) collected ($0.08)
Seat 3: Henrysport (big blind) folded on the Flop
Seat 4: LLregs folded before Flop (didn't bet)
Seat 5: IrishPheonix folded before Flop (didn't bet)
Seat 6: shovetoi folded before Flop (didn't bet)

PokerStars Zoom Hand #247965071169:  Hold'em No Limit ($0.01/$0.02) - 2023/12/30 19:44:05 WET [2023/12/30 14:44:05 ET]
Table 'Halley' 6-max Seat #1 is the button
Seat 1: joejordisson ($4.88 in chips)
Seat 2: CrazyFairfox ($4.26 in chips)
Seat 3: LLregs ($2.11 in chips)
Seat 4: djmcool ($2 in chips)
Seat 5: conspy84 ($3.22 in chips)
Seat 6: Dranton73 ($4.49 in chips)
CrazyFairfox: posts small blind $0.01
LLregs: posts big blind $0.02
*** HOLE CARDS ***
Dealt to LLregs [Kh 4c]
djmcool: folds
conspy84 has timed out
conspy84: folds
Dranton73: raises $0.03 to $0.05
joejordisson: folds
CrazyFairfox: folds
LLregs: raises $0.09 to $0.14
Dranton73: calls $0.09
*** FLOP *** [9d Ad 5d]
LLregs: checks
Dranton73: bets $0.09
LLregs: folds
Uncalled bet ($0.09) returned to Dranton73
Dranton73 collected $0.28 from pot
Dranton73: doesn't show hand
*** SUMMARY ***
Total pot $0.29 | Rake $0.01
Board [9d Ad 5d]
Seat 1: joejordisson (button) folded before Flop (didn't bet)
Seat 2: CrazyFairfox (small blind) folded before Flop
Seat 3: LLregs (big blind) folded on the Flop
Seat 4: djmcool folded before Flop (didn't bet)
Seat 5: conspy84 folded before Flop (didn't bet)
Seat 6: Dranton73 collected ($0.28)

PokerStars Zoom Hand #247965084923:  Hold'em No Limit ($0.01/$0.02) - 2023/12/30 19:44:41 WET [2023/12/30 14:44:41 ET]
Table 'Halley' 6-max Seat #1 is the button
Seat 1: steph7208 ($1.01 in chips)
Seat 2: LLregs ($2 in chips)
Seat 3: bettanye ($2 in chips)
Seat 4: RocketFir271 ($2 in chips)
Seat 5: Plmax94 ($1.58 in chips)
Seat 6: AdilsonMI ($1.04 in chips)
LLregs: posts small blind $0.01
bettanye: posts big blind $0.02
*** HOLE CARDS ***
Dealt to LLregs [4h Ad]
RocketFir271: folds
Plmax94: folds
AdilsonMI: folds
steph7208: raises $0.02 to $0.04
LLregs: folds
bettanye: folds
Uncalled bet ($0.02) returned to steph7208
steph7208 collected $0.05 from pot
steph7208: doesn't show hand
*** SUMMARY ***
Total pot $0.05 | Rake $0
Seat 1: steph7208 (button) collected ($0.05)
Seat 2: LLregs (small blind) folded before Flop
Seat 3: bettanye (big blind) folded before Flop
Seat 4: RocketFir271 folded before Flop (didn't bet)
Seat 5: Plmax94 folded before Flop (didn't bet)
Seat 6: AdilsonMI folded before Flop (didn't bet)

PokerStars Zoom Hand #247965086549:  Hold'em No Limit ($0.01/$0.02) - 2023/12/30 19:44:45 WET [2023/12/30 14:44:45 ET]
Table 'Halley' 6-max Seat #1 is the button
Seat 1: nestor-ruso ($2.02 in chips)
Seat 2: Tosche34 ($2 in chips)
Seat 3: sexynurseama ($2 in chips)
Seat 4: Poccoon ($1.52 in chips)
Seat 5: iamknight ($2.67 in chips)
Seat 6: LLregs ($2 in chips)
Tosche34: posts small blind $0.01
sexynurseama: posts big blind $0.02
*** HOLE CARDS ***
Dealt to LLregs [8c 4s]
Poccoon: raises $0.03 to $0.05
iamknight: folds
LLregs: folds
nestor-ruso: folds
Tosche34: folds
sexynurseama: calls $0.03
*** FLOP *** [6d Js Tc]
sexynurseama: checks
Poccoon: bets $0.08
sexynurseama: calls $0.08
*** TURN *** [6d Js Tc] [Qh]
sexynurseama: checks
Poccoon: bets $0.18
sexynurseama: calls $0.18
*** RIVER *** [6d Js Tc Qh] [3s]
sexynurseama: checks
Poccoon: checks
*** SHOW DOWN ***
sexynurseama: shows [Jc Kh] (a pair of Jacks)
Poccoon: shows [Kd Jd] (a pair of Jacks)
sexynurseama collected $0.31 from pot
Poccoon collected $0.30 from pot
*** SUMMARY ***
Total pot $0.63 | Rake $0.02
Board [6d Js Tc Qh 3s]
Seat 1: nestor-ruso (button) folded before Flop (didn't bet)
Seat 2: Tosche34 (small blind) folded before Flop
Seat 3: sexynurseama (big blind) showed [Jc Kh] and won ($0.31) with a pair of Jacks
Seat 4: Poccoon showed [Kd Jd] and won ($0.30) with a pair of Jacks
Seat 5: iamknight folded before Flop (didn't bet)
Seat 6: LLregs folded before Flop (didn't bet)

PokerStars Zoom Hand #247965087888:  Hold'em No Limit ($0.01/$0.02) - 2023/12/30 19:44:49 WET [2023/12/30 14:44:49 ET]
Table 'Halley' 6-max Seat #1 is the button
Seat 1: LLregs ($2 in chips)
Seat 2: Silvers14 ($2.02 in chips)
Seat 3: Kamylo20 ($3.17 in chips)
Seat 4: IanMacDaddy ($3.01 in chips)
Seat 5: dmitriy2426 ($2.32 in chips)
Seat 6: conspy84 ($2.20 in chips)
Silvers14: posts small blind $0.01
Kamylo20: posts big blind $0.02
*** HOLE CARDS ***
Dealt to LLregs [Qs 5s]
IanMacDaddy: folds
dmitriy2426: folds
conspy84: raises $0.02 to $0.04
LLregs: raises $0.02 to $0.06
Silvers14: folds
Kamylo20: calls $0.04
conspy84: calls $0.02
*** FLOP *** [2c 6d 3d]
Kamylo20: checks
conspy84: bets $0.04
LLregs: calls $0.04
Kamylo20: calls $0.04
*** TURN *** [2c 6d 3d] [7c]
Kamylo20: checks
conspy84: checks
LLregs: bets $0.10
Kamylo20: calls $0.10
conspy84: folds
*** RIVER *** [2c 6d 3d 7c] [Js]
Kamylo20: checks
LLregs: bets $0.24
Kamylo20: folds
Uncalled bet ($0.24) returned to LLregs
LLregs collected $0.49 from pot
LLregs: doesn't show hand
*** SUMMARY ***
Total pot $0.51 | Rake $0.02
Board [2c 6d 3d 7c Js]
Seat 1: LLregs (button) collected ($0.49)
Seat 2: Silvers14 (small blind) folded before Flop
Seat 3: Kamylo20 (big blind) folded on the River
Seat 4: IanMacDaddy folded before Flop (didn't bet)
Seat 5: dmitriy2426 folded before Flop (didn't bet)
Seat 6: conspy84 folded on the Turn

PokerStars Zoom Hand #247965122362:  Hold'em No Limit ($0.01/$0.02) - 2023/12/30 19:46:19 WET [2023/12/30 14:46:19 ET]
Table 'Halley' 6-max Seat #1 is the button
Seat 1: davidbarrels ($1.97 in chips)
Seat 2: LLregs ($2.29 in chips)
Seat 3: kakani78 ($2.02 in chips)
Seat 4: mangalisa ($3.33 in chips)
Seat 5: Tosche34 ($2.06 in chips)
Seat 6: IrishPheonix ($2.19 in chips)
LLregs: posts small blind $0.01
kakani78: posts big blind $0.02
*** HOLE CARDS ***
Dealt to LLregs [8c 8d]
mangalisa has timed out
mangalisa: folds
Tosche34: folds
IrishPheonix: folds
davidbarrels: raises $0.04 to $0.06
LLregs: raises $0.12 to $0.18
kakani78: folds
davidbarrels: calls $0.12
*** FLOP *** [Qs Td Ks]
LLregs: checks
davidbarrels: checks
*** TURN *** [Qs Td Ks] [7d]
LLregs: bets $0.08
davidbarrels: calls $0.08
*** RIVER *** [Qs Td Ks 7d] [Tc]
LLregs: checks
davidbarrels: checks
*** SHOW DOWN ***
LLregs: shows [8c 8d] (two pair, Tens and Eights)
davidbarrels: shows [Qc Ah] (two pair, Queens and Tens)
davidbarrels collected $0.52 from pot
*** SUMMARY ***
Total pot $0.54 | Rake $0.02
Board [Qs Td Ks 7d Tc]
Seat 1: davidbarrels (button) showed [Qc Ah] and won ($0.52) with two pair, Queens and Tens
Seat 2: LLregs (small blind) showed [8c 8d] and lost with two pair, Tens and Eights
Seat 3: kakani78 (big blind) folded before Flop
Seat 4: mangalisa folded before Flop (didn't bet)
Seat 5: Tosche34 folded before Flop (didn't bet)
Seat 6: IrishPheonix folded before Flop (didn't bet)

PokerStars Zoom Hand #247965148966:  Hold'em No Limit ($0.01/$0.02) - 2023/12/30 19:47:28 WET [2023/12/30 14:47:28 ET]
Table 'Halley' 6-max Seat #1 is the button
Seat 1: danielkiel ($2.03 in chips)
Seat 2: bandini111 ($1.24 in chips)
Seat 3: barmaley164 ($1.91 in chips)
Seat 4: Coconuthead23 ($5.66 in chips)
Seat 5: N0tsobig ($4.28 in chips)
Seat 6: LLregs ($2.03 in chips)
bandini111: posts small blind $0.01
barmaley164: posts big blind $0.02
*** HOLE CARDS ***
Dealt to LLregs [4c Ts]
Coconuthead23: folds
N0tsobig: folds
LLregs: folds
danielkiel: folds
bandini111: folds
Uncalled bet ($0.01) returned to barmaley164
barmaley164 collected $0.02 from pot
barmaley164: doesn't show hand
*** SUMMARY ***
Total pot $0.02 | Rake $0
Seat 1: danielkiel (button) folded before Flop (didn't bet)
Seat 2: bandini111 (small blind) folded before Flop
Seat 3: barmaley164 (big blind) collected ($0.02)
Seat 4: Coconuthead23 folded before Flop (didn't bet)
Seat 5: N0tsobig folded before Flop (didn't bet)
Seat 6: LLregs folded before Flop (didn't bet)

PokerStars Zoom Hand #247965151402:  Hold'em No Limit ($0.01/$0.02) - 2023/12/30 19:47:35 WET [2023/12/30 14:47:35 ET]
Table 'Halley' 6-max Seat #1 is the button
Seat 1: iamknight ($3.19 in chips)
Seat 2: begui150507 ($2.89 in chips)
Seat 3: IrishPheonix ($2.18 in chips)
Seat 4: Sperick ($2.08 in chips)
Seat 5: LLregs ($2.03 in chips)
Seat 6: santogr893 ($4.01 in chips)
begui150507: posts small blind $0.01
IrishPheonix: posts big blind $0.02
*** HOLE CARDS ***
Dealt to LLregs [6h 4h]
Sperick: folds
LLregs: folds
santogr893: folds
iamknight: folds
begui150507: folds
Uncalled bet ($0.01) returned to IrishPheonix
IrishPheonix collected $0.02 from pot
IrishPheonix: doesn't show hand
*** SUMMARY ***
Total pot $0.02 | Rake $0
Seat 1: iamknight (button) folded before Flop (didn't bet)
Seat 2: begui150507 (small blind) folded before Flop
Seat 3: IrishPheonix (big blind) collected ($0.02)
Seat 4: Sperick folded before Flop (didn't bet)
Seat 5: LLregs folded before Flop (didn't bet)
Seat 6: santogr893 folded before Flop (didn't bet)

PokerStars Zoom Hand #247965152947:  Hold'em No Limit ($0.01/$0.02) - 2023/12/30 19:47:39 WET [2023/12/30 14:47:39 ET]
Table 'Halley' 6-max Seat #1 is the button
Seat 1: LDenisL ($2.26 in chips)
Seat 2: Coconuthead23 ($2.01 in chips)
Seat 3: LLregs ($2.03 in chips)
Seat 4: MR.BUMFLUFF ($2.02 in chips)
Seat 5: cachusky ($2.38 in chips)
Seat 6: oleksandr_k3 ($2.11 in chips)
Coconuthead23: posts small blind $0.01
LLregs: posts big blind $0.02
*** HOLE CARDS ***
Dealt to LLregs [2h 8s]
MR.BUMFLUFF: raises $0.02 to $0.04
cachusky: folds
oleksandr_k3: folds
LDenisL: folds
Coconuthead23: folds
LLregs: folds
Uncalled bet ($0.02) returned to MR.BUMFLUFF
MR.BUMFLUFF collected $0.05 from pot
MR.BUMFLUFF: doesn't show hand
*** SUMMARY ***
Total pot $0.05 | Rake $0
Seat 1: LDenisL (button) folded before Flop (didn't bet)
Seat 2: Coconuthead23 (small blind) folded before Flop
Seat 3: LLregs (big blind) folded before Flop
Seat 4: MR.BUMFLUFF collected ($0.05)
Seat 5: cachusky folded before Flop (didn't bet)
Seat 6: oleksandr_k3 folded before Flop (didn't bet)

PokerStars Zoom Hand #247965158452:  Hold'em No Limit ($0.01/$0.02) - 2023/12/30 19:47:53 WET [2023/12/30 14:47:53 ET]
Table 'Halley' 6-max Seat #1 is the button
Seat 1: Ukr Troll ($9 in chips)
Seat 2: CANYA_V ($3.69 in chips)
Seat 3: tessinator89 ($2 in chips)
Seat 4: LLregs ($2.01 in chips)
Seat 5: allergy2nuts ($3.16 in chips)
Seat 6: Coconuthead23 ($2 in chips)
CANYA_V: posts small blind $0.01
tessinator89: posts big blind $0.02
*** HOLE CARDS ***
Dealt to LLregs [Js 9h]
LLregs: folds
allergy2nuts: folds
Coconuthead23: folds
Ukr Troll: folds
CANYA_V: folds
Uncalled bet ($0.01) returned to tessinator89
tessinator89 collected $0.02 from pot
tessinator89: doesn't show hand
*** SUMMARY ***
Total pot $0.02 | Rake $0
Seat 1: Ukr Troll (button) folded before Flop (didn't bet)
Seat 2: CANYA_V (small blind) folded before Flop
Seat 3: tessinator89 (big blind) collected ($0.02)
Seat 4: LLregs folded before Flop (didn't bet)
Seat 5: allergy2nuts folded before Flop (didn't bet)
Seat 6: Coconuthead23 folded before Flop (didn't bet)

PokerStars Zoom Hand #247965155612:  Hold'em No Limit ($0.01/$0.02) - 2023/12/30 19:47:46 WET [2023/12/30 14:47:46 ET]
Table 'Halley' 6-max Seat #1 is the button
Seat 1: LLregs ($2.01 in chips)
Seat 2: Leleo600 ($2.04 in chips)
Seat 3: shovetoi ($2.07 in chips)
Seat 4: mangalisa ($2.53 in chips)
Seat 5: Plmax94 ($1.46 in chips)
Seat 6: roz534 ($1.89 in chips)
Leleo600: posts small blind $0.01
shovetoi: posts big blind $0.02
*** HOLE CARDS ***
Dealt to LLregs [8s 3d]
mangalisa: folds
Plmax94: folds
roz534: calls $0.02
LLregs: folds
Leleo600: calls $0.01
shovetoi: raises $0.08 to $0.10
roz534: folds
Leleo600: calls $0.08
*** FLOP *** [Jd Tc Qc]
Leleo600: checks
shovetoi: checks
*** TURN *** [Jd Tc Qc] [8d]
Leleo600: checks
shovetoi: bets $0.11
Leleo600: calls $0.11
*** RIVER *** [Jd Tc Qc 8d] [Jh]
Leleo600: bets $0.42
shovetoi: calls $0.42
*** SHOW DOWN ***
Leleo600: shows [7c As] (a pair of Jacks)
shovetoi: shows [9c 9d] (a straight, Eight to Queen)
shovetoi collected $1.24 from pot
*** SUMMARY ***
Total pot $1.28 | Rake $0.04
Board [Jd Tc Qc 8d Jh]
Seat 1: LLregs (button) folded before Flop (didn't bet)
Seat 2: Leleo600 (small blind) showed [7c As] and lost with a pair of Jacks
Seat 3: shovetoi (big blind) showed [9c 9d] and won ($1.24) with a straight, Eight to Queen
Seat 4: mangalisa folded before Flop (didn't bet)
Seat 5: Plmax94 folded before Flop (didn't bet)
Seat 6: roz534 folded before Flop

PokerStars Zoom Hand #247965161059:  Hold'em No Limit ($0.01/$0.02) - 2023/12/30 19:48:00 WET [2023/12/30 14:48:00 ET]
Table 'Halley' 6-max Seat #1 is the button
Seat 1: 232489410 ($2.13 in chips)
Seat 2: POOMPlT ($2.84 in chips)
Seat 3: LLregs ($2.01 in chips)
Seat 4: frankquanki ($1.54 in chips)
Seat 5: picasso987 ($1.61 in chips)
Seat 6: aproximo ($2.32 in chips)
POOMPlT: posts small blind $0.01
LLregs: posts big blind $0.02
*** HOLE CARDS ***
Dealt to LLregs [Th Ad]
frankquanki: folds
picasso987: raises $1.59 to $1.61 and is all-in
aproximo: folds
232489410: folds
POOMPlT: folds
LLregs: calls $1.59
picasso987 has timed out
*** FLOP *** [4c Ts 8h]
*** TURN *** [4c Ts 8h] [9h]
*** RIVER *** [4c Ts 8h 9h] [4s]
*** SHOW DOWN ***
LLregs: shows [Th Ad] (two pair, Tens and Fours)
picasso987: shows [Ks Qh] (a pair of Fours)
LLregs collected $3.12 from pot
*** SUMMARY ***
Total pot $3.23 | Rake $0.11
Board [4c Ts 8h 9h 4s]
Seat 1: 232489410 (button) folded before Flop (didn't bet)
Seat 2: POOMPlT (small blind) folded before Flop
Seat 3: LLregs (big blind) showed [Th Ad] and won ($3.12) with two pair, Tens and Fours
Seat 4: frankquanki folded before Flop (didn't bet)
Seat 5: picasso987 showed [Ks Qh] and lost with a pair of Fours
Seat 6: aproximo folded before Flop (didn't bet)

PokerStars Zoom Hand #247965157086:  Hold'em No Limit ($0.01/$0.02) - 2023/12/30 19:47:50 WET [2023/12/30 14:47:50 ET]
Table 'Halley' 6-max Seat #1 is the button
Seat 1: Sperick ($2.07 in chips)
Seat 2: gDjambo ($3.30 in chips)
Seat 3: fernandokonno ($0.98 in chips)
Seat 4: rowingboy ($6.25 in chips)
Seat 5: LLregs ($2.01 in chips)
Seat 6: bettanye ($2.09 in chips)
gDjambo: posts small blind $0.01
fernandokonno: posts big blind $0.02
*** HOLE CARDS ***
Dealt to LLregs [Ah 9s]
rowingboy has timed out
rowingboy: folds
LLregs: folds
bettanye: folds
Sperick: raises $0.03 to $0.05
gDjambo: folds
fernandokonno: folds
Uncalled bet ($0.03) returned to Sperick
Sperick collected $0.05 from pot
Sperick: doesn't show hand
*** SUMMARY ***
Total pot $0.05 | Rake $0
Seat 1: Sperick (button) collected ($0.05)
Seat 2: gDjambo (small blind) folded before Flop
Seat 3: fernandokonno (big blind) folded before Flop
Seat 4: rowingboy folded before Flop (didn't bet)
Seat 5: LLregs folded before Flop (didn't bet)
Seat 6: bettanye folded before Flop (didn't bet)

PokerStars Zoom Hand #247965159736:  Hold'em No Limit ($0.01/$0.02) - 2023/12/30 19:47:57 WET [2023/12/30 14:47:57 ET]
Table 'Halley' 6-max Seat #1 is the button
Seat 1: marcegring ($1.87 in chips)
Seat 2: JaUm_V ($7.82 in chips)
Seat 3: napoli222 ($3.07 in chips)
Seat 4: LLregs ($2.01 in chips)
Seat 5: djmcool ($4.30 in chips)
Seat 6: jagiellonia1 ($0.92 in chips)
JaUm_V: posts small blind $0.01
napoli222: posts big blind $0.02
*** HOLE CARDS ***
Dealt to LLregs [Kh 4d]
LLregs: folds
djmcool: folds
jagiellonia1: folds
marcegring: folds
JaUm_V: raises $0.04 to $0.06
napoli222: folds
Uncalled bet ($0.04) returned to JaUm_V
JaUm_V collected $0.04 from pot
JaUm_V: doesn't show hand
*** SUMMARY ***
Total pot $0.04 | Rake $0
Seat 1: marcegring (button) folded before Flop (didn't bet)
Seat 2: JaUm_V (small blind) collected ($0.04)
Seat 3: napoli222 (big blind) folded before Flop
Seat 4: LLregs folded before Flop (didn't bet)
Seat 5: djmcool folded before Flop (didn't bet)
Seat 6: jagiellonia1 folded before Flop (didn't bet)

PokerStars Zoom Hand #247965177096:  Hold'em No Limit ($0.01/$0.02) - 2023/12/30 19:48:43 WET [2023/12/30 14:48:43 ET]
Table 'Halley' 6-max Seat #1 is the button
Seat 1: Geneticgear ($0.90 in chips)
Seat 2: LLregs ($3.52 in chips)
Seat 3: GeRA XG ($1.91 in chips)
Seat 4: 888lifeIS ($2 in chips)
Seat 5: AdilsonMI ($1.01 in chips)
Seat 6: RamGur ($2.15 in chips)
LLregs: posts small blind $0.01
GeRA XG: posts big blind $0.02
*** HOLE CARDS ***
Dealt to LLregs [Kc Tc]
888lifeIS: folds
AdilsonMI: folds
RamGur: folds
Geneticgear: folds
LLregs: raises $0.04 to $0.06
GeRA XG: folds
Uncalled bet ($0.04) returned to LLregs
LLregs collected $0.04 from pot
LLregs: doesn't show hand
*** SUMMARY ***
Total pot $0.04 | Rake $0
Seat 1: Geneticgear (button) folded before Flop (didn't bet)
Seat 2: LLregs (small blind) collected ($0.04)
Seat 3: GeRA XG (big blind) folded before Flop
Seat 4: 888lifeIS folded before Flop (didn't bet)
Seat 5: AdilsonMI folded before Flop (didn't bet)
Seat 6: RamGur folded before Flop (didn't bet)

PokerStars Zoom Hand #247965175244:  Hold'em No Limit ($0.01/$0.02) - 2023/12/30 19:48:38 WET [2023/12/30 14:48:38 ET]
Table 'Halley' 6-max Seat #1 is the button
Seat 1: Shizukas104 ($2.16 in chips)
Seat 2: ConnyNapkin ($2.36 in chips)
Seat 3: Ready2Rollu ($2 in chips)
Seat 4: 5ars33r ($2.32 in chips)
Seat 5: WarriorM7 ($1.99 in chips)
Seat 6: LLregs ($3.52 in chips)
ConnyNapkin: posts small blind $0.01
Ready2Rollu: posts big blind $0.02
*** HOLE CARDS ***
Dealt to LLregs [3c Jd]
5ars33r: raises $0.03 to $0.05
WarriorM7: folds
LLregs: folds
Shizukas104: folds
ConnyNapkin: folds
Ready2Rollu: calls $0.03
*** FLOP *** [6s 7d 7h]
Ready2Rollu: checks
5ars33r: bets $0.04
Ready2Rollu: raises $0.08 to $0.12
5ars33r: folds
Uncalled bet ($0.08) returned to Ready2Rollu
Ready2Rollu collected $0.18 from pot
Ready2Rollu: doesn't show hand
*** SUMMARY ***
Total pot $0.19 | Rake $0.01
Board [6s 7d 7h]
Seat 1: Shizukas104 (button) folded before Flop (didn't bet)
Seat 2: ConnyNapkin (small blind) folded before Flop
Seat 3: Ready2Rollu (big blind) collected ($0.18)
Seat 4: 5ars33r folded on the Flop
Seat 5: WarriorM7 folded before Flop (didn't bet)
Seat 6: LLregs folded before Flop (didn't bet)

PokerStars Zoom Hand #247965187331:  Hold'em No Limit ($0.01/$0.02) - 2023/12/30 19:49:09 WET [2023/12/30 14:49:09 ET]
Table 'Halley' 6-max Seat #1 is the button
Seat 1: PAMEGERA ($2.09 in chips)
Seat 2: danielkiel ($2.05 in chips)
Seat 3: Kamylo20 ($3.04 in chips)
Seat 4: grodsnok ($1.25 in chips)
Seat 5: LLregs ($3.54 in chips)
Seat 6: sexynurseama ($2.36 in chips)
danielkiel: posts small blind $0.01
Kamylo20: posts big blind $0.02
*** HOLE CARDS ***
Dealt to LLregs [Jd Js]
grodsnok: raises $0.03 to $0.05
LLregs: raises $0.15 to $0.20
sexynurseama: folds
PAMEGERA: folds
danielkiel: folds
Kamylo20: folds
grodsnok: folds
Uncalled bet ($0.15) returned to LLregs
LLregs collected $0.13 from pot
LLregs: doesn't show hand
*** SUMMARY ***
Total pot $0.13 | Rake $0
Seat 1: PAMEGERA (button) folded before Flop (didn't bet)
Seat 2: danielkiel (small blind) folded before Flop
Seat 3: Kamylo20 (big blind) folded before Flop
Seat 4: grodsnok folded before Flop
Seat 5: LLregs collected ($0.13)
Seat 6: sexynurseama folded before Flop (didn't bet)

PokerStars Zoom Hand #247965199696:  Hold'em No Limit ($0.01/$0.02) - 2023/12/30 19:49:42 WET [2023/12/30 14:49:42 ET]
Table 'Halley' 6-max Seat #1 is the button
Seat 1: Sulynnmx ($1.23 in chips)
Seat 2: gilmar080586 ($0.82 in chips)
Seat 3: Juonez ($2.29 in chips)
Seat 4: LLregs ($3.62 in chips)
Seat 5: bignelsonAK ($0.97 in chips)
Seat 6: simka567 ($1.09 in chips)
gilmar080586: posts small blind $0.01
Juonez: posts big blind $0.02
*** HOLE CARDS ***
Dealt to LLregs [2c Jd]
LLregs: folds
bignelsonAK: folds
simka567: folds
Sulynnmx: raises $0.06 to $0.08
gilmar080586: folds
Juonez: folds
Uncalled bet ($0.06) returned to Sulynnmx
Sulynnmx collected $0.05 from pot
Sulynnmx: doesn't show hand
*** SUMMARY ***
Total pot $0.05 | Rake $0
Seat 1: Sulynnmx (button) collected ($0.05)
Seat 2: gilmar080586 (small blind) folded before Flop
Seat 3: Juonez (big blind) folded before Flop
Seat 4: LLregs folded before Flop (didn't bet)
Seat 5: bignelsonAK folded before Flop (didn't bet)
Seat 6: simka567 folded before Flop (didn't bet)

PokerStars Zoom Hand #247965203198:  Hold'em No Limit ($0.01/$0.02) - 2023/12/30 19:49:51 WET [2023/12/30 14:49:51 ET]
Table 'Halley' 6-max Seat #1 is the button
Seat 1: MR.BUMFLUFF ($2.06 in chips)
Seat 2: Slava Gvozdev ($1.98 in chips)
Seat 3: hugopacifico ($1.87 in chips)
Seat 4: Tosche34 ($2.01 in chips)
Seat 5: djmcool ($4.22 in chips)
Seat 6: LLregs ($3.62 in chips)
Slava Gvozdev: posts small blind $0.01
hugopacifico: posts big blind $0.02
*** HOLE CARDS ***
Dealt to LLregs [5s 6d]
Tosche34: folds
djmcool: folds
LLregs: folds
MR.BUMFLUFF: folds
Slava Gvozdev: folds
Uncalled bet ($0.01) returned to hugopacifico
hugopacifico collected $0.02 from pot
hugopacifico: doesn't show hand
*** SUMMARY ***
Total pot $0.02 | Rake $0
Seat 1: MR.BUMFLUFF (button) folded before Flop (didn't bet)
Seat 2: Slava Gvozdev (small blind) folded before Flop
Seat 3: hugopacifico (big blind) collected ($0.02)
Seat 4: Tosche34 folded before Flop (didn't bet)
Seat 5: djmcool folded before Flop (didn't bet)
Seat 6: LLregs folded before Flop (didn't bet)

PokerStars Zoom Hand #247965201620:  Hold'em No Limit ($0.01/$0.02) - 2023/12/30 19:49:47 WET [2023/12/30 14:49:47 ET]
Table 'Halley' 6-max Seat #1 is the button
Seat 1: LLregs ($3.62 in chips)
Seat 2: DeepRybka10 ($2.01 in chips)
Seat 3: ivan281011 ($5.58 in chips)
Seat 4: Ready2Rollu ($2.11 in chips)
Seat 5: Sperick ($2 in chips)
Seat 6: rjana165 ($1.33 in chips)
DeepRybka10: posts small blind $0.01
ivan281011: posts big blind $0.02
*** HOLE CARDS ***
Dealt to LLregs [4c Jh]
Ready2Rollu: folds
Sperick: folds
rjana165: calls $0.02
LLregs: folds
DeepRybka10: folds
ivan281011: checks
*** FLOP *** [Qc Jd As]
ivan281011: checks
rjana165: bets $0.02
ivan281011: folds
Uncalled bet ($0.02) returned to rjana165
rjana165 collected $0.05 from pot
rjana165: doesn't show hand
*** SUMMARY ***
Total pot $0.05 | Rake $0
Board [Qc Jd As]
Seat 1: LLregs (button) folded before Flop (didn't bet)
Seat 2: DeepRybka10 (small blind) folded before Flop
Seat 3: ivan281011 (big blind) folded on the Flop
Seat 4: Ready2Rollu folded before Flop (didn't bet)
Seat 5: Sperick folded before Flop (didn't bet)
Seat 6: rjana165 collected ($0.05)

PokerStars Zoom Hand #247965204683:  Hold'em No Limit ($0.01/$0.02) - 2023/12/30 19:49:55 WET [2023/12/30 14:49:55 ET]
Table 'Halley' 6-max Seat #1 is the button
Seat 1: PR3SUR3 ($2.07 in chips)
Seat 2: LLregs ($3.62 in chips)
Seat 3: Swarleyyyy ($2 in chips)
Seat 4: Rosa Chic671 ($4.13 in chips)
Seat 5: iliyan66 ($9.76 in chips)
Seat 6: Peresmehnik1 ($2.41 in chips)
LLregs: posts small blind $0.01
Swarleyyyy: posts big blind $0.02
*** HOLE CARDS ***
Dealt to LLregs [7d 9c]
Rosa Chic671: folds
iliyan66: folds
Peresmehnik1: folds
PR3SUR3: folds
LLregs: raises $0.04 to $0.06
Swarleyyyy: calls $0.04
*** FLOP *** [7s 2c 4d]
LLregs: bets $0.03
Swarleyyyy: calls $0.03
*** TURN *** [7s 2c 4d] [8d]
LLregs: bets $0.04
Swarleyyyy: raises $0.17 to $0.21
LLregs: calls $0.17
*** RIVER *** [7s 2c 4d 8d] [9s]
LLregs: checks
Swarleyyyy: checks
*** SHOW DOWN ***
LLregs: shows [7d 9c] (two pair, Nines and Sevens)
Swarleyyyy: mucks hand
LLregs collected $0.58 from pot
*** SUMMARY ***
Total pot $0.60 | Rake $0.02
Board [7s 2c 4d 8d 9s]
Seat 1: PR3SUR3 (button) folded before Flop (didn't bet)
Seat 2: LLregs (small blind) showed [7d 9c] and won ($0.58) with two pair, Nines and Sevens
Seat 3: Swarleyyyy (big blind) mucked [9h Qh]
Seat 4: Rosa Chic671 folded before Flop (didn't bet)
Seat 5: iliyan66 folded before Flop (didn't bet)
Seat 6: Peresmehnik1 folded before Flop (didn't bet)

PokerStars Zoom Hand #247965222871:  Hold'em No Limit ($0.01/$0.02) - 2023/12/30 19:50:43 WET [2023/12/30 14:50:43 ET]
Table 'Halley' 6-max Seat #1 is the button
Seat 1: ARES_312 ($2.51 in chips)
Seat 2: xTheBulletsx ($2.03 in chips)
Seat 3: LLregs ($3.90 in chips)
Seat 4: davidbarrels ($2.23 in chips)
Seat 5: stoti73 ($1.82 in chips)
Seat 6: GeRA XG ($0.64 in chips)
xTheBulletsx: posts small blind $0.01
LLregs: posts big blind $0.02
*** HOLE CARDS ***
Dealt to LLregs [Th As]
davidbarrels: folds
stoti73: folds
GeRA XG: folds
ARES_312: folds
xTheBulletsx: raises $0.04 to $0.06
LLregs: raises $0.12 to $0.18
xTheBulletsx: folds
Uncalled bet ($0.12) returned to LLregs
LLregs collected $0.12 from pot
LLregs: doesn't show hand
*** SUMMARY ***
Total pot $0.12 | Rake $0
Seat 1: ARES_312 (button) folded before Flop (didn't bet)
Seat 2: xTheBulletsx (small blind) folded before Flop
Seat 3: LLregs (big blind) collected ($0.12)
Seat 4: davidbarrels folded before Flop (didn't bet)
Seat 5: stoti73 folded before Flop (didn't bet)
Seat 6: GeRA XG folded before Flop (didn't bet)

PokerStars Zoom Hand #247965233529:  Hold'em No Limit ($0.01/$0.02) - 2023/12/30 19:51:11 WET [2023/12/30 14:51:11 ET]
Table 'Halley' 6-max Seat #1 is the button
Seat 1: Shizukas104 ($2.46 in chips)
Seat 2: Hunter777150 ($1.49 in chips)
Seat 3: PR3SUR3 ($2 in chips)
Seat 4: GeRA XG ($1.83 in chips)
Seat 5: LLregs ($3.96 in chips)
Seat 6: wanderer7660 ($1.73 in chips)
Hunter777150: posts small blind $0.01
PR3SUR3: posts big blind $0.02
*** HOLE CARDS ***
Dealt to LLregs [Qh 6h]
GeRA XG: folds
LLregs: folds
wanderer7660: folds
Shizukas104: raises $0.03 to $0.05
Hunter777150: folds
PR3SUR3: folds
Uncalled bet ($0.03) returned to Shizukas104
Shizukas104 collected $0.05 from pot
Shizukas104: doesn't show hand
*** SUMMARY ***
Total pot $0.05 | Rake $0
Seat 1: Shizukas104 (button) collected ($0.05)
Seat 2: Hunter777150 (small blind) folded before Flop
Seat 3: PR3SUR3 (big blind) folded before Flop
Seat 4: GeRA XG folded before Flop (didn't bet)
Seat 5: LLregs folded before Flop (didn't bet)
Seat 6: wanderer7660 folded before Flop (didn't bet)

PokerStars Zoom Hand #247965241007:  Hold'em No Limit ($0.01/$0.02) - 2023/12/30 19:51:30 WET [2023/12/30 14:51:30 ET]
Table 'Halley' 6-max Seat #1 is the button
Seat 1: LLregs ($3.95 in chips)
Seat 2: Balonas ($4.03 in chips)
Seat 3: Vitaliy v775 ($2.23 in chips)
Seat 4: djmcool ($2 in chips)
Seat 5: Dranton73 ($4.12 in chips)
Seat 6: stoti73 ($2.03 in chips)
Balonas: posts small blind $0.01
Vitaliy v775: posts big blind $0.02
*** HOLE CARDS ***
Dealt to LLregs [4d 2h]
djmcool: folds
Dranton73: raises $0.04 to $0.06
stoti73: folds
LLregs: folds
Balonas: folds
Vitaliy v775: calls $0.04
*** FLOP *** [Td 7h Ks]
Vitaliy v775: checks
Dranton73: bets $0.04
Vitaliy v775: raises $0.11 to $0.15
Dranton73: calls $0.11
*** TURN *** [Td 7h Ks] [6s]
Vitaliy v775: bets $0.21
Dranton73: calls $0.21
*** RIVER *** [Td 7h Ks 6s] [4c]
Vitaliy v775: bets $0.08
Dranton73: raises $3.62 to $3.70 and is all-in
Vitaliy v775: folds
Uncalled bet ($3.62) returned to Dranton73
Dranton73 collected $0.97 from pot
Dranton73: doesn't show hand
*** SUMMARY ***
Total pot $1.01 | Rake $0.04
Board [Td 7h Ks 6s 4c]
Seat 1: LLregs (button) folded before Flop (didn't bet)
Seat 2: Balonas (small blind) folded before Flop
Seat 3: Vitaliy v775 (big blind) folded on the River
Seat 4: djmcool folded before Flop (didn't bet)
Seat 5: Dranton73 collected ($0.97)
Seat 6: stoti73 folded before Flop (didn't bet)

PokerStars Zoom Hand #247965245009:  Hold'em No Limit ($0.01/$0.02) - 2023/12/30 19:51:41 WET [2023/12/30 14:51:41 ET]
Table 'Halley' 6-max Seat #1 is the button
Seat 1: aproximo ($3.79 in chips)
Seat 2: enilno rats ($5.65 in chips)
Seat 3: Sulynnmx ($0.94 in chips)
Seat 4: VIDOPRO23 ($3.75 in chips)
Seat 5: Sperick ($2.55 in chips)
Seat 6: LLregs ($3.95 in chips)
enilno rats: posts small blind $0.01
Sulynnmx: posts big blind $0.02
*** HOLE CARDS ***
Dealt to LLregs [6c As]
VIDOPRO23: folds
Sperick: folds
LLregs: folds
aproximo: folds
enilno rats: folds
Uncalled bet ($0.01) returned to Sulynnmx
Sulynnmx collected $0.02 from pot
Sulynnmx: doesn't show hand
*** SUMMARY ***
Total pot $0.02 | Rake $0
Seat 1: aproximo (button) folded before Flop (didn't bet)
Seat 2: enilno rats (small blind) folded before Flop
Seat 3: Sulynnmx (big blind) collected ($0.02)
Seat 4: VIDOPRO23 folded before Flop (didn't bet)
Seat 5: Sperick folded before Flop (didn't bet)
Seat 6: LLregs folded before Flop (didn't bet)

PokerStars Zoom Hand #247965250706:  Hold'em No Limit ($0.01/$0.02) - 2023/12/30 19:51:56 WET [2023/12/30 14:51:56 ET]
Table 'Halley' 6-max Seat #1 is the button
Seat 1: SannBy ($6.15 in chips)
Seat 2: RamGur ($2.10 in chips)
Seat 3: gio119 ($2.21 in chips)
Seat 4: LLregs ($3.95 in chips)
Seat 5: Dr.Erguen ($1.47 in chips)
Seat 6: FirmDr ($4.05 in chips)
RamGur: posts small blind $0.01
gio119: posts big blind $0.02
*** HOLE CARDS ***
Dealt to LLregs [Ah 5s]
LLregs has timed out
LLregs: folds
Dr.Erguen: folds
FirmDr: folds
SannBy: folds
RamGur: folds
Uncalled bet ($0.01) returned to gio119
gio119 collected $0.02 from pot
gio119: doesn't show hand
*** SUMMARY ***
Total pot $0.02 | Rake $0
Seat 1: SannBy (button) folded before Flop (didn't bet)
Seat 2: RamGur (small blind) folded before Flop
Seat 3: gio119 (big blind) collected ($0.02)
Seat 4: LLregs folded before Flop (didn't bet)
Seat 5: Dr.Erguen folded before Flop (didn't bet)
Seat 6: FirmDr folded before Flop (didn't bet)

PokerStars Zoom Hand #247965235078:  Hold'em No Limit ($0.01/$0.02) - 2023/12/30 19:51:15 WET [2023/12/30 14:51:15 ET]
Table 'Halley' 6-max Seat #1 is the button
Seat 1: Tosche34 ($3.92 in chips)
Seat 2: LLregs ($3.96 in chips)
Seat 3: bignelsonAK ($0.85 in chips)
Seat 4: broks01 ($2.24 in chips)
Seat 5: Cris0ner ($4.36 in chips)
Seat 6: PAMEGERA ($2.24 in chips)
LLregs: posts small blind $0.01
bignelsonAK: posts big blind $0.02
*** HOLE CARDS ***
Dealt to LLregs [9c 4h]
broks01: folds
Cris0ner: raises $0.04 to $0.06
PAMEGERA: folds
Tosche34: folds
LLregs: folds
bignelsonAK: calls $0.04
*** FLOP *** [4d Ad As]
bignelsonAK: checks
Cris0ner: checks
*** TURN *** [4d Ad As] [3c]
bignelsonAK: bets $0.50
Cris0ner: folds
Uncalled bet ($0.50) returned to bignelsonAK
bignelsonAK collected $0.13 from pot
bignelsonAK: doesn't show hand
*** SUMMARY ***
Total pot $0.13 | Rake $0
Board [4d Ad As 3c]
Seat 1: Tosche34 (button) folded before Flop (didn't bet)
Seat 2: LLregs (small blind) folded before Flop
Seat 3: bignelsonAK (big blind) collected ($0.13)
Seat 4: broks01 folded before Flop (didn't bet)
Seat 5: Cris0ner folded on the Turn
Seat 6: PAMEGERA folded before Flop (didn't bet)

PokerStars Zoom Hand #247965256867:  Hold'em No Limit ($0.01/$0.02) - 2023/12/30 19:52:12 WET [2023/12/30 14:52:12 ET]
Table 'Halley' 6-max Seat #1 is the button
Seat 1: jandsonpower ($2.55 in chips)
Seat 2: Harold_Seven ($1.12 in chips)
Seat 3: LLregs ($3.95 in chips)
Seat 4: LarixStar ($2.75 in chips)
Seat 5: Xabitpoker ($2.01 in chips)
Seat 6: PAMEGERA ($2 in chips)
Harold_Seven: posts small blind $0.01
LLregs: posts big blind $0.02
*** HOLE CARDS ***
Dealt to LLregs [Qh 8d]
LarixStar: folds
Xabitpoker: folds
PAMEGERA: folds
jandsonpower: folds
Harold_Seven: raises $0.02 to $0.04
LLregs: raises $0.02 to $0.06
Harold_Seven: calls $0.02
*** FLOP *** [8c Ks 3s]
Harold_Seven: checks
LLregs: bets $0.04
Harold_Seven: folds
Uncalled bet ($0.04) returned to LLregs
LLregs collected $0.12 from pot
LLregs: doesn't show hand
*** SUMMARY ***
Total pot $0.12 | Rake $0
Board [8c Ks 3s]
Seat 1: jandsonpower (button) folded before Flop (didn't bet)
Seat 2: Harold_Seven (small blind) folded on the Flop
Seat 3: LLregs (big blind) collected ($0.12)
Seat 4: LarixStar folded before Flop (didn't bet)
Seat 5: Xabitpoker folded before Flop (didn't bet)
Seat 6: PAMEGERA folded before Flop (didn't bet)

PokerStars Zoom Hand #247965273327:  Hold'em No Limit ($0.01/$0.02) - 2023/12/30 19:52:55 WET [2023/12/30 14:52:55 ET]
Table 'Halley' 6-max Seat #1 is the button
Seat 1: LLregs ($4.01 in chips)
Seat 2: Henrysport ($5.73 in chips)
Seat 3: nver91 ($2.16 in chips)
Seat 4: sal_sagev41 ($2.05 in chips)
Seat 5: Fasteddie35 ($2 in chips)
Seat 6: marcegring ($3.85 in chips)
Henrysport: posts small blind $0.01
nver91: posts big blind $0.02
*** HOLE CARDS ***
Dealt to LLregs [Ah Js]
sal_sagev41: folds
Fasteddie35: folds
marcegring: folds
LLregs: raises $0.04 to $0.06
Henrysport: folds
nver91: folds
Uncalled bet ($0.04) returned to LLregs
LLregs collected $0.05 from pot
LLregs: doesn't show hand
*** SUMMARY ***
Total pot $0.05 | Rake $0
Seat 1: LLregs (button) collected ($0.05)
Seat 2: Henrysport (small blind) folded before Flop
Seat 3: nver91 (big blind) folded before Flop
Seat 4: sal_sagev41 folded before Flop (didn't bet)
Seat 5: Fasteddie35 folded before Flop (didn't bet)
Seat 6: marcegring folded before Flop (didn't bet)

PokerStars Zoom Hand #247965278320:  Hold'em No Limit ($0.01/$0.02) - 2023/12/30 19:53:08 WET [2023/12/30 14:53:08 ET]
Table 'Halley' 6-max Seat #1 is the button
Seat 1: FEROIZ ($2.72 in chips)
Seat 2: LLregs ($4.04 in chips)
Seat 3: JaUm_V ($4.91 in chips)
Seat 4: pochitama ($2 in chips)
Seat 5: misawo ($1.11 in chips)
Seat 6: PR3SUR3 ($2 in chips)
LLregs: posts small blind $0.01
JaUm_V: posts big blind $0.02
*** HOLE CARDS ***
Dealt to LLregs [2s 4s]
pochitama: folds
misawo: raises $0.04 to $0.06
PR3SUR3: folds
FEROIZ: folds
LLregs: folds
JaUm_V: folds
Uncalled bet ($0.04) returned to misawo
misawo collected $0.05 from pot
misawo: doesn't show hand
*** SUMMARY ***
Total pot $0.05 | Rake $0
Seat 1: FEROIZ (button) folded before Flop (didn't bet)
Seat 2: LLregs (small blind) folded before Flop
Seat 3: JaUm_V (big blind) folded before Flop
Seat 4: pochitama folded before Flop (didn't bet)
Seat 5: misawo collected ($0.05)
Seat 6: PR3SUR3 folded before Flop (didn't bet)

PokerStars Zoom Hand #247965280530:  Hold'em No Limit ($0.01/$0.02) - 2023/12/30 19:53:14 WET [2023/12/30 14:53:14 ET]
Table 'Halley' 6-max Seat #1 is the button
Seat 1: Swarleyyyy ($2.04 in chips)
Seat 2: MassterD21 ($1.49 in chips)
Seat 3: marcegring ($2.17 in chips)
Seat 4: kosatkazostravy ($2.16 in chips)
Seat 5: LLregs ($4.03 in chips)
Seat 6: batya1212 ($2 in chips)
MassterD21: posts small blind $0.01
marcegring: posts big blind $0.02
*** HOLE CARDS ***
Dealt to LLregs [4s Th]
kosatkazostravy: raises $0.04 to $0.06
LLregs: folds
batya1212: folds
Swarleyyyy: folds
MassterD21: folds
marcegring: calls $0.04
*** FLOP *** [9c Ts Jd]
marcegring: checks
kosatkazostravy: bets $0.06
marcegring: calls $0.06
*** TURN *** [9c Ts Jd] [6s]
marcegring: checks
kosatkazostravy: bets $0.14
marcegring: folds
Uncalled bet ($0.14) returned to kosatkazostravy
kosatkazostravy collected $0.24 from pot
kosatkazostravy: doesn't show hand
*** SUMMARY ***
Total pot $0.25 | Rake $0.01
Board [9c Ts Jd 6s]
Seat 1: Swarleyyyy (button) folded before Flop (didn't bet)
Seat 2: MassterD21 (small blind) folded before Flop
Seat 3: marcegring (big blind) folded on the Turn
Seat 4: kosatkazostravy collected ($0.24)
Seat 5: LLregs folded before Flop (didn't bet)
Seat 6: batya1212 folded before Flop (didn't bet)

PokerStars Zoom Hand #247965283937:  Hold'em No Limit ($0.01/$0.02) - 2023/12/30 19:53:23 WET [2023/12/30 14:53:23 ET]
Table 'Halley' 6-max Seat #1 is the button
Seat 1: lazyG007605 ($1.77 in chips)
Seat 2: bettanye ($2 in chips)
Seat 3: Slava Gvozdev ($1.90 in chips)
Seat 4: LLregs ($4.03 in chips)
Seat 5: yomomma444 ($0.91 in chips)
Seat 6: Kykyrit ($2.08 in chips)
bettanye: posts small blind $0.01
Slava Gvozdev: posts big blind $0.02
*** HOLE CARDS ***
Dealt to LLregs [4h 5s]
LLregs: folds
yomomma444: folds
Kykyrit: folds
lazyG007605: folds
bettanye: raises $0.04 to $0.06
Slava Gvozdev: calls $0.04
*** FLOP *** [Qd Qs 2d]
bettanye: bets $0.06
Slava Gvozdev: calls $0.06
*** TURN *** [Qd Qs 2d] [6c]
bettanye: bets $0.09
Slava Gvozdev: calls $0.09
*** RIVER *** [Qd Qs 2d 6c] [5h]
bettanye: checks
Slava Gvozdev: checks
*** SHOW DOWN ***
bettanye: shows [4d Ad] (a pair of Queens)
Slava Gvozdev: shows [7s 7d] (two pair, Queens and Sevens)
Slava Gvozdev collected $0.41 from pot
*** SUMMARY ***
Total pot $0.42 | Rake $0.01
Board [Qd Qs 2d 6c 5h]
Seat 1: lazyG007605 (button) folded before Flop (didn't bet)
Seat 2: bettanye (small blind) showed [4d Ad] and lost with a pair of Queens
Seat 3: Slava Gvozdev (big blind) showed [7s 7d] and won ($0.41) with two pair, Queens and Sevens
Seat 4: LLregs folded before Flop (didn't bet)
Seat 5: yomomma444 folded before Flop (didn't bet)
Seat 6: Kykyrit folded before Flop (didn't bet)

PokerStars Zoom Hand #247965287417:  Hold'em No Limit ($0.01/$0.02) - 2023/12/30 19:53:32 WET [2023/12/30 14:53:32 ET]
Table 'Halley' 6-max Seat #1 is the button
Seat 1: JFSTommy ($2 in chips)
Seat 2: Kykyrit ($2.08 in chips)
Seat 3: LLregs ($4.03 in chips)
Seat 4: Ilikefossil ($2.65 in chips)
Seat 5: Ready2Rollu ($2.20 in chips)
Seat 6: Juonez ($2.19 in chips)
Kykyrit: posts small blind $0.01
LLregs: posts big blind $0.02
*** HOLE CARDS ***
Dealt to LLregs [Tc Kh]
Ilikefossil: folds
Ready2Rollu: folds
Juonez: folds
JFSTommy: raises $0.02 to $0.04
Kykyrit: folds
LLregs: calls $0.02
*** FLOP *** [Qd 6h 2h]
LLregs: checks
JFSTommy: bets $0.02
LLregs: calls $0.02
*** TURN *** [Qd 6h 2h] [8c]
LLregs: checks
JFSTommy: checks
*** RIVER *** [Qd 6h 2h 8c] [Th]
LLregs: bets $0.03
JFSTommy: calls $0.03
*** SHOW DOWN ***
LLregs: shows [Tc Kh] (a pair of Tens)
JFSTommy: mucks hand
LLregs collected $0.18 from pot
*** SUMMARY ***
Total pot $0.19 | Rake $0.01
Board [Qd 6h 2h 8c Th]
Seat 1: JFSTommy (button) mucked [Jc Td]
Seat 2: Kykyrit (small blind) folded before Flop
Seat 3: LLregs (big blind) showed [Tc Kh] and won ($0.18) with a pair of Tens
Seat 4: Ilikefossil folded before Flop (didn't bet)
Seat 5: Ready2Rollu folded before Flop (didn't bet)
Seat 6: Juonez folded before Flop (didn't bet)

PokerStars Zoom Hand #247965303091:  Hold'em No Limit ($0.01/$0.02) - 2023/12/30 19:54:14 WET [2023/12/30 14:54:14 ET]
Table 'Halley' 6-max Seat #1 is the button
Seat 1: Ninjafuturo123 ($1.89 in chips)
Seat 2: mncr07 ($2.94 in chips)
Seat 3: bettanye ($2 in chips)
Seat 4: wee_smurf23 ($2.06 in chips)
Seat 5: GULI-369 ($2.06 in chips)
Seat 6: LLregs ($4.12 in chips)
mncr07: posts small blind $0.01
bettanye: posts big blind $0.02
*** HOLE CARDS ***
Dealt to LLregs [Qh 5h]
wee_smurf23: folds
GULI-369: raises $0.04 to $0.06
LLregs: folds
Ninjafuturo123: folds
mncr07: folds
bettanye: folds
Uncalled bet ($0.04) returned to GULI-369
GULI-369 collected $0.05 from pot
GULI-369: doesn't show hand
*** SUMMARY ***
Total pot $0.05 | Rake $0
Seat 1: Ninjafuturo123 (button) folded before Flop (didn't bet)
Seat 2: mncr07 (small blind) folded before Flop
Seat 3: bettanye (big blind) folded before Flop
Seat 4: wee_smurf23 folded before Flop (didn't bet)
Seat 5: GULI-369 collected ($0.05)
Seat 6: LLregs folded before Flop (didn't bet)

PokerStars Zoom Hand #247965306168:  Hold'em No Limit ($0.01/$0.02) - 2023/12/30 19:54:22 WET [2023/12/30 14:54:22 ET]
Table 'Halley' 6-max Seat #1 is the button
Seat 1: LLregs ($4.12 in chips)
Seat 2: Swarleyyyy ($2.49 in chips)
Seat 3: Aschi1970 ($1 in chips)
Seat 4: RafaCartaxo ($2.33 in chips)
Seat 5: SchmittNieto ($2 in chips)
Seat 6: PAMEGERA ($2.30 in chips)
Swarleyyyy: posts small blind $0.01
Aschi1970: posts big blind $0.02
*** HOLE CARDS ***
Dealt to LLregs [5h Kh]
RafaCartaxo: raises $0.04 to $0.06
SchmittNieto: folds
PAMEGERA: calls $0.06
LLregs: folds
Swarleyyyy: folds
Aschi1970: calls $0.04
*** FLOP *** [4s Th Jd]
Aschi1970: bets $0.02
RafaCartaxo: calls $0.02
PAMEGERA: folds
*** TURN *** [4s Th Jd] [Qh]
Aschi1970: checks
RafaCartaxo: bets $0.13
Aschi1970: folds
Uncalled bet ($0.13) returned to RafaCartaxo
RafaCartaxo collected $0.22 from pot
RafaCartaxo: doesn't show hand
*** SUMMARY ***
Total pot $0.23 | Rake $0.01
Board [4s Th Jd Qh]
Seat 1: LLregs (button) folded before Flop (didn't bet)
Seat 2: Swarleyyyy (small blind) folded before Flop
Seat 3: Aschi1970 (big blind) folded on the Turn
Seat 4: RafaCartaxo collected ($0.22)
Seat 5: SchmittNieto folded before Flop (didn't bet)
Seat 6: PAMEGERA folded on the Flop

PokerStars Zoom Hand #247965309170:  Hold'em No Limit ($0.01/$0.02) - 2023/12/30 19:54:30 WET [2023/12/30 14:54:30 ET]
Table 'Halley' 6-max Seat #1 is the button
Seat 1: oleksandr_k3 ($1.98 in chips)
Seat 2: FERNANDO R01997 ($1.26 in chips)
Seat 3: Harold_Seven ($1.02 in chips)
Seat 4: Balonas ($2.85 in chips)
Seat 5: LLregs ($4.12 in chips)
Seat 6: Loucomeloo ($2.03 in chips)
FERNANDO R01997: posts small blind $0.01
Harold_Seven: posts big blind $0.02
*** HOLE CARDS ***
Dealt to LLregs [5c 5s]
Balonas: folds
LLregs: raises $0.02 to $0.04
Loucomeloo: calls $0.04
oleksandr_k3: folds
FERNANDO R01997: calls $0.03
Harold_Seven: folds
*** FLOP *** [3d Qh Qs]
FERNANDO R01997: checks
LLregs: checks
Loucomeloo: bets $0.07
FERNANDO R01997: folds
LLregs: calls $0.07
*** TURN *** [3d Qh Qs] [8s]
LLregs: checks
Loucomeloo: checks
*** RIVER *** [3d Qh Qs 8s] [Kd]
LLregs: checks
Loucomeloo: checks
*** SHOW DOWN ***
LLregs: shows [5c 5s] (two pair, Queens and Fives)
Loucomeloo: shows [9h Kh] (two pair, Kings and Queens)
Loucomeloo collected $0.27 from pot
*** SUMMARY ***
Total pot $0.28 | Rake $0.01
Board [3d Qh Qs 8s Kd]
Seat 1: oleksandr_k3 (button) folded before Flop (didn't bet)
Seat 2: FERNANDO R01997 (small blind) folded on the Flop
Seat 3: Harold_Seven (big blind) folded before Flop
Seat 4: Balonas folded before Flop (didn't bet)
Seat 5: LLregs showed [5c 5s] and lost with two pair, Queens and Fives
Seat 6: Loucomeloo showed [9h Kh] and won ($0.27) with two pair, Kings and Queens

PokerStars Zoom Hand #247965325216:  Hold'em No Limit ($0.01/$0.02) - 2023/12/30 19:55:17 WET [2023/12/30 14:55:17 ET]
Table 'Halley' 6-max Seat #1 is the button
Seat 1: LDenisL ($2.94 in chips)
Seat 2: LLregs ($4.01 in chips)
Seat 3: hugopacifico ($1.71 in chips)
Seat 4: jandsonpower ($2 in chips)
Seat 5: Dranton73 ($4.79 in chips)
Seat 6: danielkiel ($2.09 in chips)
LLregs: posts small blind $0.01
hugopacifico: posts big blind $0.02
*** HOLE CARDS ***
Dealt to LLregs [Qs 6s]
jandsonpower: folds
Dranton73: folds
danielkiel: folds
LDenisL: folds
LLregs: raises $0.04 to $0.06
hugopacifico: folds
Uncalled bet ($0.04) returned to LLregs
LLregs collected $0.04 from pot
LLregs: doesn't show hand
*** SUMMARY ***
Total pot $0.04 | Rake $0
Seat 1: LDenisL (button) folded before Flop (didn't bet)
Seat 2: LLregs (small blind) collected ($0.04)
Seat 3: hugopacifico (big blind) folded before Flop
Seat 4: jandsonpower folded before Flop (didn't bet)
Seat 5: Dranton73 folded before Flop (didn't bet)
Seat 6: danielkiel folded before Flop (didn't bet)

PokerStars Zoom Hand #247965330364:  Hold'em No Limit ($0.01/$0.02) - 2023/12/30 19:55:38 WET [2023/12/30 14:55:38 ET]
Table 'Halley' 6-max Seat #1 is the button
Seat 1: LordRocky89 ($3.36 in chips)
Seat 2: vannstarzz ($10.63 in chips)
Seat 3: Baroudo ($0.10 in chips)
Seat 4: SHANEZ01 ($1.16 in chips)
Seat 5: langejan1984 ($2 in chips)
Seat 6: LLregs ($4.03 in chips)
vannstarzz: posts small blind $0.01
Baroudo: posts big blind $0.02
*** HOLE CARDS ***
Dealt to LLregs [3c Jd]
SHANEZ01: folds
langejan1984: folds
LLregs: folds
LordRocky89: folds
vannstarzz: folds
Uncalled bet ($0.01) returned to Baroudo
Baroudo collected $0.02 from pot
Baroudo: doesn't show hand
*** SUMMARY ***
Total pot $0.02 | Rake $0
Seat 1: LordRocky89 (button) folded before Flop (didn't bet)
Seat 2: vannstarzz (small blind) folded before Flop
Seat 3: Baroudo (big blind) collected ($0.02)
Seat 4: SHANEZ01 folded before Flop (didn't bet)
Seat 5: langejan1984 folded before Flop (didn't bet)
Seat 6: LLregs folded before Flop (didn't bet)

PokerStars Zoom Hand #247965331269:  Hold'em No Limit ($0.01/$0.02) - 2023/12/30 19:55:41 WET [2023/12/30 14:55:41 ET]
Table 'Halley' 6-max Seat #1 is the button
Seat 1: PR3SUR3 ($3.19 in chips)
Seat 2: richireef ($2 in chips)
Seat 3: LLregs ($4.03 in chips)
Seat 4: Fasteddie35 ($2.05 in chips)
Seat 5: aproximo ($2.17 in chips)
Seat 6: wdeoliveiram ($1.38 in chips)
richireef: posts small blind $0.01
LLregs: posts big blind $0.02
*** HOLE CARDS ***
Dealt to LLregs [Ah Ac]
Fasteddie35: folds
aproximo: folds
wdeoliveiram: folds
PR3SUR3: folds
richireef: calls $0.01
LLregs: raises $0.04 to $0.06
richireef: folds
Uncalled bet ($0.04) returned to LLregs
LLregs collected $0.04 from pot
LLregs: doesn't show hand
*** SUMMARY ***
Total pot $0.04 | Rake $0
Seat 1: PR3SUR3 (button) folded before Flop (didn't bet)
Seat 2: richireef (small blind) folded before Flop
Seat 3: LLregs (big blind) collected ($0.04)
Seat 4: Fasteddie35 folded before Flop (didn't bet)
Seat 5: aproximo folded before Flop (didn't bet)
Seat 6: wdeoliveiram folded before Flop (didn't bet)

PokerStars Zoom Hand #247965336628:  Hold'em No Limit ($0.01/$0.02) - 2023/12/30 19:56:02 WET [2023/12/30 14:56:02 ET]
Table 'Halley' 6-max Seat #1 is the button
Seat 1: Baroudo ($0.10 in chips)
Seat 2: Henrysport ($5.59 in chips)
Seat 3: dobri151 ($2.86 in chips)
Seat 4: Aschi1970 ($0.84 in chips)
Seat 5: ARES_312 ($2.07 in chips)
Seat 6: LLregs ($4.05 in chips)
Henrysport: posts small blind $0.01
dobri151: posts big blind $0.02
*** HOLE CARDS ***
Dealt to LLregs [2d 9s]
Aschi1970: folds
ARES_312: folds
LLregs: folds
Baroudo: folds
Henrysport: folds
Uncalled bet ($0.01) returned to dobri151
dobri151 collected $0.02 from pot
dobri151: doesn't show hand
*** SUMMARY ***
Total pot $0.02 | Rake $0
Seat 1: Baroudo (button) folded before Flop (didn't bet)
Seat 2: Henrysport (small blind) folded before Flop
Seat 3: dobri151 (big blind) collected ($0.02)
Seat 4: Aschi1970 folded before Flop (didn't bet)
Seat 5: ARES_312 folded before Flop (didn't bet)
Seat 6: LLregs folded before Flop (didn't bet)

PokerStars Zoom Hand #247965335619:  Hold'em No Limit ($0.01/$0.02) - 2023/12/30 19:55:58 WET [2023/12/30 14:55:58 ET]
Table 'Halley' 6-max Seat #1 is the button
Seat 1: Vitaliy v775 ($2.14 in chips)
Seat 2: Loucomeloo ($2.08 in chips)
Seat 3: bandini111 ($0.84 in chips)
Seat 4: dgage8 ($2.94 in chips)
Seat 5: LLregs ($4.05 in chips)
Seat 6: ARES_312 ($2.30 in chips)
Loucomeloo: posts small blind $0.01
bandini111: posts big blind $0.02
*** HOLE CARDS ***
Dealt to LLregs [6s 8s]
dgage8: folds
LLregs: folds
ARES_312: folds
Vitaliy v775: folds
Loucomeloo: folds
Uncalled bet ($0.01) returned to bandini111
bandini111 collected $0.02 from pot
bandini111: doesn't show hand
*** SUMMARY ***
Total pot $0.02 | Rake $0
Seat 1: Vitaliy v775 (button) folded before Flop (didn't bet)
Seat 2: Loucomeloo (small blind) folded before Flop
Seat 3: bandini111 (big blind) collected ($0.02)
Seat 4: dgage8 folded before Flop (didn't bet)
Seat 5: LLregs folded before Flop (didn't bet)
Seat 6: ARES_312 folded before Flop (didn't bet)

PokerStars Zoom Hand #247965328328:  Hold'em No Limit ($0.01/$0.02) - 2023/12/30 19:55:30 WET [2023/12/30 14:55:30 ET]
Table 'Halley' 6-max Seat #1 is the button
Seat 1: LLregs ($4.03 in chips)
Seat 2: VOYAGERC ($2.08 in chips)
Seat 3: MR.BUMFLUFF ($2.14 in chips)
Seat 4: Bardiyayaya ($2.47 in chips)
Seat 5: arkins00 ($2 in chips)
Seat 6: Shizukas104 ($2 in chips)
VOYAGERC: posts small blind $0.01
MR.BUMFLUFF: posts big blind $0.02
*** HOLE CARDS ***
Dealt to LLregs [9s 6s]
Bardiyayaya: raises $0.02 to $0.04
arkins00: folds
Shizukas104: folds
LLregs: folds
VOYAGERC: folds
MR.BUMFLUFF: calls $0.02
*** FLOP *** [6d 7s 9c]
MR.BUMFLUFF: bets $0.04
Bardiyayaya: calls $0.04
*** TURN *** [6d 7s 9c] [2d]
MR.BUMFLUFF: bets $0.07
Bardiyayaya: calls $0.07
*** RIVER *** [6d 7s 9c 2d] [2h]
MR.BUMFLUFF: checks
Bardiyayaya: bets $0.40
MR.BUMFLUFF: calls $0.40
*** SHOW DOWN ***
Bardiyayaya: shows [6h 8h] (two pair, Sixes and Deuces)
MR.BUMFLUFF: shows [5d 7d] (two pair, Sevens and Deuces)
MR.BUMFLUFF collected $1.07 from pot
*** SUMMARY ***
Total pot $1.11 | Rake $0.04
Board [6d 7s 9c 2d 2h]
Seat 1: LLregs (button) folded before Flop (didn't bet)
Seat 2: VOYAGERC (small blind) folded before Flop
Seat 3: MR.BUMFLUFF (big blind) showed [5d 7d] and won ($1.07) with two pair, Sevens and Deuces
Seat 4: Bardiyayaya showed [6h 8h] and lost with two pair, Sixes and Deuces
Seat 5: arkins00 folded before Flop (didn't bet)
Seat 6: Shizukas104 folded before Flop (didn't bet)

PokerStars Zoom Hand #247965337658:  Hold'em No Limit ($0.01/$0.02) - 2023/12/30 19:56:06 WET [2023/12/30 14:56:06 ET]
Table 'Halley' 6-max Seat #1 is the button
Seat 1: Vigorous580 ($0.77 in chips)
Seat 2: LLregs ($4.05 in chips)
Seat 3: Racketeer 92 ($5.53 in chips)
Seat 4: vovan22-99 ($1.99 in chips)
Seat 5: Shizukas104 ($2 in chips)
Seat 6: Bardiyayaya ($2.02 in chips)
LLregs: posts small blind $0.01
Racketeer 92: posts big blind $0.02
*** HOLE CARDS ***
Dealt to LLregs [2s As]
vovan22-99: folds
Shizukas104: folds
Bardiyayaya: folds
Vigorous580: calls $0.02
LLregs: calls $0.01
Racketeer 92: checks
*** FLOP *** [Tc 4d Ad]
LLregs: checks
Racketeer 92: checks
Vigorous580: bets $0.02
LLregs: calls $0.02
Racketeer 92: folds
*** TURN *** [Tc 4d Ad] [2h]
LLregs: checks
Vigorous580: bets $0.05
LLregs: calls $0.05
*** RIVER *** [Tc 4d Ad 2h] [Qd]
LLregs: bets $0.09
Vigorous580: folds
Uncalled bet ($0.09) returned to LLregs
LLregs collected $0.19 from pot
LLregs: doesn't show hand
*** SUMMARY ***
Total pot $0.20 | Rake $0.01
Board [Tc 4d Ad 2h Qd]
Seat 1: Vigorous580 (button) folded on the River
Seat 2: LLregs (small blind) collected ($0.19)
Seat 3: Racketeer 92 (big blind) folded on the Flop
Seat 4: vovan22-99 folded before Flop (didn't bet)
Seat 5: Shizukas104 folded before Flop (didn't bet)
Seat 6: Bardiyayaya folded before Flop (didn't bet)

PokerStars Zoom Hand #247965350520:  Hold'em No Limit ($0.01/$0.02) - 2023/12/30 19:56:56 WET [2023/12/30 14:56:56 ET]
Table 'Halley' 6-max Seat #1 is the button
Seat 1: hugopacifico ($1.45 in chips)
Seat 2: Cigarrinh0 ($3.86 in chips)
Seat 3: LLregs ($4.15 in chips)
Seat 4: bettanye ($2.05 in chips)
Seat 5: AlGiNho ($2.48 in chips)
Seat 6: Ihor cr24 ($1.22 in chips)
Cigarrinh0: posts small blind $0.01
LLregs: posts big blind $0.02
*** HOLE CARDS ***
Dealt to LLregs [Qh Qs]
bettanye: folds
AlGiNho: folds
Ihor cr24: calls $0.02
hugopacifico: folds
Cigarrinh0: folds
LLregs: raises $0.04 to $0.06
Ihor cr24: calls $0.04
*** FLOP *** [4c Jh Jd]
LLregs: checks
Ihor cr24: bets $0.04
LLregs: calls $0.04
*** TURN *** [4c Jh Jd] [6c]
LLregs: checks
Ihor cr24: bets $0.10
LLregs: calls $0.10
*** RIVER *** [4c Jh Jd 6c] [Kh]
LLregs: checks
Ihor cr24: bets $0.30
LLregs: calls $0.30
*** SHOW DOWN ***
Ihor cr24: shows [9s Js] (three of a kind, Jacks)
LLregs: mucks hand
Ihor cr24 collected $0.97 from pot
*** SUMMARY ***
Total pot $1.01 | Rake $0.04
Board [4c Jh Jd 6c Kh]
Seat 1: hugopacifico (button) folded before Flop (didn't bet)
Seat 2: Cigarrinh0 (small blind) folded before Flop
Seat 3: LLregs (big blind) mucked [Qh Qs]
Seat 4: bettanye folded before Flop (didn't bet)
Seat 5: AlGiNho folded before Flop (didn't bet)
Seat 6: Ihor cr24 showed [9s Js] and won ($0.97) with three of a kind, Jacks

PokerStars Zoom Hand #247965361062:  Hold'em No Limit ($0.01/$0.02) - 2023/12/30 19:57:37 WET [2023/12/30 14:57:37 ET]
Table 'Halley' 6-max Seat #1 is the button
Seat 1: wee_smurf23 ($2 in chips)
Seat 2: CANYA_V ($2.90 in chips)
Seat 3: C@s@ndr@ ($1.36 in chips)
Seat 4: LLregs ($3.65 in chips)
Seat 5: xTheBulletsx ($2.07 in chips)
Seat 6: conspy84 ($4.42 in chips)
CANYA_V: posts small blind $0.01
C@s@ndr@: posts big blind $0.02
*** HOLE CARDS ***
Dealt to LLregs [2h Ah]
LLregs: folds
xTheBulletsx: folds
conspy84: folds
wee_smurf23: raises $0.04 to $0.06
CANYA_V: folds
C@s@ndr@: folds
Uncalled bet ($0.04) returned to wee_smurf23
wee_smurf23 collected $0.05 from pot
wee_smurf23: doesn't show hand
*** SUMMARY ***
Total pot $0.05 | Rake $0
Seat 1: wee_smurf23 (button) collected ($0.05)
Seat 2: CANYA_V (small blind) folded before Flop
Seat 3: C@s@ndr@ (big blind) folded before Flop
Seat 4: LLregs folded before Flop (didn't bet)
Seat 5: xTheBulletsx folded before Flop (didn't bet)
Seat 6: conspy84 folded before Flop (didn't bet)

PokerStars Zoom Hand #247965362616:  Hold'em No Limit ($0.01/$0.02) - 2023/12/30 19:57:43 WET [2023/12/30 14:57:43 ET]
Table 'Halley' 6-max Seat #1 is the button
Seat 1: LLregs ($3.65 in chips)
Seat 2: psdgr3 ($2.03 in chips)
Seat 3: vannstarzz ($9.57 in chips)
Seat 4: Vigorous580 ($0.81 in chips)
Seat 5: LarixStar ($3.02 in chips)
Seat 6: ARES_312 ($2.29 in chips)
psdgr3: posts small blind $0.01
vannstarzz: posts big blind $0.02
*** HOLE CARDS ***
Dealt to LLregs [Kc 3c]
Vigorous580: raises $0.05 to $0.07
LarixStar: folds
ARES_312: folds
LLregs: folds
psdgr3: folds
vannstarzz: folds
Uncalled bet ($0.05) returned to Vigorous580
Vigorous580 collected $0.05 from pot
Vigorous580: doesn't show hand
*** SUMMARY ***
Total pot $0.05 | Rake $0
Seat 1: LLregs (button) folded before Flop (didn't bet)
Seat 2: psdgr3 (small blind) folded before Flop
Seat 3: vannstarzz (big blind) folded before Flop
Seat 4: Vigorous580 collected ($0.05)
Seat 5: LarixStar folded before Flop (didn't bet)
Seat 6: ARES_312 folded before Flop (didn't bet)

PokerStars Zoom Hand #247965349524:  Hold'em No Limit ($0.01/$0.02) - 2023/12/30 19:56:52 WET [2023/12/30 14:56:52 ET]
Table 'Halley' 6-max Seat #1 is the button
Seat 1: Vitaliy v775 ($1.86 in chips)
Seat 2: Harold_Seven ($1 in chips)
Seat 3: MR.BUMFLUFF ($3.28 in chips)
Seat 4: cachusky ($3.66 in chips)
Seat 5: LLregs ($4.15 in chips)
Seat 6: 3 gabriel ($1.08 in chips)
Harold_Seven: posts small blind $0.01
MR.BUMFLUFF: posts big blind $0.02
*** HOLE CARDS ***
Dealt to LLregs [5s 3d]
cachusky: folds
LLregs: folds
3 gabriel: folds
Vitaliy v775: raises $0.04 to $0.06
Harold_Seven: calls $0.05
MR.BUMFLUFF: calls $0.04
*** FLOP *** [Kh 4h Js]
Harold_Seven: checks
MR.BUMFLUFF: checks
Vitaliy v775: bets $0.06
Harold_Seven: calls $0.06
MR.BUMFLUFF: folds
*** TURN *** [Kh 4h Js] [7h]
Harold_Seven: checks
Vitaliy v775: checks
*** RIVER *** [Kh 4h Js 7h] [8h]
Harold_Seven: bets $0.23
Vitaliy v775: folds
Uncalled bet ($0.23) returned to Harold_Seven
Harold_Seven collected $0.29 from pot
Harold_Seven: doesn't show hand
*** SUMMARY ***
Total pot $0.30 | Rake $0.01
Board [Kh 4h Js 7h 8h]
Seat 1: Vitaliy v775 (button) folded on the River
Seat 2: Harold_Seven (small blind) collected ($0.29)
Seat 3: MR.BUMFLUFF (big blind) folded on the Flop
Seat 4: cachusky folded before Flop (didn't bet)
Seat 5: LLregs folded before Flop (didn't bet)
Seat 6: 3 gabriel folded before Flop (didn't bet)

PokerStars Zoom Hand #247965365493:  Hold'em No Limit ($0.01/$0.02) - 2023/12/30 19:57:54 WET [2023/12/30 14:57:54 ET]
Table 'Halley' 6-max Seat #1 is the button
Seat 1: mangalisa ($2.53 in chips)
Seat 2: PR3SUR3 ($4.27 in chips)
Seat 3: 113utd ($1.30 in chips)
Seat 4: LLregs ($3.65 in chips)
Seat 5: emirandal ($2.24 in chips)
Seat 6: bignelsonAK ($0.71 in chips)
PR3SUR3: posts small blind $0.01
113utd: posts big blind $0.02
*** HOLE CARDS ***
Dealt to LLregs [6d 2c]
LLregs: folds
emirandal: folds
bignelsonAK: raises $0.02 to $0.04
mangalisa: folds
PR3SUR3: folds
113utd: folds
Uncalled bet ($0.02) returned to bignelsonAK
bignelsonAK collected $0.05 from pot
bignelsonAK: doesn't show hand
*** SUMMARY ***
Total pot $0.05 | Rake $0
Seat 1: mangalisa (button) folded before Flop (didn't bet)
Seat 2: PR3SUR3 (small blind) folded before Flop
Seat 3: 113utd (big blind) folded before Flop
Seat 4: LLregs folded before Flop (didn't bet)
Seat 5: emirandal folded before Flop (didn't bet)
Seat 6: bignelsonAK collected ($0.05)

PokerStars Zoom Hand #247965367692:  Hold'em No Limit ($0.01/$0.02) - 2023/12/30 19:58:03 WET [2023/12/30 14:58:03 ET]
Table 'Halley' 6-max Seat #1 is the button
Seat 1: SchmittNieto ($2.14 in chips)
Seat 2: Racketeer 92 ($5.62 in chips)
Seat 3: Slava Gvozdev ($1.76 in chips)
Seat 4: batya1212 ($2 in chips)
Seat 5: Balonas ($12.57 in chips)
Seat 6: LLregs ($3.64 in chips)
Racketeer 92: posts small blind $0.01
Slava Gvozdev: posts big blind $0.02
*** HOLE CARDS ***
Dealt to LLregs [Ts 3c]
batya1212: folds
Balonas: folds
LLregs: folds
SchmittNieto: folds
Racketeer 92: folds
Uncalled bet ($0.01) returned to Slava Gvozdev
Slava Gvozdev collected $0.02 from pot
Slava Gvozdev: doesn't show hand
*** SUMMARY ***
Total pot $0.02 | Rake $0
Seat 1: SchmittNieto (button) folded before Flop (didn't bet)
Seat 2: Racketeer 92 (small blind) folded before Flop
Seat 3: Slava Gvozdev (big blind) collected ($0.02)
Seat 4: batya1212 folded before Flop (didn't bet)
Seat 5: Balonas folded before Flop (didn't bet)
Seat 6: LLregs folded before Flop (didn't bet)

PokerStars Zoom Hand #247965366740:  Hold'em No Limit ($0.01/$0.02) - 2023/12/30 19:57:59 WET [2023/12/30 14:57:59 ET]
Table 'Halley' 6-max Seat #1 is the button
Seat 1: BossTH4 ($2 in chips)
Seat 2: LLregs ($3.65 in chips)
Seat 3: Juonez ($2.96 in chips)
Seat 4: conspy84 ($4.41 in chips)
Seat 5: yukon Ronald ($0.88 in chips)
Seat 6: dixvins ($1.52 in chips)
LLregs: posts small blind $0.01
Juonez: posts big blind $0.02
*** HOLE CARDS ***
Dealt to LLregs [9c 4c]
conspy84: folds
yukon Ronald: calls $0.02
dixvins: folds
BossTH4: folds
LLregs: folds
Juonez: checks
*** FLOP *** [5h 2d Qs]
Juonez: checks
yukon Ronald: checks
*** TURN *** [5h 2d Qs] [8s]
Juonez: bets $0.02
yukon Ronald: calls $0.02
*** RIVER *** [5h 2d Qs 8s] [7c]
Juonez: bets $0.03
yukon Ronald: folds
Uncalled bet ($0.03) returned to Juonez
Juonez collected $0.09 from pot
Juonez: doesn't show hand
*** SUMMARY ***
Total pot $0.09 | Rake $0
Board [5h 2d Qs 8s 7c]
Seat 1: BossTH4 (button) folded before Flop (didn't bet)
Seat 2: LLregs (small blind) folded before Flop
Seat 3: Juonez (big blind) collected ($0.09)
Seat 4: conspy84 folded before Flop (didn't bet)
Seat 5: yukon Ronald folded on the River
Seat 6: dixvins folded before Flop (didn't bet)

PokerStars Zoom Hand #247965368393:  Hold'em No Limit ($0.01/$0.02) - 2023/12/30 19:58:06 WET [2023/12/30 14:58:06 ET]
Table 'Halley' 6-max Seat #1 is the button
Seat 1: luckyal00 ($2 in chips)
Seat 2: Rockoteki ($7.07 in chips)
Seat 3: PAMEGERA ($2.22 in chips)
Seat 4: conspy84 ($1.50 in chips)
Seat 5: LLregs ($3.64 in chips)
Seat 6: wanderer7660 ($1.96 in chips)
Rockoteki: posts small blind $0.01
PAMEGERA: posts big blind $0.02
*** HOLE CARDS ***
Dealt to LLregs [9h Th]
conspy84: folds
LLregs: raises $0.02 to $0.04
wanderer7660: folds
luckyal00: folds
Rockoteki: raises $0.16 to $0.20
PAMEGERA: folds
LLregs: folds
Uncalled bet ($0.16) returned to Rockoteki
Rockoteki collected $0.10 from pot
Rockoteki: doesn't show hand
*** SUMMARY ***
Total pot $0.10 | Rake $0
Seat 1: luckyal00 (button) folded before Flop (didn't bet)
Seat 2: Rockoteki (small blind) collected ($0.10)
Seat 3: PAMEGERA (big blind) folded before Flop
Seat 4: conspy84 folded before Flop (didn't bet)
Seat 5: LLregs folded before Flop
Seat 6: wanderer7660 folded before Flop (didn't bet)

PokerStars Zoom Hand #247965373166:  Hold'em No Limit ($0.01/$0.02) - 2023/12/30 19:58:24 WET [2023/12/30 14:58:24 ET]
Table 'Halley' 6-max Seat #1 is the button
Seat 1: LLregs ($3.60 in chips)
Seat 2: 5let dr ($6.48 in chips)
Seat 3: WalkingDude19 ($2.25 in chips)
Seat 4: Cyzo1151 ($1.71 in chips)
Seat 5: luckyal00 ($2 in chips)
Seat 6: gDjambo ($3.79 in chips)
5let dr: posts small blind $0.01
WalkingDude19: posts big blind $0.02
*** HOLE CARDS ***
Dealt to LLregs [7c 8d]
Cyzo1151: folds
luckyal00: folds
gDjambo: folds
LLregs: folds
5let dr: folds
Uncalled bet ($0.01) returned to WalkingDude19
WalkingDude19 collected $0.02 from pot
WalkingDude19: doesn't show hand
*** SUMMARY ***
Total pot $0.02 | Rake $0
Seat 1: LLregs (button) folded before Flop (didn't bet)
Seat 2: 5let dr (small blind) folded before Flop
Seat 3: WalkingDude19 (big blind) collected ($0.02)
Seat 4: Cyzo1151 folded before Flop (didn't bet)
Seat 5: luckyal00 folded before Flop (didn't bet)
Seat 6: gDjambo folded before Flop (didn't bet)

PokerStars Zoom Hand #247965374162:  Hold'em No Limit ($0.01/$0.02) - 2023/12/30 19:58:28 WET [2023/12/30 14:58:28 ET]
Table 'Halley' 6-max Seat #1 is the button
Seat 1: FirmDr ($6.50 in chips)
Seat 2: jandsonpower ($2.03 in chips)
Seat 3: LLregs ($3.60 in chips)
Seat 4: shovetoi ($2.02 in chips)
Seat 5: AdilsonMI ($1.62 in chips)
Seat 6: gepard35 ($2.79 in chips)
jandsonpower: posts small blind $0.01
LLregs: posts big blind $0.02
*** HOLE CARDS ***
Dealt to LLregs [2d Kc]
shovetoi: folds
FirmDr is disconnected
AdilsonMI: raises $0.04 to $0.06
gepard35: folds
FirmDr has timed out while disconnected
FirmDr: folds
jandsonpower: folds
LLregs: folds
Uncalled bet ($0.04) returned to AdilsonMI
AdilsonMI collected $0.05 from pot
AdilsonMI: doesn't show hand
*** SUMMARY ***
Total pot $0.05 | Rake $0
Seat 1: FirmDr (button) folded before Flop (didn't bet)
Seat 2: jandsonpower (small blind) folded before Flop
Seat 3: LLregs (big blind) folded before Flop
Seat 4: shovetoi folded before Flop (didn't bet)
Seat 5: AdilsonMI collected ($0.05)
Seat 6: gepard35 folded before Flop (didn't bet)

PokerStars Zoom Hand #247965376273:  Hold'em No Limit ($0.01/$0.02) - 2023/12/30 19:58:36 WET [2023/12/30 14:58:36 ET]
Table 'Halley' 6-max Seat #1 is the button
Seat 1: fernandokonno ($0.90 in chips)
Seat 2: doggie_bollocks ($0.98 in chips)
Seat 3: jandsonpower ($3.73 in chips)
Seat 4: panosarg88 ($2.34 in chips)
Seat 5: bettanye ($2 in chips)
Seat 6: LLregs ($3.58 in chips)
doggie_bollocks: posts small blind $0.01
jandsonpower: posts big blind $0.02
*** HOLE CARDS ***
Dealt to LLregs [Ad Kh]
panosarg88: folds
bettanye: raises $0.03 to $0.05
LLregs: raises $0.13 to $0.18
fernandokonno: folds
doggie_bollocks: folds
jandsonpower: folds
bettanye: calls $0.13
*** FLOP *** [4h Kd 3d]
bettanye: checks
LLregs: bets $0.18
bettanye: calls $0.18
*** TURN *** [4h Kd 3d] [Tc]
bettanye: checks
LLregs: bets $0.16
bettanye: folds
Uncalled bet ($0.16) returned to LLregs
LLregs collected $0.72 from pot
LLregs: doesn't show hand
*** SUMMARY ***
Total pot $0.75 | Rake $0.03
Board [4h Kd 3d Tc]
Seat 1: fernandokonno (button) folded before Flop (didn't bet)
Seat 2: doggie_bollocks (small blind) folded before Flop
Seat 3: jandsonpower (big blind) folded before Flop
Seat 4: panosarg88 folded before Flop (didn't bet)
Seat 5: bettanye folded on the Turn
Seat 6: LLregs collected ($0.72)

PokerStars Zoom Hand #247965390899:  Hold'em No Limit ($0.01/$0.02) - 2023/12/30 19:59:32 WET [2023/12/30 14:59:32 ET]
Table 'Halley' 6-max Seat #1 is the button
Seat 1: schoneborn0408 ($0.87 in chips)
Seat 2: Val'demar.ks ($2.48 in chips)
Seat 3: cachusky ($3.96 in chips)
Seat 4: LLregs ($3.94 in chips)
Seat 5: dixvins ($3.25 in chips)
Seat 6: theRedDrag0n ($2 in chips)
Val'demar.ks: posts small blind $0.01
cachusky: posts big blind $0.02
*** HOLE CARDS ***
Dealt to LLregs [Qd 2d]
LLregs: folds
dixvins: folds
theRedDrag0n: folds
schoneborn0408: raises $0.02 to $0.04
Val'demar.ks: raises $0.12 to $0.16
cachusky: folds
schoneborn0408: calls $0.12
*** FLOP *** [Jd 2h Qs]
Val'demar.ks: checks
schoneborn0408: checks
*** TURN *** [Jd 2h Qs] [8c]
Val'demar.ks: checks
schoneborn0408: bets $0.02
Val'demar.ks: calls $0.02
*** RIVER *** [Jd 2h Qs 8c] [Kd]
Val'demar.ks: checks
schoneborn0408: checks
*** SHOW DOWN ***
Val'demar.ks: shows [5d Ac] (high card Ace)
schoneborn0408: shows [9d 8d] (a pair of Eights)
schoneborn0408 collected $0.37 from pot
*** SUMMARY ***
Total pot $0.38 | Rake $0.01
Board [Jd 2h Qs 8c Kd]
Seat 1: schoneborn0408 (button) showed [9d 8d] and won ($0.37) with a pair of Eights
Seat 2: Val'demar.ks (small blind) showed [5d Ac] and lost with high card Ace
Seat 3: cachusky (big blind) folded before Flop
Seat 4: LLregs folded before Flop (didn't bet)
Seat 5: dixvins folded before Flop (didn't bet)
Seat 6: theRedDrag0n folded before Flop (didn't bet)

PokerStars Zoom Hand #247965391774:  Hold'em No Limit ($0.01/$0.02) - 2023/12/30 19:59:36 WET [2023/12/30 14:59:36 ET]
Table 'Halley' 6-max Seat #1 is the button
Seat 1: ERMAK.DEN777 ($1.35 in chips)
Seat 2: AlGiNho ($2.52 in chips)
Seat 3: Indeko-plus ($2 in chips)
Seat 4: LLregs ($3.94 in chips)
Seat 5: Juonez ($2.88 in chips)
Seat 6: djmcool ($2.07 in chips)
AlGiNho: posts small blind $0.01
Indeko-plus: posts big blind $0.02
*** HOLE CARDS ***
Dealt to LLregs [Qd As]
LLregs: raises $0.04 to $0.06
Juonez: folds
djmcool: folds
ERMAK.DEN777: folds
AlGiNho: folds
Indeko-plus: raises $0.13 to $0.19
LLregs: calls $0.13
*** FLOP *** [Ks Td 7s]
Indeko-plus: bets $0.29
LLregs: calls $0.29
*** TURN *** [Ks Td 7s] [Ah]
Indeko-plus: bets $0.28
LLregs: calls $0.28
*** RIVER *** [Ks Td 7s Ah] [2s]
Indeko-plus: checks
LLregs: bets $3.18 and is all-in
Indeko-plus: folds
Uncalled bet ($3.18) returned to LLregs
LLregs collected $1.48 from pot
LLregs: doesn't show hand
*** SUMMARY ***
Total pot $1.53 | Rake $0.05
Board [Ks Td 7s Ah 2s]
Seat 1: ERMAK.DEN777 (button) folded before Flop (didn't bet)
Seat 2: AlGiNho (small blind) folded before Flop
Seat 3: Indeko-plus (big blind) folded on the River
Seat 4: LLregs collected ($1.48)
Seat 5: Juonez folded before Flop (didn't bet)
Seat 6: djmcool folded before Flop (didn't bet)

PokerStars Zoom Hand #247965407421:  Hold'em No Limit ($0.01/$0.02) - 2023/12/30 20:00:31 WET [2023/12/30 15:00:31 ET]
Table 'Halley' 6-max Seat #1 is the button
Seat 1: TrickyJ75 ($3.28 in chips)
Seat 2: LLregs ($4.66 in chips)
Seat 3: rahki124 ($1.34 in chips)
Seat 4: Balonas ($3.92 in chips)
Seat 5: Rockoteki ($2.64 in chips)
Seat 6: Sperick ($2.15 in chips)
LLregs: posts small blind $0.01
rahki124: posts big blind $0.02
*** HOLE CARDS ***
Dealt to LLregs [8s 9d]
Balonas: folds
Rockoteki: folds
Sperick: folds
TrickyJ75: folds
LLregs: folds
Uncalled bet ($0.01) returned to rahki124
rahki124 collected $0.02 from pot
rahki124: doesn't show hand
*** SUMMARY ***
Total pot $0.02 | Rake $0
Seat 1: TrickyJ75 (button) folded before Flop (didn't bet)
Seat 2: LLregs (small blind) folded before Flop
Seat 3: rahki124 (big blind) collected ($0.02)
Seat 4: Balonas folded before Flop (didn't bet)
Seat 5: Rockoteki folded before Flop (didn't bet)
Seat 6: Sperick folded before Flop (didn't bet)

PokerStars Zoom Hand #247965410775:  Hold'em No Limit ($0.01/$0.02) - 2023/12/30 20:00:43 WET [2023/12/30 15:00:43 ET]
Table 'Halley' 6-max Seat #1 is the button
Seat 1: LLregs ($4.65 in chips)
Seat 2: GULI-369 ($5.96 in chips)
Seat 3: RafaCartaxo ($2.26 in chips)
Seat 4: leedsrounder ($3.50 in chips)
Seat 5: WA.Anacleto ($1.56 in chips)
Seat 6: Rosa Chic671 ($1.01 in chips)
GULI-369: posts small blind $0.01
RafaCartaxo: posts big blind $0.02
*** HOLE CARDS ***
Dealt to LLregs [Qc 4h]
leedsrounder: folds
WA.Anacleto: folds
Rosa Chic671 is disconnected
Rosa Chic671 has timed out while disconnected
Rosa Chic671: folds
LLregs: raises $0.04 to $0.06
GULI-369: folds
RafaCartaxo: folds
Uncalled bet ($0.04) returned to LLregs
LLregs collected $0.05 from pot
LLregs: doesn't show hand
*** SUMMARY ***
Total pot $0.05 | Rake $0
Seat 1: LLregs (button) collected ($0.05)
Seat 2: GULI-369 (small blind) folded before Flop
Seat 3: RafaCartaxo (big blind) folded before Flop
Seat 4: leedsrounder folded before Flop (didn't bet)
Seat 5: WA.Anacleto folded before Flop (didn't bet)
Seat 6: Rosa Chic671 folded before Flop (didn't bet)

PokerStars Zoom Hand #247965418293:  Hold'em No Limit ($0.01/$0.02) - 2023/12/30 20:01:08 WET [2023/12/30 15:01:08 ET]
Table 'Halley' 6-max Seat #1 is the button
Seat 1: MassterD21 ($1.44 in chips)
Seat 2: kingdieter1 ($1.99 in chips)
Seat 3: LLregs ($4.68 in chips)
Seat 4: gepard35 ($2.59 in chips)
Seat 5: pietrek2 ($8.16 in chips)
Seat 6: edhillm ($2 in chips)
kingdieter1: posts small blind $0.01
LLregs: posts big blind $0.02
*** HOLE CARDS ***
Dealt to LLregs [8s Jh]
gepard35: folds
pietrek2: folds
edhillm: folds
MassterD21: folds
kingdieter1: folds
Uncalled bet ($0.01) returned to LLregs
LLregs collected $0.02 from pot
LLregs: doesn't show hand
*** SUMMARY ***
Total pot $0.02 | Rake $0
Seat 1: MassterD21 (button) folded before Flop (didn't bet)
Seat 2: kingdieter1 (small blind) folded before Flop
Seat 3: LLregs (big blind) collected ($0.02)
Seat 4: gepard35 folded before Flop (didn't bet)
Seat 5: pietrek2 folded before Flop (didn't bet)
Seat 6: edhillm folded before Flop (didn't bet)

PokerStars Zoom Hand #247965420899:  Hold'em No Limit ($0.01/$0.02) - 2023/12/30 20:01:16 WET [2023/12/30 15:01:16 ET]
Table 'Halley' 6-max Seat #1 is the button
Seat 1: Anatol89419 ($1.07 in chips)
Seat 2: Fasteddie35 ($2.22 in chips)
Seat 3: SchmittNieto ($2 in chips)
Seat 4: dkaygenius ($1.61 in chips)
Seat 5: LLregs ($4.69 in chips)
Seat 6: JaUm_V ($3.57 in chips)
Fasteddie35: posts small blind $0.01
SchmittNieto: posts big blind $0.02
*** HOLE CARDS ***
Dealt to LLregs [Qd Jc]
dkaygenius: folds
LLregs: raises $0.04 to $0.06
JaUm_V: folds
Anatol89419: calls $0.06
Fasteddie35: folds
SchmittNieto: calls $0.04
*** FLOP *** [4h Th Td]
SchmittNieto: checks
LLregs: checks
Anatol89419: checks
*** TURN *** [4h Th Td] [5h]
SchmittNieto: bets $0.09
LLregs: folds
Anatol89419: folds
Uncalled bet ($0.09) returned to SchmittNieto
SchmittNieto collected $0.18 from pot
SchmittNieto: doesn't show hand
*** SUMMARY ***
Total pot $0.19 | Rake $0.01
Board [4h Th Td 5h]
Seat 1: Anatol89419 (button) folded on the Turn
Seat 2: Fasteddie35 (small blind) folded before Flop
Seat 3: SchmittNieto (big blind) collected ($0.18)
Seat 4: dkaygenius folded before Flop (didn't bet)
Seat 5: LLregs folded on the Turn
Seat 6: JaUm_V folded before Flop (didn't bet)

PokerStars Zoom Hand #247965433809:  Hold'em No Limit ($0.01/$0.02) - 2023/12/30 20:01:53 WET [2023/12/30 15:01:53 ET]
Table 'Halley' 6-max Seat #1 is the button
Seat 1: barmaley164 ($2.46 in chips)
Seat 2: ifiret68 ($2.09 in chips)
Seat 3: Lizzan618 ($2.66 in chips)
Seat 4: LLregs ($4.63 in chips)
Seat 5: ajimvr ($6.06 in chips)
Seat 6: Rockoteki ($2.61 in chips)
ifiret68: posts small blind $0.01
Lizzan618: posts big blind $0.02
*** HOLE CARDS ***
Dealt to LLregs [8s 7c]
LLregs: folds
ajimvr: raises $0.04 to $0.06
Rockoteki: folds
barmaley164: folds
ifiret68: folds
Lizzan618: folds
Uncalled bet ($0.04) returned to ajimvr
ajimvr collected $0.05 from pot
ajimvr: doesn't show hand
*** SUMMARY ***
Total pot $0.05 | Rake $0
Seat 1: barmaley164 (button) folded before Flop (didn't bet)
Seat 2: ifiret68 (small blind) folded before Flop
Seat 3: Lizzan618 (big blind) folded before Flop
Seat 4: LLregs folded before Flop (didn't bet)
Seat 5: ajimvr collected ($0.05)
Seat 6: Rockoteki folded before Flop (didn't bet)

PokerStars Zoom Hand #247965435250:  Hold'em No Limit ($0.01/$0.02) - 2023/12/30 20:01:57 WET [2023/12/30 15:01:57 ET]
Table 'Halley' 6-max Seat #1 is the button
Seat 1: TrickyJ75 ($3.21 in chips)
Seat 2: theRedDrag0n ($2.03 in chips)
Seat 3: LLregs ($4.63 in chips)
Seat 4: davidbarrels ($2.35 in chips)
Seat 5: jandsonpower ($3.89 in chips)
Seat 6: LordRocky89 ($2.28 in chips)
theRedDrag0n: posts small blind $0.01
LLregs: posts big blind $0.02
*** HOLE CARDS ***
Dealt to LLregs [2d Jc]
davidbarrels: folds
jandsonpower: folds
LordRocky89: folds
TrickyJ75: raises $0.03 to $0.05
theRedDrag0n: folds
LLregs: folds
Uncalled bet ($0.03) returned to TrickyJ75
TrickyJ75 collected $0.05 from pot
TrickyJ75: doesn't show hand
*** SUMMARY ***
Total pot $0.05 | Rake $0
Seat 1: TrickyJ75 (button) collected ($0.05)
Seat 2: theRedDrag0n (small blind) folded before Flop
Seat 3: LLregs (big blind) folded before Flop
Seat 4: davidbarrels folded before Flop (didn't bet)
Seat 5: jandsonpower folded before Flop (didn't bet)
Seat 6: LordRocky89 folded before Flop (didn't bet)

PokerStars Zoom Hand #247965444120:  Hold'em No Limit ($0.01/$0.02) - 2023/12/30 20:02:21 WET [2023/12/30 15:02:21 ET]
Table 'Halley' 6-max Seat #1 is the button
Seat 1: dkaygenius ($5.32 in chips)
Seat 2: LLregs ($4.61 in chips)
Seat 3: Balonas ($12.46 in chips)
Seat 4: Henrysport ($2.53 in chips)
Seat 5: Rockoteki ($2.61 in chips)
Seat 6: bowsergama18 ($1.11 in chips)
LLregs: posts small blind $0.01
Balonas: posts big blind $0.02
*** HOLE CARDS ***
Dealt to LLregs [6c 3h]
Henrysport: raises $0.03 to $0.05
Rockoteki: folds
bowsergama18: folds
dkaygenius: folds
LLregs: folds
Balonas: folds
Uncalled bet ($0.03) returned to Henrysport
Henrysport collected $0.05 from pot
Henrysport: doesn't show hand
*** SUMMARY ***
Total pot $0.05 | Rake $0
Seat 1: dkaygenius (button) folded before Flop (didn't bet)
Seat 2: LLregs (small blind) folded before Flop
Seat 3: Balonas (big blind) folded before Flop
Seat 4: Henrysport collected ($0.05)
Seat 5: Rockoteki folded before Flop (didn't bet)
Seat 6: bowsergama18 folded before Flop (didn't bet)

PokerStars Zoom Hand #247965446250:  Hold'em No Limit ($0.01/$0.02) - 2023/12/30 20:02:27 WET [2023/12/30 15:02:27 ET]
Table 'Halley' 6-max Seat #1 is the button
Seat 1: LLregs ($4.60 in chips)
Seat 2: jailson509 ($1.39 in chips)
Seat 3: se62dor1961 ($0.95 in chips)
Seat 4: ajimvr ($6.09 in chips)
Seat 5: iliyan66 ($8.12 in chips)
Seat 6: Kykyrit ($2.71 in chips)
jailson509: posts small blind $0.01
se62dor1961: posts big blind $0.02
*** HOLE CARDS ***
Dealt to LLregs [8d Kc]
ajimvr: folds
iliyan66: folds
Kykyrit: folds
LLregs: raises $0.04 to $0.06
jailson509: raises $0.08 to $0.14
se62dor1961: folds
LLregs: folds
Uncalled bet ($0.08) returned to jailson509
jailson509 collected $0.14 from pot
jailson509: doesn't show hand
*** SUMMARY ***
Total pot $0.14 | Rake $0
Seat 1: LLregs (button) folded before Flop
Seat 2: jailson509 (small blind) collected ($0.14)
Seat 3: se62dor1961 (big blind) folded before Flop
Seat 4: ajimvr folded before Flop (didn't bet)
Seat 5: iliyan66 folded before Flop (didn't bet)
Seat 6: Kykyrit folded before Flop (didn't bet)

PokerStars Zoom Hand #247965460980:  Hold'em No Limit ($0.01/$0.02) - 2023/12/30 20:03:06 WET [2023/12/30 15:03:06 ET]
Table 'Halley' 6-max Seat #1 is the button
Seat 1: psdgr3 ($2.02 in chips)
Seat 2: 232489410 ($2 in chips)
Seat 3: WolveroX ($1 in chips)
Seat 4: Handede ($1.95 in chips)
Seat 5: dobri151 ($2.71 in chips)
Seat 6: LLregs ($4.54 in chips)
232489410: posts small blind $0.01
WolveroX: posts big blind $0.02
*** HOLE CARDS ***
Dealt to LLregs [6c 4d]
Handede: folds
dobri151: folds
LLregs: folds
psdgr3: raises $0.02 to $0.04
232489410: folds
WolveroX: folds
Uncalled bet ($0.02) returned to psdgr3
psdgr3 collected $0.05 from pot
psdgr3: doesn't show hand
*** SUMMARY ***
Total pot $0.05 | Rake $0
Seat 1: psdgr3 (button) collected ($0.05)
Seat 2: 232489410 (small blind) folded before Flop
Seat 3: WolveroX (big blind) folded before Flop
Seat 4: Handede folded before Flop (didn't bet)
Seat 5: dobri151 folded before Flop (didn't bet)
Seat 6: LLregs folded before Flop (didn't bet)

PokerStars Zoom Hand #247965462498:  Hold'em No Limit ($0.01/$0.02) - 2023/12/30 20:03:10 WET [2023/12/30 15:03:10 ET]
Table 'Halley' 6-max Seat #1 is the button
Seat 1: diokyn ($1.74 in chips)
Seat 2: CANYA_V ($5.62 in chips)
Seat 3: Indeko-plus ($2.28 in chips)
Seat 4: Ninjafuturo123 ($3.45 in chips)
Seat 5: LLregs ($4.54 in chips)
Seat 6: batya1212 ($2.26 in chips)
CANYA_V: posts small blind $0.01
Indeko-plus: posts big blind $0.02
*** HOLE CARDS ***
Dealt to LLregs [8d 3d]
Ninjafuturo123: folds
LLregs: folds
batya1212: folds
diokyn: folds
CANYA_V: folds
Uncalled bet ($0.01) returned to Indeko-plus
Indeko-plus collected $0.02 from pot
Indeko-plus: doesn't show hand
*** SUMMARY ***
Total pot $0.02 | Rake $0
Seat 1: diokyn (button) folded before Flop (didn't bet)
Seat 2: CANYA_V (small blind) folded before Flop
Seat 3: Indeko-plus (big blind) collected ($0.02)
Seat 4: Ninjafuturo123 folded before Flop (didn't bet)
Seat 5: LLregs folded before Flop (didn't bet)
Seat 6: batya1212 folded before Flop (didn't bet)

PokerStars Zoom Hand #247965464066:  Hold'em No Limit ($0.01/$0.02) - 2023/12/30 20:03:14 WET [2023/12/30 15:03:14 ET]
Table 'Halley' 6-max Seat #1 is the button
Seat 1: FEROIZ ($3.97 in chips)
Seat 2: Shizukas104 ($3.40 in chips)
Seat 3: Silvers14 ($2.33 in chips)
Seat 4: rainerr69 ($2.15 in chips)
Seat 5: ARES_312 ($2.04 in chips)
Seat 6: LLregs ($4.54 in chips)
Shizukas104: posts small blind $0.01
Silvers14: posts big blind $0.02
*** HOLE CARDS ***
Dealt to LLregs [2d 9s]
rainerr69: folds
ARES_312: folds
LLregs: folds
FEROIZ: folds
Shizukas104: raises $0.03 to $0.05
Silvers14: raises $0.11 to $0.16
Shizukas104: raises $0.28 to $0.44
Silvers14: folds
Uncalled bet ($0.28) returned to Shizukas104
Shizukas104 collected $0.32 from pot
Shizukas104: doesn't show hand
*** SUMMARY ***
Total pot $0.32 | Rake $0
Seat 1: FEROIZ (button) folded before Flop (didn't bet)
Seat 2: Shizukas104 (small blind) collected ($0.32)
Seat 3: Silvers14 (big blind) folded before Flop
Seat 4: rainerr69 folded before Flop (didn't bet)
Seat 5: ARES_312 folded before Flop (didn't bet)
Seat 6: LLregs folded before Flop (didn't bet)

PokerStars Zoom Hand #247965465219:  Hold'em No Limit ($0.01/$0.02) - 2023/12/30 20:03:17 WET [2023/12/30 15:03:17 ET]
Table 'Halley' 6-max Seat #1 is the button
Seat 1: cachusky ($3.95 in chips)
Seat 2: LLregs ($4.54 in chips)
Seat 3: davidbarrels ($2.48 in chips)
Seat 4: ONIPIKA ($2.54 in chips)
Seat 5: francomassoni ($2.34 in chips)
Seat 6: gio119 ($2.19 in chips)
LLregs: posts small blind $0.01
davidbarrels: posts big blind $0.02
*** HOLE CARDS ***
Dealt to LLregs [5c 7c]
ONIPIKA: folds
francomassoni: folds
gio119: raises $0.05 to $0.07
cachusky: folds
LLregs: calls $0.06
davidbarrels: folds
*** FLOP *** [3s Kc 4s]
LLregs: checks
gio119: bets $0.23
LLregs: folds
Uncalled bet ($0.23) returned to gio119
gio119 collected $0.15 from pot
gio119: doesn't show hand
*** SUMMARY ***
Total pot $0.16 | Rake $0.01
Board [3s Kc 4s]
Seat 1: cachusky (button) folded before Flop (didn't bet)
Seat 2: LLregs (small blind) folded on the Flop
Seat 3: davidbarrels (big blind) folded before Flop
Seat 4: ONIPIKA folded before Flop (didn't bet)
Seat 5: francomassoni folded before Flop (didn't bet)
Seat 6: gio119 collected ($0.15)

PokerStars Zoom Hand #247965477949:  Hold'em No Limit ($0.01/$0.02) - 2023/12/30 20:03:51 WET [2023/12/30 15:03:51 ET]
Table 'Halley' 6-max Seat #1 is the button
Seat 1: frankquanki ($3.14 in chips)
Seat 2: kingdieter1 ($2.01 in chips)
Seat 3: Shizukas104 ($3.92 in chips)
Seat 4: Tomswiss87 ($1.74 in chips)
Seat 5: LLregs ($4.47 in chips)
Seat 6: AntiGosuTux ($3.25 in chips)
kingdieter1: posts small blind $0.01
Shizukas104: posts big blind $0.02
*** HOLE CARDS ***
Dealt to LLregs [Qs Qd]
Tomswiss87: raises $0.04 to $0.06
LLregs: raises $0.12 to $0.18
AntiGosuTux: folds
frankquanki: calls $0.18
kingdieter1: folds
Shizukas104: folds
Tomswiss87: calls $0.12
*** FLOP *** [4c 3h 8c]
Tomswiss87: checks
LLregs: checks
frankquanki: bets $0.28
Tomswiss87: folds
LLregs: calls $0.28
*** TURN *** [4c 3h 8c] [9s]
LLregs: checks
frankquanki: checks
*** RIVER *** [4c 3h 8c 9s] [Kh]
LLregs: checks
frankquanki: checks
*** SHOW DOWN ***
LLregs: shows [Qs Qd] (a pair of Queens)
frankquanki: shows [Qh Qc] (a pair of Queens)
LLregs collected $0.55 from pot
frankquanki collected $0.54 from pot
*** SUMMARY ***
Total pot $1.13 | Rake $0.04
Board [4c 3h 8c 9s Kh]
Seat 1: frankquanki (button) showed [Qh Qc] and won ($0.54) with a pair of Queens
Seat 2: kingdieter1 (small blind) folded before Flop
Seat 3: Shizukas104 (big blind) folded before Flop
Seat 4: Tomswiss87 folded on the Flop
Seat 5: LLregs showed [Qs Qd] and won ($0.55) with a pair of Queens
Seat 6: AntiGosuTux folded before Flop (didn't bet)

PokerStars Zoom Hand #247965494459:  Hold'em No Limit ($0.01/$0.02) - 2023/12/30 20:04:34 WET [2023/12/30 15:04:34 ET]
Table 'Halley' 6-max Seat #1 is the button
Seat 1: LLregs ($4.56 in chips)
Seat 2: homefull621 ($2 in chips)
Seat 3: Caluguis ($1.93 in chips)
Seat 4: AdilsonMI ($1.51 in chips)
Seat 5: ARES_312 ($2.01 in chips)
Seat 6: rrluis1930 ($2 in chips)
homefull621: posts small blind $0.01
Caluguis: posts big blind $0.02
*** HOLE CARDS ***
Dealt to LLregs [Ks Jc]
AdilsonMI: folds
ARES_312: folds
rrluis1930: folds
LLregs: raises $0.04 to $0.06
homefull621: calls $0.05
Caluguis: folds
*** FLOP *** [9d 5h Qs]
homefull621: checks
LLregs: checks
*** TURN *** [9d 5h Qs] [3h]
homefull621: checks
LLregs: bets $0.03
homefull621: calls $0.03
*** RIVER *** [9d 5h Qs 3h] [Th]
homefull621: checks
LLregs: bets $0.25
homefull621: folds
Uncalled bet ($0.25) returned to LLregs
LLregs collected $0.19 from pot
LLregs: doesn't show hand
*** SUMMARY ***
Total pot $0.20 | Rake $0.01
Board [9d 5h Qs 3h Th]
Seat 1: LLregs (button) collected ($0.19)
Seat 2: homefull621 (small blind) folded on the River
Seat 3: Caluguis (big blind) folded before Flop
Seat 4: AdilsonMI folded before Flop (didn't bet)
Seat 5: ARES_312 folded before Flop (didn't bet)
Seat 6: rrluis1930 folded before Flop (didn't bet)

PokerStars Zoom Hand #247965510327:  Hold'em No Limit ($0.01/$0.02) - 2023/12/30 20:05:15 WET [2023/12/30 15:05:15 ET]
Table 'Halley' 6-max Seat #1 is the button
Seat 1: WalkingDude19 ($2.27 in chips)
Seat 2: DeepRybka10 ($2.37 in chips)
Seat 3: LLregs ($4.66 in chips)
Seat 4: davidbarrels ($2.40 in chips)
Seat 5: xTheBulletsx ($2.08 in chips)
Seat 6: iliyan66 ($5.27 in chips)
DeepRybka10: posts small blind $0.01
LLregs: posts big blind $0.02
*** HOLE CARDS ***
Dealt to LLregs [Js 4c]
davidbarrels: folds
xTheBulletsx: folds
iliyan66: folds
WalkingDude19: folds
DeepRybka10: raises $0.04 to $0.06
LLregs: folds
Uncalled bet ($0.04) returned to DeepRybka10
DeepRybka10 collected $0.04 from pot
DeepRybka10: doesn't show hand
*** SUMMARY ***
Total pot $0.04 | Rake $0
Seat 1: WalkingDude19 (button) folded before Flop (didn't bet)
Seat 2: DeepRybka10 (small blind) collected ($0.04)
Seat 3: LLregs (big blind) folded before Flop
Seat 4: davidbarrels folded before Flop (didn't bet)
Seat 5: xTheBulletsx folded before Flop (didn't bet)
Seat 6: iliyan66 folded before Flop (didn't bet)

PokerStars Zoom Hand #247965518231:  Hold'em No Limit ($0.01/$0.02) - 2023/12/30 20:05:35 WET [2023/12/30 15:05:35 ET]
Table 'Halley' 6-max Seat #1 is the button
Seat 1: LLregs ($4.64 in chips)
Seat 2: graves80 ($2.31 in chips)
Seat 3: Chrigra03 ($1.19 in chips)
Seat 4: Bardiyayaya ($2.06 in chips)
Seat 5: JaUm_V ($5.17 in chips)
Seat 6: kingdieter1 ($2.03 in chips)
graves80: posts small blind $0.01
Chrigra03: posts big blind $0.02
*** HOLE CARDS ***
Dealt to LLregs [4h Qh]
Bardiyayaya: folds
JaUm_V: folds
kingdieter1: folds
LLregs: raises $0.04 to $0.06
graves80: calls $0.05
Chrigra03: folds
*** FLOP *** [8c Ks 8s]
graves80: bets $0.10
LLregs: folds
Uncalled bet ($0.10) returned to graves80
graves80 collected $0.14 from pot
graves80: doesn't show hand
*** SUMMARY ***
Total pot $0.14 | Rake $0
Board [8c Ks 8s]
Seat 1: LLregs (button) folded on the Flop
Seat 2: graves80 (small blind) collected ($0.14)
Seat 3: Chrigra03 (big blind) folded before Flop
Seat 4: Bardiyayaya folded before Flop (didn't bet)
Seat 5: JaUm_V folded before Flop (didn't bet)
Seat 6: kingdieter1 folded before Flop (didn't bet)

PokerStars Zoom Hand #247965516095:  Hold'em No Limit ($0.01/$0.02) - 2023/12/30 20:05:31 WET [2023/12/30 15:05:31 ET]
Table 'Halley' 6-max Seat #1 is the button
Seat 1: Harold_Seven ($2.38 in chips)
Seat 2: JFSTommy ($0.66 in chips)
Seat 3: francomassoni ($4.07 in chips)
Seat 4: LLregs ($4.64 in chips)
Seat 5: iliyan66 ($7.99 in chips)
Seat 6: Sir_bon0 ($2.23 in chips)
JFSTommy: posts small blind $0.01
francomassoni: posts big blind $0.02
*** HOLE CARDS ***
Dealt to LLregs [Qc 5h]
LLregs: folds
iliyan66: raises $0.04 to $0.06
Sir_bon0: folds
Harold_Seven: folds
JFSTommy: raises $0.10 to $0.16
francomassoni: folds
iliyan66: calls $0.10
*** FLOP *** [3h 7s 8d]
JFSTommy: bets $0.50 and is all-in
iliyan66: calls $0.50
*** TURN *** [3h 7s 8d] [6d]
*** RIVER *** [3h 7s 8d 6d] [Th]
*** SHOW DOWN ***
JFSTommy: shows [As Tc] (a pair of Tens)
iliyan66: shows [7c 7h] (three of a kind, Sevens)
iliyan66 collected $1.29 from pot
*** SUMMARY ***
Total pot $1.34 | Rake $0.05
Board [3h 7s 8d 6d Th]
Seat 1: Harold_Seven (button) folded before Flop (didn't bet)
Seat 2: JFSTommy (small blind) showed [As Tc] and lost with a pair of Tens
Seat 3: francomassoni (big blind) folded before Flop
Seat 4: LLregs folded before Flop (didn't bet)
Seat 5: iliyan66 showed [7c 7h] and won ($1.29) with three of a kind, Sevens
Seat 6: Sir_bon0 folded before Flop (didn't bet)

PokerStars Zoom Hand #247965532854:  Hold'em No Limit ($0.01/$0.02) - 2023/12/30 20:06:12 WET [2023/12/30 15:06:12 ET]
Table 'Halley' 6-max Seat #1 is the button
Seat 1: Caluguis ($2.95 in chips)
Seat 2: rrluis1930 ($2 in chips)
Seat 3: LLregs ($4.57 in chips)
Seat 4: bowsergama18 ($1.03 in chips)
Seat 5: Alel861 ($1.50 in chips)
Seat 6: Dorian4win ($1.11 in chips)
rrluis1930: posts small blind $0.01
LLregs: posts big blind $0.02
*** HOLE CARDS ***
Dealt to LLregs [3s 2h]
bowsergama18: folds
Alel861: folds
Dorian4win: folds
Caluguis: folds
rrluis1930: folds
Uncalled bet ($0.01) returned to LLregs
LLregs collected $0.02 from pot
LLregs: doesn't show hand
*** SUMMARY ***
Total pot $0.02 | Rake $0
Seat 1: Caluguis (button) folded before Flop (didn't bet)
Seat 2: rrluis1930 (small blind) folded before Flop
Seat 3: LLregs (big blind) collected ($0.02)
Seat 4: bowsergama18 folded before Flop (didn't bet)
Seat 5: Alel861 folded before Flop (didn't bet)
Seat 6: Dorian4win folded before Flop (didn't bet)

PokerStars Zoom Hand #247965529440:  Hold'em No Limit ($0.01/$0.02) - 2023/12/30 20:06:04 WET [2023/12/30 15:06:04 ET]
Table 'Halley' 6-max Seat #1 is the button
Seat 1: Alel861 ($1.50 in chips)
Seat 2: Shmatrixs ($2.01 in chips)
Seat 3: gepard35 ($2.67 in chips)
Seat 4: nadd399 ($2 in chips)
Seat 5: Seeek275 ($2.45 in chips)
Seat 6: LLregs ($4.58 in chips)
Shmatrixs: posts small blind $0.01
gepard35: posts big blind $0.02
*** HOLE CARDS ***
Dealt to LLregs [6c Ah]
nadd399: folds
Seeek275: raises $0.04 to $0.06
LLregs: folds
Alel861: folds
Shmatrixs: folds
gepard35: folds
Uncalled bet ($0.04) returned to Seeek275
Seeek275 collected $0.05 from pot
Seeek275: doesn't show hand
*** SUMMARY ***
Total pot $0.05 | Rake $0
Seat 1: Alel861 (button) folded before Flop (didn't bet)
Seat 2: Shmatrixs (small blind) folded before Flop
Seat 3: gepard35 (big blind) folded before Flop
Seat 4: nadd399 folded before Flop (didn't bet)
Seat 5: Seeek275 collected ($0.05)
Seat 6: LLregs folded before Flop (didn't bet)

PokerStars Zoom Hand #247965531195:  Hold'em No Limit ($0.01/$0.02) - 2023/12/30 20:06:08 WET [2023/12/30 15:06:08 ET]
Table 'Halley' 6-max Seat #1 is the button
Seat 1: francomassoni ($2 in chips)
Seat 2: LLregs ($4.58 in chips)
Seat 3: 232489410 ($2 in chips)
Seat 4: Juonez ($3.37 in chips)
Seat 5: Aschi1970 ($1.65 in chips)
Seat 6: wanderer7660 ($1.81 in chips)
LLregs: posts small blind $0.01
232489410: posts big blind $0.02
*** HOLE CARDS ***
Dealt to LLregs [7c Th]
Juonez: folds
Aschi1970: raises $0.02 to $0.04
wanderer7660: folds
francomassoni: folds
LLregs: folds
232489410: calls $0.02
*** FLOP *** [Qs 2h 2d]
232489410: checks
Aschi1970: bets $0.02
232489410: calls $0.02
*** TURN *** [Qs 2h 2d] [Ks]
232489410: checks
Aschi1970: checks
*** RIVER *** [Qs 2h 2d Ks] [3d]
232489410: checks
Aschi1970: checks
*** SHOW DOWN ***
232489410: shows [Jh Jc] (two pair, Jacks and Deuces)
Aschi1970: mucks hand
232489410 collected $0.13 from pot
*** SUMMARY ***
Total pot $0.13 | Rake $0
Board [Qs 2h 2d Ks 3d]
Seat 1: francomassoni (button) folded before Flop (didn't bet)
Seat 2: LLregs (small blind) folded before Flop
Seat 3: 232489410 (big blind) showed [Jh Jc] and won ($0.13) with two pair, Jacks and Deuces
Seat 4: Juonez folded before Flop (didn't bet)
Seat 5: Aschi1970 mucked [Ad 5d]
Seat 6: wanderer7660 folded before Flop (didn't bet)

PokerStars Zoom Hand #247965539202:  Hold'em No Limit ($0.01/$0.02) - 2023/12/30 20:06:28 WET [2023/12/30 15:06:28 ET]
Table 'Halley' 6-max Seat #1 is the button
Seat 1: ZorroZoltan ($2.30 in chips)
Seat 2: craz400 ($1.04 in chips)
Seat 3: psdgr3 ($2.02 in chips)
Seat 4: LLregs ($4.58 in chips)
Seat 5: N0tsobig ($4.18 in chips)
Seat 6: Dimoni797979 ($2.56 in chips)
craz400: posts small blind $0.01
psdgr3: posts big blind $0.02
*** HOLE CARDS ***
Dealt to LLregs [5s Kh]
LLregs: folds
N0tsobig: folds
Dimoni797979: folds
ZorroZoltan: folds
craz400: raises $0.04 to $0.06
psdgr3: folds
Uncalled bet ($0.04) returned to craz400
craz400 collected $0.04 from pot
craz400: doesn't show hand
*** SUMMARY ***
Total pot $0.04 | Rake $0
Seat 1: ZorroZoltan (button) folded before Flop (didn't bet)
Seat 2: craz400 (small blind) collected ($0.04)
Seat 3: psdgr3 (big blind) folded before Flop
Seat 4: LLregs folded before Flop (didn't bet)
Seat 5: N0tsobig folded before Flop (didn't bet)
Seat 6: Dimoni797979 folded before Flop (didn't bet)

PokerStars Zoom Hand #247965537681:  Hold'em No Limit ($0.01/$0.02) - 2023/12/30 20:06:24 WET [2023/12/30 15:06:24 ET]
Table 'Halley' 6-max Seat #1 is the button
Seat 1: Shizukas104 ($3.85 in chips)
Seat 2: Nerful ($2 in chips)
Seat 3: Cnavy ($2.32 in chips)
Seat 4: organik33 ($1.57 in chips)
Seat 5: LLregs ($4.58 in chips)
Seat 6: lasica8312 ($0.90 in chips)
Nerful: posts small blind $0.01
Cnavy: posts big blind $0.02
*** HOLE CARDS ***
Dealt to LLregs [5s 8d]
organik33: folds
LLregs: folds
lasica8312: folds
Shizukas104: folds
Nerful: raises $0.04 to $0.06
Cnavy: folds
Uncalled bet ($0.04) returned to Nerful
Nerful collected $0.04 from pot
Nerful: doesn't show hand
*** SUMMARY ***
Total pot $0.04 | Rake $0
Seat 1: Shizukas104 (button) folded before Flop (didn't bet)
Seat 2: Nerful (small blind) collected ($0.04)
Seat 3: Cnavy (big blind) folded before Flop
Seat 4: organik33 folded before Flop (didn't bet)
Seat 5: LLregs folded before Flop (didn't bet)
Seat 6: lasica8312 folded before Flop (didn't bet)

PokerStars Zoom Hand #247965540535:  Hold'em No Limit ($0.01/$0.02) - 2023/12/30 20:06:32 WET [2023/12/30 15:06:32 ET]
Table 'Halley' 6-max Seat #1 is the button
Seat 1: Fasteddie35 ($2.01 in chips)
Seat 2: LLregs ($4.58 in chips)
Seat 3: Juonez ($2.73 in chips)
Seat 4: Seeek275 ($2.48 in chips)
Seat 5: PAMEGERA ($2.76 in chips)
Seat 6: Tornado$ky ($2.21 in chips)
LLregs: posts small blind $0.01
Juonez: posts big blind $0.02
*** HOLE CARDS ***
Dealt to LLregs [Js 2h]
Seeek275: folds
PAMEGERA: raises $0.03 to $0.05
Tornado$ky: folds
Fasteddie35: folds
LLregs: folds
Juonez: folds
Uncalled bet ($0.03) returned to PAMEGERA
PAMEGERA collected $0.05 from pot
PAMEGERA: doesn't show hand
*** SUMMARY ***
Total pot $0.05 | Rake $0
Seat 1: Fasteddie35 (button) folded before Flop (didn't bet)
Seat 2: LLregs (small blind) folded before Flop
Seat 3: Juonez (big blind) folded before Flop
Seat 4: Seeek275 folded before Flop (didn't bet)
Seat 5: PAMEGERA collected ($0.05)
Seat 6: Tornado$ky folded before Flop (didn't bet)

PokerStars Zoom Hand #247965542025:  Hold'em No Limit ($0.01/$0.02) - 2023/12/30 20:06:35 WET [2023/12/30 15:06:35 ET]
Table 'Halley' 6-max Seat #1 is the button
Seat 1: LLregs ($4.57 in chips)
Seat 2: psdgr3 ($2 in chips)
Seat 3: Gustaveira ($3 in chips)
Seat 4: Harold_Seven ($1.50 in chips)
Seat 5: ERMAK.DEN777 ($1.21 in chips)
Seat 6: iliyan66 ($5.63 in chips)
psdgr3: posts small blind $0.01
Gustaveira: posts big blind $0.02
*** HOLE CARDS ***
Dealt to LLregs [2d 7c]
Harold_Seven: folds
ERMAK.DEN777 has timed out
ERMAK.DEN777: folds
iliyan66: folds
LLregs: folds
psdgr3: raises $0.02 to $0.04
Gustaveira: calls $0.02
*** FLOP *** [Js 7h Qs]
psdgr3: checks
Gustaveira: bets $0.08
psdgr3: folds
Uncalled bet ($0.08) returned to Gustaveira
Gustaveira collected $0.08 from pot
Gustaveira: doesn't show hand
*** SUMMARY ***
Total pot $0.08 | Rake $0
Board [Js 7h Qs]
Seat 1: LLregs (button) folded before Flop (didn't bet)
Seat 2: psdgr3 (small blind) folded on the Flop
Seat 3: Gustaveira (big blind) collected ($0.08)
Seat 4: Harold_Seven folded before Flop (didn't bet)
Seat 5: ERMAK.DEN777 folded before Flop (didn't bet)
Seat 6: iliyan66 folded before Flop (didn't bet)

PokerStars Zoom Hand #247965545171:  Hold'em No Limit ($0.01/$0.02) - 2023/12/30 20:06:43 WET [2023/12/30 15:06:43 ET]
Table 'Halley' 6-max Seat #1 is the button
Seat 1: MassterD21 ($1.31 in chips)
Seat 2: Sir_bon0 ($2.20 in chips)
Seat 3: marwood888 ($2.99 in chips)
Seat 4: diokyn ($2.90 in chips)
Seat 5: LLregs ($4.57 in chips)
Seat 6: Vitaliy v775 ($2.37 in chips)
Sir_bon0: posts small blind $0.01
marwood888: posts big blind $0.02
*** HOLE CARDS ***
Dealt to LLregs [Kc Qs]
diokyn: folds
LLregs: raises $0.04 to $0.06
Vitaliy v775: folds
MassterD21: folds
Sir_bon0: folds
marwood888: folds
Uncalled bet ($0.04) returned to LLregs
LLregs collected $0.05 from pot
LLregs: doesn't show hand
*** SUMMARY ***
Total pot $0.05 | Rake $0
Seat 1: MassterD21 (button) folded before Flop (didn't bet)
Seat 2: Sir_bon0 (small blind) folded before Flop
Seat 3: marwood888 (big blind) folded before Flop
Seat 4: diokyn folded before Flop (didn't bet)
Seat 5: LLregs collected ($0.05)
Seat 6: Vitaliy v775 folded before Flop (didn't bet)

PokerStars Zoom Hand #247965543560:  Hold'em No Limit ($0.01/$0.02) - 2023/12/30 20:06:39 WET [2023/12/30 15:06:39 ET]
Table 'Halley' 6-max Seat #1 is the button
Seat 1: francomassoni ($2.31 in chips)
Seat 2: Ar198513 ($1.50 in chips)
Seat 3: nuttymuch ($5.34 in chips)
Seat 4: pöbel23 ($2.21 in chips)
Seat 5: Indeko-plus ($2.67 in chips)
Seat 6: LLregs ($4.57 in chips)
Ar198513: posts small blind $0.01
nuttymuch: posts big blind $0.02
*** HOLE CARDS ***
Dealt to LLregs [7s 5d]
pöbel23: calls $0.02
Indeko-plus: folds
LLregs: folds
francomassoni: raises $0.08 to $0.10
Ar198513: folds
nuttymuch: folds
pöbel23: calls $0.08
*** FLOP *** [Js 3h 9c]
pöbel23: checks
francomassoni: bets $0.11
pöbel23: calls $0.11
*** TURN *** [Js 3h 9c] [Qc]
pöbel23: checks
francomassoni: bets $0.32
pöbel23: folds
Uncalled bet ($0.32) returned to francomassoni
francomassoni collected $0.43 from pot
francomassoni: doesn't show hand
*** SUMMARY ***
Total pot $0.45 | Rake $0.02
Board [Js 3h 9c Qc]
Seat 1: francomassoni (button) collected ($0.43)
Seat 2: Ar198513 (small blind) folded before Flop
Seat 3: nuttymuch (big blind) folded before Flop
Seat 4: pöbel23 folded on the Turn
Seat 5: Indeko-plus folded before Flop (didn't bet)
Seat 6: LLregs folded before Flop (didn't bet)

PokerStars Zoom Hand #247965557031:  Hold'em No Limit ($0.01/$0.02) - 2023/12/30 20:07:14 WET [2023/12/30 15:07:14 ET]
Table 'Halley' 6-max Seat #1 is the button
Seat 1: peto322 ($2.50 in chips)
Seat 2: my sapphire ($1.90 in chips)
Seat 3: LLregs ($4.60 in chips)
Seat 4: Shmatrixs ($1.93 in chips)
Seat 5: santogr893 ($5.81 in chips)
Seat 6: rrluis1930 ($2 in chips)
my sapphire: posts small blind $0.01
LLregs: posts big blind $0.02
*** HOLE CARDS ***
Dealt to LLregs [Ks 6d]
Shmatrixs: raises $0.03 to $0.05
santogr893: folds
rrluis1930: folds
peto322: folds
my sapphire: folds
LLregs: calls $0.03
*** FLOP *** [8c Kc Ad]
LLregs: checks
Shmatrixs: checks
*** TURN *** [8c Kc Ad] [Jc]
LLregs: bets $0.02
Shmatrixs: calls $0.02
*** RIVER *** [8c Kc Ad Jc] [4h]
LLregs: checks
Shmatrixs: checks
*** SHOW DOWN ***
LLregs: shows [Ks 6d] (a pair of Kings)
Shmatrixs: shows [6h Ah] (a pair of Aces)
Shmatrixs collected $0.14 from pot
*** SUMMARY ***
Total pot $0.15 | Rake $0.01
Board [8c Kc Ad Jc 4h]
Seat 1: peto322 (button) folded before Flop (didn't bet)
Seat 2: my sapphire (small blind) folded before Flop
Seat 3: LLregs (big blind) showed [Ks 6d] and lost with a pair of Kings
Seat 4: Shmatrixs showed [6h Ah] and won ($0.14) with a pair of Aces
Seat 5: santogr893 folded before Flop (didn't bet)
Seat 6: rrluis1930 folded before Flop (didn't bet)

PokerStars Zoom Hand #247965584077:  Hold'em No Limit ($0.01/$0.02) - 2023/12/30 20:08:22 WET [2023/12/30 15:08:22 ET]
Table 'Halley' 6-max Seat #1 is the button
Seat 1: organik33 ($1.48 in chips)
Seat 2: LLregs ($4.53 in chips)
Seat 3: Aschi1970 ($1.42 in chips)
Seat 4: davidbarrels ($2.66 in chips)
Seat 5: rjana165 ($2.32 in chips)
Seat 6: Dimoni797979 ($2.34 in chips)
LLregs: posts small blind $0.01
Aschi1970: posts big blind $0.02
*** HOLE CARDS ***
Dealt to LLregs [4d 7d]
davidbarrels: folds
rjana165: folds
Dimoni797979: raises $0.02 to $0.04
organik33: folds
LLregs: folds
Aschi1970: folds
Uncalled bet ($0.02) returned to Dimoni797979
Dimoni797979 collected $0.05 from pot
Dimoni797979: doesn't show hand
*** SUMMARY ***
Total pot $0.05 | Rake $0
Seat 1: organik33 (button) folded before Flop (didn't bet)
Seat 2: LLregs (small blind) folded before Flop
Seat 3: Aschi1970 (big blind) folded before Flop
Seat 4: davidbarrels folded before Flop (didn't bet)
Seat 5: rjana165 folded before Flop (didn't bet)
Seat 6: Dimoni797979 collected ($0.05)

PokerStars Zoom Hand #247965589312:  Hold'em No Limit ($0.01/$0.02) - 2023/12/30 20:08:36 WET [2023/12/30 15:08:36 ET]
Table 'Halley' 6-max Seat #1 is the button
Seat 1: Dimoni797979 ($2.37 in chips)
Seat 2: RickyPoker ($2.38 in chips)
Seat 3: Alel861 ($1.74 in chips)
Seat 4: graves80 ($2.35 in chips)
Seat 5: LLregs ($4.52 in chips)
Seat 6: RafaCartaxo ($3.97 in chips)
RickyPoker: posts small blind $0.01
Alel861: posts big blind $0.02
*** HOLE CARDS ***
Dealt to LLregs [Qd 4h]
graves80: folds
LLregs: folds
RafaCartaxo: folds
Dimoni797979: folds
RickyPoker: folds
Uncalled bet ($0.01) returned to Alel861
Alel861 collected $0.02 from pot
Alel861: doesn't show hand
*** SUMMARY ***
Total pot $0.02 | Rake $0
Seat 1: Dimoni797979 (button) folded before Flop (didn't bet)
Seat 2: RickyPoker (small blind) folded before Flop
Seat 3: Alel861 (big blind) collected ($0.02)
Seat 4: graves80 folded before Flop (didn't bet)
Seat 5: LLregs folded before Flop (didn't bet)
Seat 6: RafaCartaxo folded before Flop (didn't bet)

PokerStars Zoom Hand #247965580699:  Hold'em No Limit ($0.01/$0.02) - 2023/12/30 20:08:14 WET [2023/12/30 15:08:14 ET]
Table 'Halley' 6-max Seat #1 is the button
Seat 1: matthTankian ($0.24 in chips)
Seat 2: hugopacifico ($2.08 in chips)
Seat 3: C@s@ndr@ ($0.85 in chips)
Seat 4: LLregs ($4.53 in chips)
Seat 5: DeepRybka10 ($2.76 in chips)
Seat 6: MR.BUMFLUFF ($4.56 in chips)
hugopacifico: posts small blind $0.01
C@s@ndr@: posts big blind $0.02
*** HOLE CARDS ***
Dealt to LLregs [Qd 3h]
LLregs: folds
DeepRybka10: folds
MR.BUMFLUFF: folds
matthTankian has timed out while disconnected
matthTankian: folds
hugopacifico: folds
Uncalled bet ($0.01) returned to C@s@ndr@
C@s@ndr@ collected $0.02 from pot
C@s@ndr@: doesn't show hand
*** SUMMARY ***
Total pot $0.02 | Rake $0
Seat 1: matthTankian (button) folded before Flop (didn't bet)
Seat 2: hugopacifico (small blind) folded before Flop
Seat 3: C@s@ndr@ (big blind) collected ($0.02)
Seat 4: LLregs folded before Flop (didn't bet)
Seat 5: DeepRybka10 folded before Flop (didn't bet)
Seat 6: MR.BUMFLUFF folded before Flop (didn't bet)

PokerStars Zoom Hand #247965587716:  Hold'em No Limit ($0.01/$0.02) - 2023/12/30 20:08:32 WET [2023/12/30 15:08:32 ET]
Table 'Halley' 6-max Seat #1 is the button
Seat 1: kuelas ($1.82 in chips)
Seat 2: cachusky ($4.06 in chips)
Seat 3: Juonez ($3.47 in chips)
Seat 4: Shmatrixs ($1.90 in chips)
Seat 5: cryptoncks ($2.77 in chips)
Seat 6: LLregs ($4.52 in chips)
cachusky: posts small blind $0.01
Juonez: posts big blind $0.02
*** HOLE CARDS ***
Dealt to LLregs [2d Js]
Shmatrixs: folds
cryptoncks: folds
LLregs: folds
kuelas: raises $0.02 to $0.04
cachusky: folds
Juonez: folds
Uncalled bet ($0.02) returned to kuelas
kuelas collected $0.05 from pot
kuelas: doesn't show hand
*** SUMMARY ***
Total pot $0.05 | Rake $0
Seat 1: kuelas (button) collected ($0.05)
Seat 2: cachusky (small blind) folded before Flop
Seat 3: Juonez (big blind) folded before Flop
Seat 4: Shmatrixs folded before Flop (didn't bet)
Seat 5: cryptoncks folded before Flop (didn't bet)
Seat 6: LLregs folded before Flop (didn't bet)

PokerStars Zoom Hand #247965590837:  Hold'em No Limit ($0.01/$0.02) - 2023/12/30 20:08:40 WET [2023/12/30 15:08:40 ET]
Table 'Halley' 6-max Seat #1 is the button
Seat 1: RichardTnz ($2.05 in chips)
Seat 2: WarriorM7 ($2.05 in chips)
Seat 3: LLregs ($4.52 in chips)
Seat 4: Handede ($2.56 in chips)
Seat 5: Bardiyayaya ($2.03 in chips)
Seat 6: Dranton73 ($2.20 in chips)
WarriorM7: posts small blind $0.01
LLregs: posts big blind $0.02
*** HOLE CARDS ***
Dealt to LLregs [Tc 5s]
Handede: raises $0.06 to $0.08
Bardiyayaya: folds
Dranton73: folds
RichardTnz: folds
WarriorM7: folds
LLregs: folds
Uncalled bet ($0.06) returned to Handede
Handede collected $0.05 from pot
Handede: doesn't show hand
*** SUMMARY ***
Total pot $0.05 | Rake $0
Seat 1: RichardTnz (button) folded before Flop (didn't bet)
Seat 2: WarriorM7 (small blind) folded before Flop
Seat 3: LLregs (big blind) folded before Flop
Seat 4: Handede collected ($0.05)
Seat 5: Bardiyayaya folded before Flop (didn't bet)
Seat 6: Dranton73 folded before Flop (didn't bet)

PokerStars Zoom Hand #247965593992:  Hold'em No Limit ($0.01/$0.02) - 2023/12/30 20:08:47 WET [2023/12/30 15:08:47 ET]
Table 'Halley' 6-max Seat #1 is the button
Seat 1: LLregs ($4.50 in chips)
Seat 2: Viinha ($0.98 in chips)
Seat 3: Dimoni797979 ($1.58 in chips)
Seat 4: Anthony2027 ($1.92 in chips)
Seat 5: as123st ($2.40 in chips)
Seat 6: Sperick ($2.53 in chips)
Viinha: posts small blind $0.01
Dimoni797979: posts big blind $0.02
*** HOLE CARDS ***
Dealt to LLregs [6c 5c]
Anthony2027: folds
as123st: folds
Sperick: folds
LLregs: raises $0.04 to $0.06
Viinha: folds
Dimoni797979: calls $0.04
*** FLOP *** [Td 3d 4s]
Dimoni797979: checks
LLregs: bets $0.04
Dimoni797979: calls $0.04
*** TURN *** [Td 3d 4s] [4d]
Dimoni797979: checks
LLregs: bets $0.07
Dimoni797979: calls $0.07
*** RIVER *** [Td 3d 4s 4d] [2h]
Dimoni797979: checks
LLregs: bets $0.26
Dimoni797979: calls $0.26
*** SHOW DOWN ***
LLregs: shows [6c 5c] (a straight, Deuce to Six)
Dimoni797979: mucks hand
LLregs collected $0.84 from pot
*** SUMMARY ***
Total pot $0.87 | Rake $0.03
Board [Td 3d 4s 4d 2h]
Seat 1: LLregs (button) showed [6c 5c] and won ($0.84) with a straight, Deuce to Six
Seat 2: Viinha (small blind) folded before Flop
Seat 3: Dimoni797979 (big blind) mucked [Th 9c]
Seat 4: Anthony2027 folded before Flop (didn't bet)
Seat 5: as123st folded before Flop (didn't bet)
Seat 6: Sperick folded before Flop (didn't bet)

PokerStars Zoom Hand #247965617029:  Hold'em No Limit ($0.01/$0.02) - 2023/12/30 20:09:46 WET [2023/12/30 15:09:46 ET]
Table 'Halley' 6-max Seat #1 is the button
Seat 1: marcio14 ($2.06 in chips)
Seat 2: alexad05 ($3.92 in chips)
Seat 3: alindat ($1.03 in chips)
Seat 4: kingdieter1 ($2.06 in chips)
Seat 5: Caluguis ($3.05 in chips)
Seat 6: LLregs ($4.91 in chips)
alexad05: posts small blind $0.01
alindat: posts big blind $0.02
*** HOLE CARDS ***
Dealt to LLregs [3h Qh]
kingdieter1: folds
Caluguis: folds
LLregs: folds
marcio14: folds
alexad05: folds
Uncalled bet ($0.01) returned to alindat
alindat collected $0.02 from pot
alindat: doesn't show hand
*** SUMMARY ***
Total pot $0.02 | Rake $0
Seat 1: marcio14 (button) folded before Flop (didn't bet)
Seat 2: alexad05 (small blind) folded before Flop
Seat 3: alindat (big blind) collected ($0.02)
Seat 4: kingdieter1 folded before Flop (didn't bet)
Seat 5: Caluguis folded before Flop (didn't bet)
Seat 6: LLregs folded before Flop (didn't bet)

PokerStars Zoom Hand #247965615040:  Hold'em No Limit ($0.01/$0.02) - 2023/12/30 20:09:41 WET [2023/12/30 15:09:41 ET]
Table 'Halley' 6-max Seat #1 is the button
Seat 1: batya1212 ($2.14 in chips)
Seat 2: as123st ($1.90 in chips)
Seat 3: tooloco ($0.89 in chips)
Seat 4: LLregs ($4.91 in chips)
Seat 5: xTheBulletsx ($2 in chips)
Seat 6: AntiGosuTux ($3.52 in chips)
as123st: posts small blind $0.01
tooloco: posts big blind $0.02
*** HOLE CARDS ***
Dealt to LLregs [Jc 9d]
LLregs: folds
xTheBulletsx: folds
AntiGosuTux: folds
batya1212: folds
as123st: raises $0.03 to $0.05
tooloco: folds
Uncalled bet ($0.03) returned to as123st
as123st collected $0.04 from pot
as123st: doesn't show hand
*** SUMMARY ***
Total pot $0.04 | Rake $0
Seat 1: batya1212 (button) folded before Flop (didn't bet)
Seat 2: as123st (small blind) collected ($0.04)
Seat 3: tooloco (big blind) folded before Flop
Seat 4: LLregs folded before Flop (didn't bet)
Seat 5: xTheBulletsx folded before Flop (didn't bet)
Seat 6: AntiGosuTux folded before Flop (didn't bet)

PokerStars Zoom Hand #247965618638:  Hold'em No Limit ($0.01/$0.02) - 2023/12/30 20:09:50 WET [2023/12/30 15:09:50 ET]
Table 'Halley' 6-max Seat #1 is the button
Seat 1: rrluis1930 ($2.41 in chips)
Seat 2: LLregs ($4.91 in chips)
Seat 3: psdgr3 ($2 in chips)
Seat 4: Tornado$ky ($2.41 in chips)
Seat 5: iliyan66 ($5.18 in chips)
Seat 6: somidwey ($2.01 in chips)
LLregs: posts small blind $0.01
psdgr3: posts big blind $0.02
*** HOLE CARDS ***
Dealt to LLregs [6d As]
Tornado$ky: folds
iliyan66: folds
somidwey: raises $0.02 to $0.04
rrluis1930: folds
LLregs: calls $0.03
psdgr3: folds
*** FLOP *** [4h Qh 8c]
LLregs: checks
somidwey: bets $0.04
LLregs: folds
Uncalled bet ($0.04) returned to somidwey
somidwey collected $0.10 from pot
somidwey: doesn't show hand
*** SUMMARY ***
Total pot $0.10 | Rake $0
Board [4h Qh 8c]
Seat 1: rrluis1930 (button) folded before Flop (didn't bet)
Seat 2: LLregs (small blind) folded on the Flop
Seat 3: psdgr3 (big blind) folded before Flop
Seat 4: Tornado$ky folded before Flop (didn't bet)
Seat 5: iliyan66 folded before Flop (didn't bet)
Seat 6: somidwey collected ($0.10)

PokerStars Zoom Hand #247965628971:  Hold'em No Limit ($0.01/$0.02) - 2023/12/30 20:10:16 WET [2023/12/30 15:10:16 ET]
Table 'Halley' 6-max Seat #1 is the button
Seat 1: esox_l ($2 in chips)
Seat 2: WalkingDude19 ($2.51 in chips)
Seat 3: Tornado$ky ($2.36 in chips)
Seat 4: iliyan66 ($8.52 in chips)
Seat 5: LLregs ($4.87 in chips)
Seat 6: Shmatrixs ($2.14 in chips)
WalkingDude19: posts small blind $0.01
Tornado$ky: posts big blind $0.02
*** HOLE CARDS ***
Dealt to LLregs [2s Ac]
iliyan66: folds
LLregs: folds
Shmatrixs: folds
esox_l: raises $0.03 to $0.05
WalkingDude19: folds
Tornado$ky: calls $0.03
*** FLOP *** [7s Ts Js]
Tornado$ky: checks
esox_l: bets $0.15
Tornado$ky: folds
Uncalled bet ($0.15) returned to esox_l
esox_l collected $0.11 from pot
esox_l: doesn't show hand
*** SUMMARY ***
Total pot $0.11 | Rake $0
Board [7s Ts Js]
Seat 1: esox_l (button) collected ($0.11)
Seat 2: WalkingDude19 (small blind) folded before Flop
Seat 3: Tornado$ky (big blind) folded on the Flop
Seat 4: iliyan66 folded before Flop (didn't bet)
Seat 5: LLregs folded before Flop (didn't bet)
Seat 6: Shmatrixs folded before Flop (didn't bet)

PokerStars Zoom Hand #247965630070:  Hold'em No Limit ($0.01/$0.02) - 2023/12/30 20:10:18 WET [2023/12/30 15:10:18 ET]
Table 'Halley' 6-max Seat #1 is the button
Seat 1: Nerful ($2.03 in chips)
Seat 2: Devilfishtheone ($4.60 in chips)
Seat 3: LLregs ($4.87 in chips)
Seat 4: ionic77 ($1.54 in chips)
Seat 5: Bardiyayaya ($2 in chips)
Seat 6: alexad05 ($3.89 in chips)
Devilfishtheone: posts small blind $0.01
LLregs: posts big blind $0.02
*** HOLE CARDS ***
Dealt to LLregs [8s 3c]
ionic77: folds
Bardiyayaya: folds
alexad05: folds
Nerful: folds
Devilfishtheone: calls $0.01
LLregs: raises $0.04 to $0.06
Devilfishtheone: calls $0.04
*** FLOP *** [Ac Ts 4h]
Devilfishtheone: checks
LLregs: bets $0.09
Devilfishtheone: folds
Uncalled bet ($0.09) returned to LLregs
LLregs collected $0.12 from pot
LLregs: doesn't show hand
*** SUMMARY ***
Total pot $0.12 | Rake $0
Board [Ac Ts 4h]
Seat 1: Nerful (button) folded before Flop (didn't bet)
Seat 2: Devilfishtheone (small blind) folded on the Flop
Seat 3: LLregs (big blind) collected ($0.12)
Seat 4: ionic77 folded before Flop (didn't bet)
Seat 5: Bardiyayaya folded before Flop (didn't bet)
Seat 6: alexad05 folded before Flop (didn't bet)

PokerStars Zoom Hand #247965645448:  Hold'em No Limit ($0.01/$0.02) - 2023/12/30 20:10:57 WET [2023/12/30 15:10:57 ET]
Table 'Halley' 6-max Seat #1 is the button
Seat 1: LLregs ($4.93 in chips)
Seat 2: WarriorM7 ($2 in chips)
Seat 3: djmcool ($4.13 in chips)
Seat 4: sugarboy69 ($1.27 in chips)
Seat 5: nuttymuch ($2.72 in chips)
Seat 6: Fasteddie35 ($2.90 in chips)
WarriorM7: posts small blind $0.01
djmcool: posts big blind $0.02
*** HOLE CARDS ***
Dealt to LLregs [7h Ah]
sugarboy69: folds
nuttymuch: folds
Fasteddie35: folds
LLregs: raises $0.04 to $0.06
WarriorM7: raises $0.18 to $0.24
djmcool: folds
LLregs: folds
Uncalled bet ($0.18) returned to WarriorM7
WarriorM7 collected $0.14 from pot
WarriorM7: doesn't show hand
*** SUMMARY ***
Total pot $0.14 | Rake $0
Seat 1: LLregs (button) folded before Flop
Seat 2: WarriorM7 (small blind) collected ($0.14)
Seat 3: djmcool (big blind) folded before Flop
Seat 4: sugarboy69 folded before Flop (didn't bet)
Seat 5: nuttymuch folded before Flop (didn't bet)
Seat 6: Fasteddie35 folded before Flop (didn't bet)

PokerStars Zoom Hand #247965660680:  Hold'em No Limit ($0.01/$0.02) - 2023/12/30 20:11:36 WET [2023/12/30 15:11:36 ET]
Table 'Halley' 6-max Seat #1 is the button
Seat 1: Kamylo20 ($3.18 in chips)
Seat 2: Dimoni797979 ($2.53 in chips)
Seat 3: MR.BUMFLUFF ($3.88 in chips)
Seat 4: richireef ($2.07 in chips)
Seat 5: pochitama ($2 in chips)
Seat 6: LLregs ($4.87 in chips)
Dimoni797979: posts small blind $0.01
MR.BUMFLUFF: posts big blind $0.02
*** HOLE CARDS ***
Dealt to LLregs [Td 8h]
richireef: folds
pochitama: folds
LLregs: folds
Kamylo20: folds
Dimoni797979: folds
Uncalled bet ($0.01) returned to MR.BUMFLUFF
MR.BUMFLUFF collected $0.02 from pot
MR.BUMFLUFF: doesn't show hand
*** SUMMARY ***
Total pot $0.02 | Rake $0
Seat 1: Kamylo20 (button) folded before Flop (didn't bet)
Seat 2: Dimoni797979 (small blind) folded before Flop
Seat 3: MR.BUMFLUFF (big blind) collected ($0.02)
Seat 4: richireef folded before Flop (didn't bet)
Seat 5: pochitama folded before Flop (didn't bet)
Seat 6: LLregs folded before Flop (didn't bet)

PokerStars Zoom Hand #247965662317:  Hold'em No Limit ($0.01/$0.02) - 2023/12/30 20:11:41 WET [2023/12/30 15:11:41 ET]
Table 'Halley' 6-max Seat #1 is the button
Seat 1: WA.Anacleto ($1.44 in chips)
Seat 2: LLregs ($4.87 in chips)
Seat 3: WolveroX ($1.23 in chips)
Seat 4: conspy84 ($6.26 in chips)
Seat 5: Shmatrixs ($1.85 in chips)
Seat 6: SchmittNieto ($2.01 in chips)
LLregs: posts small blind $0.01
WolveroX: posts big blind $0.02
*** HOLE CARDS ***
Dealt to LLregs [5s 9h]
conspy84: folds
Shmatrixs: folds
SchmittNieto: folds
WA.Anacleto: folds
LLregs: folds
Uncalled bet ($0.01) returned to WolveroX
WolveroX collected $0.02 from pot
WolveroX: doesn't show hand
*** SUMMARY ***
Total pot $0.02 | Rake $0
Seat 1: WA.Anacleto (button) folded before Flop (didn't bet)
Seat 2: LLregs (small blind) folded before Flop
Seat 3: WolveroX (big blind) collected ($0.02)
Seat 4: conspy84 folded before Flop (didn't bet)
Seat 5: Shmatrixs folded before Flop (didn't bet)
Seat 6: SchmittNieto folded before Flop (didn't bet)

PokerStars Zoom Hand #247965663830:  Hold'em No Limit ($0.01/$0.02) - 2023/12/30 20:11:45 WET [2023/12/30 15:11:45 ET]
Table 'Halley' 6-max Seat #1 is the button
Seat 1: Choponthis ($2.03 in chips)
Seat 2: det1a ($1.95 in chips)
Seat 3: KubaForNever ($2.61 in chips)
Seat 4: LLregs ($4.86 in chips)
Seat 5: Harold_Seven ($5.93 in chips)
Seat 6: mangalisa ($2.04 in chips)
det1a: posts small blind $0.01
KubaForNever: posts big blind $0.02
*** HOLE CARDS ***
Dealt to LLregs [8s 3h]
LLregs: folds
Harold_Seven: folds
mangalisa: raises $0.04 to $0.06
Choponthis: folds
det1a: folds
KubaForNever: calls $0.04
*** FLOP *** [Kd 9s 4c]
KubaForNever: checks
mangalisa: bets $0.07
KubaForNever: folds
Uncalled bet ($0.07) returned to mangalisa
mangalisa collected $0.13 from pot
mangalisa: doesn't show hand
*** SUMMARY ***
Total pot $0.13 | Rake $0
Board [Kd 9s 4c]
Seat 1: Choponthis (button) folded before Flop (didn't bet)
Seat 2: det1a (small blind) folded before Flop
Seat 3: KubaForNever (big blind) folded on the Flop
Seat 4: LLregs folded before Flop (didn't bet)
Seat 5: Harold_Seven folded before Flop (didn't bet)
Seat 6: mangalisa collected ($0.13)

PokerStars Zoom Hand #247965665418:  Hold'em No Limit ($0.01/$0.02) - 2023/12/30 20:11:49 WET [2023/12/30 15:11:49 ET]
Table 'Halley' 6-max Seat #1 is the button
Seat 1: Nerful ($2 in chips)
Seat 2: WarriorM7 ($2.08 in chips)
Seat 3: LLregs ($4.86 in chips)
Seat 4: Tornado$ky ($2 in chips)
Seat 5: Doksi_pro ($2.45 in chips)
Seat 6: gio119 ($2.19 in chips)
WarriorM7: posts small blind $0.01
LLregs: posts big blind $0.02
*** HOLE CARDS ***
Dealt to LLregs [Kd Qd]
Tornado$ky: raises $0.03 to $0.05
Doksi_pro: calls $0.05
gio119: folds
Nerful: folds
WarriorM7: folds
LLregs: calls $0.03
*** FLOP *** [Qc 2s 9h]
LLregs: checks
Tornado$ky: checks
Doksi_pro: bets $0.08
LLregs: calls $0.08
Tornado$ky: calls $0.08
*** TURN *** [Qc 2s 9h] [7h]
LLregs: checks
Tornado$ky: checks
Doksi_pro: checks
*** RIVER *** [Qc 2s 9h 7h] [Jh]
LLregs: bets $0.19
Tornado$ky: calls $0.19
Doksi_pro: folds
*** SHOW DOWN ***
LLregs: shows [Kd Qd] (a pair of Queens)
Tornado$ky: shows [9c Jc] (two pair, Jacks and Nines)
Tornado$ky collected $0.75 from pot
*** SUMMARY ***
Total pot $0.78 | Rake $0.03
Board [Qc 2s 9h 7h Jh]
Seat 1: Nerful (button) folded before Flop (didn't bet)
Seat 2: WarriorM7 (small blind) folded before Flop
Seat 3: LLregs (big blind) showed [Kd Qd] and lost with a pair of Queens
Seat 4: Tornado$ky showed [9c Jc] and won ($0.75) with two pair, Jacks and Nines
Seat 5: Doksi_pro folded on the River
Seat 6: gio119 folded before Flop (didn't bet)

PokerStars Zoom Hand #247965680272:  Hold'em No Limit ($0.01/$0.02) - 2023/12/30 20:12:26 WET [2023/12/30 15:12:26 ET]
Table 'Halley' 6-max Seat #1 is the button
Seat 1: LLregs ($4.54 in chips)
Seat 2: zhuk201355 ($1.17 in chips)
Seat 3: FERNANDO R01997 ($2 in chips)
Seat 4: ARES_312 ($2.27 in chips)
Seat 5: DanRussel ($1.91 in chips)
Seat 6: Juonez ($3.87 in chips)
zhuk201355: posts small blind $0.01
FERNANDO R01997: posts big blind $0.02
*** HOLE CARDS ***
Dealt to LLregs [Jc 5h]
ARES_312: folds
DanRussel: folds
Juonez: folds
LLregs: raises $0.04 to $0.06
zhuk201355: calls $0.05
FERNANDO R01997: folds
*** FLOP *** [4d Ad Qd]
zhuk201355: bets $0.02
LLregs: folds
Uncalled bet ($0.02) returned to zhuk201355
zhuk201355 collected $0.14 from pot
zhuk201355: doesn't show hand
*** SUMMARY ***
Total pot $0.14 | Rake $0
Board [4d Ad Qd]
Seat 1: LLregs (button) folded on the Flop
Seat 2: zhuk201355 (small blind) collected ($0.14)
Seat 3: FERNANDO R01997 (big blind) folded before Flop
Seat 4: ARES_312 folded before Flop (didn't bet)
Seat 5: DanRussel folded before Flop (didn't bet)
Seat 6: Juonez folded before Flop (didn't bet)

PokerStars Zoom Hand #247965688898:  Hold'em No Limit ($0.01/$0.02) - 2023/12/30 20:12:49 WET [2023/12/30 15:12:49 ET]
Table 'Halley' 6-max Seat #1 is the button
Seat 1: craz400 ($1.52 in chips)
Seat 2: Ukr Troll ($6.82 in chips)
Seat 3: RickyPoker ($3.35 in chips)
Seat 4: texashenry2 ($1.79 in chips)
Seat 5: as123st ($1.52 in chips)
Seat 6: LLregs ($4.48 in chips)
Ukr Troll: posts small blind $0.01
RickyPoker: posts big blind $0.02
*** HOLE CARDS ***
Dealt to LLregs [Qd 3s]
texashenry2: folds
as123st: folds
LLregs: folds
craz400: folds
Ukr Troll: folds
Uncalled bet ($0.01) returned to RickyPoker
RickyPoker collected $0.02 from pot
RickyPoker: doesn't show hand
*** SUMMARY ***
Total pot $0.02 | Rake $0
Seat 1: craz400 (button) folded before Flop (didn't bet)
Seat 2: Ukr Troll (small blind) folded before Flop
Seat 3: RickyPoker (big blind) collected ($0.02)
Seat 4: texashenry2 folded before Flop (didn't bet)
Seat 5: as123st folded before Flop (didn't bet)
Seat 6: LLregs folded before Flop (didn't bet)

PokerStars Zoom Hand #247965691852:  Hold'em No Limit ($0.01/$0.02) - 2023/12/30 20:12:56 WET [2023/12/30 15:12:56 ET]
Table 'Halley' 6-max Seat #1 is the button
Seat 1: dkaygenius ($1.15 in chips)
Seat 2: ionic77 ($1.44 in chips)
Seat 3: JaUm_V ($11.91 in chips)
Seat 4: r3v3rs3f3r3t ($2.06 in chips)
Seat 5: LLregs ($4.48 in chips)
Seat 6: Juonez ($3.84 in chips)
ionic77: posts small blind $0.01
JaUm_V: posts big blind $0.02
*** HOLE CARDS ***
Dealt to LLregs [9c Th]
r3v3rs3f3r3t: folds
LLregs: folds
Juonez: folds
dkaygenius: folds
ionic77: folds
Uncalled bet ($0.01) returned to JaUm_V
JaUm_V collected $0.02 from pot
JaUm_V: doesn't show hand
*** SUMMARY ***
Total pot $0.02 | Rake $0
Seat 1: dkaygenius (button) folded before Flop (didn't bet)
Seat 2: ionic77 (small blind) folded before Flop
Seat 3: JaUm_V (big blind) collected ($0.02)
Seat 4: r3v3rs3f3r3t folded before Flop (didn't bet)
Seat 5: LLregs folded before Flop (didn't bet)
Seat 6: Juonez folded before Flop (didn't bet)

PokerStars Zoom Hand #247965693523:  Hold'em No Limit ($0.01/$0.02) - 2023/12/30 20:13:01 WET [2023/12/30 15:13:01 ET]
Table 'Halley' 6-max Seat #1 is the button
Seat 1: WalkingDude19 ($2.96 in chips)
Seat 2: voha88 ($2.09 in chips)
Seat 3: Vitaliy v775 ($2.33 in chips)
Seat 4: LLregs ($4.48 in chips)
Seat 5: Svetlana-ck ($1.42 in chips)
Seat 6: theRedDrag0n ($2.44 in chips)
voha88: posts small blind $0.01
Vitaliy v775: posts big blind $0.02
*** HOLE CARDS ***
Dealt to LLregs [8d Tc]
LLregs: folds
Svetlana-ck: calls $0.02
theRedDrag0n: folds
WalkingDude19: folds
voha88: folds
Vitaliy v775: checks
*** FLOP *** [7h Js 8h]
Vitaliy v775: bets $0.02
Svetlana-ck: calls $0.02
*** TURN *** [7h Js 8h] [3c]
Vitaliy v775: bets $0.02
Svetlana-ck: calls $0.02
*** RIVER *** [7h Js 8h 3c] [3s]
Vitaliy v775: checks
Svetlana-ck: checks
*** SHOW DOWN ***
Vitaliy v775: shows [4d 9c] (a pair of Threes)
Svetlana-ck: shows [Ks Ad] (a pair of Threes - Ace kicker)
Svetlana-ck collected $0.13 from pot
*** SUMMARY ***
Total pot $0.13 | Rake $0
Board [7h Js 8h 3c 3s]
Seat 1: WalkingDude19 (button) folded before Flop (didn't bet)
Seat 2: voha88 (small blind) folded before Flop
Seat 3: Vitaliy v775 (big blind) showed [4d 9c] and lost with a pair of Threes
Seat 4: LLregs folded before Flop (didn't bet)
Seat 5: Svetlana-ck showed [Ks Ad] and won ($0.13) with a pair of Threes
Seat 6: theRedDrag0n folded before Flop (didn't bet)

PokerStars Zoom Hand #247965687956:  Hold'em No Limit ($0.01/$0.02) - 2023/12/30 20:12:47 WET [2023/12/30 15:12:47 ET]
Table 'Halley' 6-max Seat #1 is the button
Seat 1: Shizukas104 ($3.50 in chips)
Seat 2: voha88 ($2 in chips)
Seat 3: IGERRIT ($1 in chips)
Seat 4: tito1806 ($1.71 in chips)
Seat 5: LLregs ($4.48 in chips)
Seat 6: ERMAK.DEN777 ($1.96 in chips)
voha88: posts small blind $0.01
IGERRIT: posts big blind $0.02
*** HOLE CARDS ***
Dealt to LLregs [4c Th]
tito1806: raises $0.02 to $0.04
LLregs: folds
ERMAK.DEN777: folds
Shizukas104: folds
voha88: folds
IGERRIT: calls $0.02
*** FLOP *** [9h 4d 5d]
IGERRIT: checks
tito1806: checks
*** TURN *** [9h 4d 5d] [6d]
IGERRIT: bets $0.05
tito1806: calls $0.05
*** RIVER *** [9h 4d 5d 6d] [Js]
IGERRIT: bets $0.12
tito1806: raises $1.50 to $1.62 and is all-in
IGERRIT: folds
Uncalled bet ($1.50) returned to tito1806
tito1806 collected $0.41 from pot
tito1806: doesn't show hand
*** SUMMARY ***
Total pot $0.43 | Rake $0.02
Board [9h 4d 5d 6d Js]
Seat 1: Shizukas104 (button) folded before Flop (didn't bet)
Seat 2: voha88 (small blind) folded before Flop
Seat 3: IGERRIT (big blind) folded on the River
Seat 4: tito1806 collected ($0.41)
Seat 5: LLregs folded before Flop (didn't bet)
Seat 6: ERMAK.DEN777 folded before Flop (didn't bet)

PokerStars Zoom Hand #247965695131:  Hold'em No Limit ($0.01/$0.02) - 2023/12/30 20:13:05 WET [2023/12/30 15:13:05 ET]
Table 'Halley' 6-max Seat #1 is the button
Seat 1: jeanclaude5949 ($3.38 in chips)
Seat 2: LLregs ($4.48 in chips)
Seat 3: IanMacDaddy ($2.73 in chips)
Seat 4: Dr.Erguen ($1.90 in chips)
Seat 5: VOYAGERC ($2 in chips)
Seat 6: Nerful ($2 in chips)
LLregs: posts small blind $0.01
IanMacDaddy: posts big blind $0.02
*** HOLE CARDS ***
Dealt to LLregs [Td Qh]
jeanclaude5949 is disconnected
Dr.Erguen: folds
VOYAGERC: folds
Nerful: raises $0.03 to $0.05
jeanclaude5949 has timed out while disconnected
jeanclaude5949: folds
LLregs: calls $0.04
IanMacDaddy: folds
*** FLOP *** [Th Qc Tc]
LLregs: checks
Nerful: bets $0.04
LLregs: calls $0.04
*** TURN *** [Th Qc Tc] [9s]
LLregs: checks
Nerful: checks
*** RIVER *** [Th Qc Tc 9s] [4c]
LLregs: bets $0.04
Nerful: calls $0.04
*** SHOW DOWN ***
LLregs: shows [Td Qh] (a full house, Tens full of Queens)
Nerful: mucks hand
LLregs collected $0.27 from pot
*** SUMMARY ***
Total pot $0.28 | Rake $0.01
Board [Th Qc Tc 9s 4c]
Seat 1: jeanclaude5949 (button) folded before Flop (didn't bet)
Seat 2: LLregs (small blind) showed [Td Qh] and won ($0.27) with a full house, Tens full of Queens
Seat 3: IanMacDaddy (big blind) folded before Flop
Seat 4: Dr.Erguen folded before Flop (didn't bet)
Seat 5: VOYAGERC folded before Flop (didn't bet)
Seat 6: Nerful mucked [Ad Qs]

PokerStars Zoom Hand #247965718540:  Hold'em No Limit ($0.01/$0.02) - 2023/12/30 20:14:05 WET [2023/12/30 15:14:05 ET]
Table 'Halley' 6-max Seat #1 is the button
Seat 1: gepard35 ($3.42 in chips)
Seat 2: WEBOO1 ($2 in chips)
Seat 3: LLregs ($4.62 in chips)
Seat 4: Kingoooo ($1.68 in chips)
Seat 5: djmcool ($2.36 in chips)
Seat 6: Gomez224 ($2.15 in chips)
WEBOO1: posts small blind $0.01
LLregs: posts big blind $0.02
*** HOLE CARDS ***
Dealt to LLregs [3d 5c]
Kingoooo: folds
djmcool: folds
Gomez224: folds
gepard35: folds
WEBOO1: raises $0.04 to $0.06
LLregs: folds
Uncalled bet ($0.04) returned to WEBOO1
WEBOO1 collected $0.04 from pot
WEBOO1: doesn't show hand
*** SUMMARY ***
Total pot $0.04 | Rake $0
Seat 1: gepard35 (button) folded before Flop (didn't bet)
Seat 2: WEBOO1 (small blind) collected ($0.04)
Seat 3: LLregs (big blind) folded before Flop
Seat 4: Kingoooo folded before Flop (didn't bet)
Seat 5: djmcool folded before Flop (didn't bet)
Seat 6: Gomez224 folded before Flop (didn't bet)

PokerStars Zoom Hand #247965729498:  Hold'em No Limit ($0.01/$0.02) - 2023/12/30 20:14:33 WET [2023/12/30 15:14:33 ET]
Table 'Halley' 6-max Seat #1 is the button
Seat 1: LLregs ($4.60 in chips)
Seat 2: eduardo feijó ($1.62 in chips)
Seat 3: davidbarrels ($2.09 in chips)
Seat 4: Bardiyayaya ($2.32 in chips)
Seat 5: Choponthis ($2.03 in chips)
Seat 6: craz400 ($1.33 in chips)
eduardo feijó: posts small blind $0.01
davidbarrels: posts big blind $0.02
*** HOLE CARDS ***
Dealt to LLregs [Ah Qc]
Bardiyayaya: folds
Choponthis: folds
craz400: folds
LLregs: raises $0.04 to $0.06
eduardo feijó: folds
davidbarrels: folds
Uncalled bet ($0.04) returned to LLregs
LLregs collected $0.05 from pot
LLregs: doesn't show hand
*** SUMMARY ***
Total pot $0.05 | Rake $0
Seat 1: LLregs (button) collected ($0.05)
Seat 2: eduardo feijó (small blind) folded before Flop
Seat 3: davidbarrels (big blind) folded before Flop
Seat 4: Bardiyayaya folded before Flop (didn't bet)
Seat 5: Choponthis folded before Flop (didn't bet)
Seat 6: craz400 folded before Flop (didn't bet)

PokerStars Zoom Hand #247965737521:  Hold'em No Limit ($0.01/$0.02) - 2023/12/30 20:14:53 WET [2023/12/30 15:14:53 ET]
Table 'Halley' 6-max Seat #1 is the button
Seat 1: Juonez ($3.68 in chips)
Seat 2: Rockoteki ($4.41 in chips)
Seat 3: Cigarrinh0 ($2.86 in chips)
Seat 4: LLregs ($4.63 in chips)
Seat 5: bettanye ($2.03 in chips)
Seat 6: wanderer7660 ($1.66 in chips)
Rockoteki: posts small blind $0.01
Cigarrinh0: posts big blind $0.02
*** HOLE CARDS ***
Dealt to LLregs [Tc Jh]
LLregs: folds
bettanye: folds
wanderer7660: folds
Juonez: folds
Rockoteki: raises $0.04 to $0.06
Cigarrinh0: folds
Uncalled bet ($0.04) returned to Rockoteki
Rockoteki collected $0.04 from pot
Rockoteki: doesn't show hand
*** SUMMARY ***
Total pot $0.04 | Rake $0
Seat 1: Juonez (button) folded before Flop (didn't bet)
Seat 2: Rockoteki (small blind) collected ($0.04)
Seat 3: Cigarrinh0 (big blind) folded before Flop
Seat 4: LLregs folded before Flop (didn't bet)
Seat 5: bettanye folded before Flop (didn't bet)
Seat 6: wanderer7660 folded before Flop (didn't bet)

PokerStars Zoom Hand #247965736006:  Hold'em No Limit ($0.01/$0.02) - 2023/12/30 20:14:49 WET [2023/12/30 15:14:49 ET]
Table 'Halley' 6-max Seat #1 is the button
Seat 1: Ukr Troll ($6.72 in chips)
Seat 2: gio119 ($2.04 in chips)
Seat 3: mangalisa ($3.72 in chips)
Seat 4: Shmatrixs ($1.59 in chips)
Seat 5: ZorroZoltan ($5.45 in chips)
Seat 6: LLregs ($4.63 in chips)
gio119: posts small blind $0.01
mangalisa: posts big blind $0.02
*** HOLE CARDS ***
Dealt to LLregs [5s 9s]
Shmatrixs has timed out
Shmatrixs: folds
ZorroZoltan: raises $0.04 to $0.06
LLregs: folds
Ukr Troll: folds
gio119: folds
mangalisa: calls $0.04
*** FLOP *** [Kh Jc Qh]
mangalisa: checks
ZorroZoltan: checks
*** TURN *** [Kh Jc Qh] [4s]
mangalisa: checks
ZorroZoltan: checks
*** RIVER *** [Kh Jc Qh 4s] [2d]
mangalisa: bets $0.13
ZorroZoltan: folds
Uncalled bet ($0.13) returned to mangalisa
mangalisa collected $0.13 from pot
mangalisa: doesn't show hand
*** SUMMARY ***
Total pot $0.13 | Rake $0
Board [Kh Jc Qh 4s 2d]
Seat 1: Ukr Troll (button) folded before Flop (didn't bet)
Seat 2: gio119 (small blind) folded before Flop
Seat 3: mangalisa (big blind) collected ($0.13)
Seat 4: Shmatrixs folded before Flop (didn't bet)
Seat 5: ZorroZoltan folded on the River
Seat 6: LLregs folded before Flop (didn't bet)

PokerStars Zoom Hand #247965739224:  Hold'em No Limit ($0.01/$0.02) - 2023/12/30 20:14:58 WET [2023/12/30 15:14:58 ET]
Table 'Halley' 6-max Seat #1 is the button
Seat 1: Nerful ($2.02 in chips)
Seat 2: gvc33 ($0.98 in chips)
Seat 3: bakayoko31 ($2.21 in chips)
Seat 4: frankquanki ($5.05 in chips)
Seat 5: LLregs ($4.63 in chips)
Seat 6: Sperick ($2.25 in chips)
gvc33: posts small blind $0.01
bakayoko31: posts big blind $0.02
*** HOLE CARDS ***
Dealt to LLregs [As 8s]
frankquanki: folds
LLregs: raises $0.04 to $0.06
Sperick: raises $0.12 to $0.18
Nerful: folds
gvc33: folds
bakayoko31: folds
LLregs: folds
Uncalled bet ($0.12) returned to Sperick
Sperick collected $0.15 from pot
Sperick: doesn't show hand
*** SUMMARY ***
Total pot $0.15 | Rake $0
Seat 1: Nerful (button) folded before Flop (didn't bet)
Seat 2: gvc33 (small blind) folded before Flop
Seat 3: bakayoko31 (big blind) folded before Flop
Seat 4: frankquanki folded before Flop (didn't bet)
Seat 5: LLregs folded before Flop
Seat 6: Sperick collected ($0.15)

PokerStars Zoom Hand #247965757276:  Hold'em No Limit ($0.01/$0.02) - 2023/12/30 20:15:43 WET [2023/12/30 15:15:43 ET]
Table 'Halley' 6-max Seat #1 is the button
Seat 1: LLregs ($4.57 in chips)
Seat 2: mangalisa ($3.79 in chips)
Seat 3: KKisthere ($1.93 in chips)
Seat 4: dogor73 ($2.41 in chips)
Seat 5: xTheBulletsx ($2 in chips)
Seat 6: mrmother2 ($2.23 in chips)
mangalisa: posts small blind $0.01
KKisthere: posts big blind $0.02
*** HOLE CARDS ***
Dealt to LLregs [8d 7h]
dogor73: folds
xTheBulletsx: folds
mrmother2: folds
LLregs: folds
mangalisa: folds
Uncalled bet ($0.01) returned to KKisthere
KKisthere collected $0.02 from pot
KKisthere: doesn't show hand
*** SUMMARY ***
Total pot $0.02 | Rake $0
Seat 1: LLregs (button) folded before Flop (didn't bet)
Seat 2: mangalisa (small blind) folded before Flop
Seat 3: KKisthere (big blind) collected ($0.02)
Seat 4: dogor73 folded before Flop (didn't bet)
Seat 5: xTheBulletsx folded before Flop (didn't bet)
Seat 6: mrmother2 folded before Flop (didn't bet)

PokerStars Zoom Hand #247965760429:  Hold'em No Limit ($0.01/$0.02) - 2023/12/30 20:15:52 WET [2023/12/30 15:15:52 ET]
Table 'Halley' 6-max Seat #1 is the button
Seat 1: LukeSoldier ($2.42 in chips)
Seat 2: N0tsobig ($3.94 in chips)
Seat 3: LLregs ($4.56 in chips)
Seat 4: JaUm_V ($4.49 in chips)
Seat 5: Fasteddie35 ($2.41 in chips)
Seat 6: frankquanki ($5.02 in chips)
N0tsobig: posts small blind $0.01
LLregs: posts big blind $0.02
*** HOLE CARDS ***
Dealt to LLregs [7c 7h]
JaUm_V: folds
Fasteddie35: raises $0.03 to $0.05
frankquanki: folds
LukeSoldier: folds
N0tsobig: folds
LLregs: raises $0.11 to $0.16
Fasteddie35: calls $0.11
*** FLOP *** [2s Qd 2c]
LLregs: bets $0.15
Fasteddie35: calls $0.15
*** TURN *** [2s Qd 2c] [4d]
LLregs: bets $0.20
Fasteddie35: folds
Uncalled bet ($0.20) returned to LLregs
LLregs collected $0.61 from pot
LLregs: doesn't show hand
*** SUMMARY ***
Total pot $0.63 | Rake $0.02
Board [2s Qd 2c 4d]
Seat 1: LukeSoldier (button) folded before Flop (didn't bet)
Seat 2: N0tsobig (small blind) folded before Flop
Seat 3: LLregs (big blind) collected ($0.61)
Seat 4: JaUm_V folded before Flop (didn't bet)
Seat 5: Fasteddie35 folded on the Turn
Seat 6: frankquanki folded before Flop (didn't bet)

PokerStars Zoom Hand #247965758827:  Hold'em No Limit ($0.01/$0.02) - 2023/12/30 20:15:48 WET [2023/12/30 15:15:48 ET]
Table 'Halley' 6-max Seat #1 is the button
Seat 1: as123st ($3.43 in chips)
Seat 2: LLregs ($4.57 in chips)
Seat 3: SchmittNieto ($2 in chips)
Seat 4: pochitama ($2 in chips)
Seat 5: sugarboy69 ($1.18 in chips)
Seat 6: TheBoss1985 ($1.99 in chips)
LLregs: posts small blind $0.01
SchmittNieto: posts big blind $0.02
*** HOLE CARDS ***
Dealt to LLregs [6c 2s]
pochitama: raises $0.03 to $0.05
sugarboy69: calls $0.05
TheBoss1985: calls $0.05
as123st: folds
LLregs: folds
SchmittNieto: folds
*** FLOP *** [8c Ad Qd]
pochitama: bets $0.06
sugarboy69: calls $0.06
TheBoss1985: folds
*** TURN *** [8c Ad Qd] [4s]
pochitama: checks
sugarboy69: checks
*** RIVER *** [8c Ad Qd 4s] [Kh]
pochitama: bets $0.20
sugarboy69: folds
Uncalled bet ($0.20) returned to pochitama
pochitama collected $0.29 from pot
pochitama: doesn't show hand
*** SUMMARY ***
Total pot $0.30 | Rake $0.01
Board [8c Ad Qd 4s Kh]
Seat 1: as123st (button) folded before Flop (didn't bet)
Seat 2: LLregs (small blind) folded before Flop
Seat 3: SchmittNieto (big blind) folded before Flop
Seat 4: pochitama collected ($0.29)
Seat 5: sugarboy69 folded on the River
Seat 6: TheBoss1985 folded on the Flop

PokerStars Zoom Hand #247965775615:  Hold'em No Limit ($0.01/$0.02) - 2023/12/30 20:16:30 WET [2023/12/30 15:16:30 ET]
Table 'Halley' 6-max Seat #1 is the button
Seat 1: Svetlana-ck ($1.40 in chips)
Seat 2: wanderer7660 ($1.71 in chips)
Seat 3: Pierros177 ($8.06 in chips)
Seat 4: LLregs ($4.86 in chips)
Seat 5: voha88 ($2 in chips)
Seat 6: dobri151 ($4.72 in chips)
wanderer7660: posts small blind $0.01
Pierros177: posts big blind $0.02
*** HOLE CARDS ***
Dealt to LLregs [Tc Kc]
LLregs: raises $0.04 to $0.06
voha88: folds
dobri151: folds
Svetlana-ck: folds
wanderer7660: folds
Pierros177: folds
Uncalled bet ($0.04) returned to LLregs
LLregs collected $0.05 from pot
LLregs: doesn't show hand
*** SUMMARY ***
Total pot $0.05 | Rake $0
Seat 1: Svetlana-ck (button) folded before Flop (didn't bet)
Seat 2: wanderer7660 (small blind) folded before Flop
Seat 3: Pierros177 (big blind) folded before Flop
Seat 4: LLregs collected ($0.05)
Seat 5: voha88 folded before Flop (didn't bet)
Seat 6: dobri151 folded before Flop (didn't bet)

PokerStars Zoom Hand #247965780568:  Hold'em No Limit ($0.01/$0.02) - 2023/12/30 20:16:43 WET [2023/12/30 15:16:43 ET]
Table 'Halley' 6-max Seat #1 is the button
Seat 1: TigerYear ($3.22 in chips)
Seat 2: gio119 ($2 in chips)
Seat 3: BIG tyger500 ($0.89 in chips)
Seat 4: as123st ($2.03 in chips)
Seat 5: Waltermanni ($1.01 in chips)
Seat 6: LLregs ($4.89 in chips)
gio119: posts small blind $0.01
BIG tyger500: posts big blind $0.02
*** HOLE CARDS ***
Dealt to LLregs [Kc Jd]
as123st: folds
Waltermanni: folds
LLregs: raises $0.04 to $0.06
TigerYear: raises $0.15 to $0.21
gio119: folds
BIG tyger500: folds
LLregs: folds
Uncalled bet ($0.15) returned to TigerYear
TigerYear collected $0.15 from pot
TigerYear: doesn't show hand
*** SUMMARY ***
Total pot $0.15 | Rake $0
Seat 1: TigerYear (button) collected ($0.15)
Seat 2: gio119 (small blind) folded before Flop
Seat 3: BIG tyger500 (big blind) folded before Flop
Seat 4: as123st folded before Flop (didn't bet)
Seat 5: Waltermanni folded before Flop (didn't bet)
Seat 6: LLregs folded before Flop

PokerStars Zoom Hand #247965789613:  Hold'em No Limit ($0.01/$0.02) - 2023/12/30 20:17:06 WET [2023/12/30 15:17:06 ET]
Table 'Halley' 6-max Seat #1 is the button
Seat 1: PR3SUR3 ($4.25 in chips)
Seat 2: LLregs ($4.83 in chips)
Seat 3: matthTankian ($1.95 in chips)
Seat 4: cachusky ($3.96 in chips)
Seat 5: iliyan66 ($3.55 in chips)
Seat 6: LukeSoldier ($2.39 in chips)
LLregs: posts small blind $0.01
matthTankian: posts big blind $0.02
*** HOLE CARDS ***
Dealt to LLregs [Ah Qc]
cachusky: raises $0.02 to $0.04
iliyan66: folds
LukeSoldier: folds
PR3SUR3: folds
LLregs: raises $0.08 to $0.12
matthTankian: folds
cachusky: folds
Uncalled bet ($0.08) returned to LLregs
LLregs collected $0.10 from pot
LLregs: doesn't show hand
*** SUMMARY ***
Total pot $0.10 | Rake $0
Seat 1: PR3SUR3 (button) folded before Flop (didn't bet)
Seat 2: LLregs (small blind) collected ($0.10)
Seat 3: matthTankian (big blind) folded before Flop
Seat 4: cachusky folded before Flop
Seat 5: iliyan66 folded before Flop (didn't bet)
Seat 6: LukeSoldier folded before Flop (didn't bet)

PokerStars Zoom Hand #247965800779:  Hold'em No Limit ($0.01/$0.02) - 2023/12/30 20:17:34 WET [2023/12/30 15:17:34 ET]
Table 'Halley' 6-max Seat #1 is the button
Seat 1: LLregs ($4.89 in chips)
Seat 2: SchmittNieto ($2.48 in chips)
Seat 3: Lizzan618 ($2 in chips)
Seat 4: RichardTnz ($2 in chips)
Seat 5: MFanderson ($2.75 in chips)
Seat 6: Gomez224 ($3.93 in chips)
SchmittNieto: posts small blind $0.01
Lizzan618: posts big blind $0.02
*** HOLE CARDS ***
Dealt to LLregs [8s 9s]
RichardTnz: folds
MFanderson: folds
Gomez224: folds
LLregs: raises $0.04 to $0.06
SchmittNieto: folds
Lizzan618: folds
Uncalled bet ($0.04) returned to LLregs
LLregs collected $0.05 from pot
LLregs: doesn't show hand
*** SUMMARY ***
Total pot $0.05 | Rake $0
Seat 1: LLregs (button) collected ($0.05)
Seat 2: SchmittNieto (small blind) folded before Flop
Seat 3: Lizzan618 (big blind) folded before Flop
Seat 4: RichardTnz folded before Flop (didn't bet)
Seat 5: MFanderson folded before Flop (didn't bet)
Seat 6: Gomez224 folded before Flop (didn't bet)

PokerStars Zoom Hand #247965810350:  Hold'em No Limit ($0.01/$0.02) - 2023/12/30 20:17:58 WET [2023/12/30 15:17:58 ET]
Table 'Halley' 6-max Seat #1 is the button
Seat 1: mangalisa ($3.92 in chips)
Seat 2: organik33 ($0.76 in chips)
Seat 3: LLregs ($4.92 in chips)
Seat 4: lasica8312 ($1.21 in chips)
Seat 5: batya1212 ($3.79 in chips)
Seat 6: ifiret68 ($2 in chips)
organik33: posts small blind $0.01
LLregs: posts big blind $0.02
*** HOLE CARDS ***
Dealt to LLregs [3s 2d]
lasica8312: folds
batya1212: folds
ifiret68: folds
mangalisa: folds
organik33: raises $0.06 to $0.08
LLregs: folds
Uncalled bet ($0.06) returned to organik33
organik33 collected $0.04 from pot
organik33: doesn't show hand
*** SUMMARY ***
Total pot $0.04 | Rake $0
Seat 1: mangalisa (button) folded before Flop (didn't bet)
Seat 2: organik33 (small blind) collected ($0.04)
Seat 3: LLregs (big blind) folded before Flop
Seat 4: lasica8312 folded before Flop (didn't bet)
Seat 5: batya1212 folded before Flop (didn't bet)
Seat 6: ifiret68 folded before Flop (didn't bet)

PokerStars Zoom Hand #247965816796:  Hold'em No Limit ($0.01/$0.02) - 2023/12/30 20:18:14 WET [2023/12/30 15:18:14 ET]
Table 'Halley' 6-max Seat #1 is the button
Seat 1: LETZaGoMARIO ($2.31 in chips)
Seat 2: mangalisa ($3.92 in chips)
Seat 3: RickyPoker ($0.77 in chips)
Seat 4: Giuma2705 ($1.13 in chips)
Seat 5: bettanye ($2.16 in chips)
Seat 6: LLregs ($4.90 in chips)
mangalisa: posts small blind $0.01
RickyPoker: posts big blind $0.02
*** HOLE CARDS ***
Dealt to LLregs [As Ad]
Giuma2705: folds
bettanye: folds
LLregs: raises $0.04 to $0.06
LETZaGoMARIO: folds
mangalisa: calls $0.05
RickyPoker: calls $0.04
*** FLOP *** [6d Qd Kc]
mangalisa: checks
RickyPoker: checks
LLregs: bets $0.08
mangalisa: folds
RickyPoker: folds
Uncalled bet ($0.08) returned to LLregs
LLregs collected $0.17 from pot
LLregs: doesn't show hand
*** SUMMARY ***
Total pot $0.18 | Rake $0.01
Board [6d Qd Kc]
Seat 1: LETZaGoMARIO (button) folded before Flop (didn't bet)
Seat 2: mangalisa (small blind) folded on the Flop
Seat 3: RickyPoker (big blind) folded on the Flop
Seat 4: Giuma2705 folded before Flop (didn't bet)
Seat 5: bettanye folded before Flop (didn't bet)
Seat 6: LLregs collected ($0.17)

PokerStars Zoom Hand #247965828698:  Hold'em No Limit ($0.01/$0.02) - 2023/12/30 20:18:44 WET [2023/12/30 15:18:44 ET]
Table 'Halley' 6-max Seat #1 is the button
Seat 1: archilida ($0.96 in chips)
Seat 2: xTheBulletsx ($2.47 in chips)
Seat 3: Dimoni797979 ($1.55 in chips)
Seat 4: RichardTnz ($2.84 in chips)
Seat 5: LLregs ($5.01 in chips)
Seat 6: mrfastflow ($2.24 in chips)
xTheBulletsx: posts small blind $0.01
Dimoni797979: posts big blind $0.02
*** HOLE CARDS ***
Dealt to LLregs [6s 6d]
RichardTnz: raises $0.03 to $0.05
LLregs: calls $0.05
mrfastflow: folds
archilida: folds
xTheBulletsx: folds
Dimoni797979: folds
*** FLOP *** [8h Ts 9s]
RichardTnz: bets $0.05
LLregs: calls $0.05
*** TURN *** [8h Ts 9s] [Jd]
RichardTnz: checks
LLregs: bets $0.11
RichardTnz: folds
Uncalled bet ($0.11) returned to LLregs
LLregs collected $0.22 from pot
LLregs: doesn't show hand
*** SUMMARY ***
Total pot $0.23 | Rake $0.01
Board [8h Ts 9s Jd]
Seat 1: archilida (button) folded before Flop (didn't bet)
Seat 2: xTheBulletsx (small blind) folded before Flop
Seat 3: Dimoni797979 (big blind) folded before Flop
Seat 4: RichardTnz folded on the Turn
Seat 5: LLregs collected ($0.22)
Seat 6: mrfastflow folded before Flop (didn't bet)

PokerStars Zoom Hand #247965845626:  Hold'em No Limit ($0.01/$0.02) - 2023/12/30 20:19:27 WET [2023/12/30 15:19:27 ET]
Table 'Halley' 6-max Seat #1 is the button
Seat 1: LLregs ($5.13 in chips)
Seat 2: TooManyRivers ($5.59 in chips)
Seat 3: Noan Pereira ($2 in chips)
Seat 4: Rockoteki ($4.51 in chips)
Seat 5: Tornado$ky ($2 in chips)
Seat 6: roz534 ($1.52 in chips)
TooManyRivers: posts small blind $0.01
Noan Pereira: posts big blind $0.02
*** HOLE CARDS ***
Dealt to LLregs [3s Ks]
Rockoteki: folds
Tornado$ky: folds
roz534: folds
LLregs: folds
TooManyRivers: folds
Uncalled bet ($0.01) returned to Noan Pereira
Noan Pereira collected $0.02 from pot
Noan Pereira: doesn't show hand
*** SUMMARY ***
Total pot $0.02 | Rake $0
Seat 1: LLregs (button) folded before Flop (didn't bet)
Seat 2: TooManyRivers (small blind) folded before Flop
Seat 3: Noan Pereira (big blind) collected ($0.02)
Seat 4: Rockoteki folded before Flop (didn't bet)
Seat 5: Tornado$ky folded before Flop (didn't bet)
Seat 6: roz534 folded before Flop (didn't bet)

PokerStars Zoom Hand #247965854434:  Hold'em No Limit ($0.01/$0.02) - 2023/12/30 20:19:49 WET [2023/12/30 15:19:49 ET]
Table 'Halley' 6-max Seat #1 is the button
Seat 1: TigerYear ($3.41 in chips)
Seat 2: Lizzan618 ($2.69 in chips)
Seat 3: CrazyFairfox ($4.57 in chips)
Seat 4: WalkingDude19 ($2 in chips)
Seat 5: LLregs ($5.12 in chips)
Seat 6: ARES_312 ($1.88 in chips)
Lizzan618: posts small blind $0.01
CrazyFairfox: posts big blind $0.02
*** HOLE CARDS ***
Dealt to LLregs [Qs Ad]
WalkingDude19: folds
LLregs: raises $0.04 to $0.06
ARES_312: folds
TigerYear: folds
Lizzan618: folds
CrazyFairfox: folds
Uncalled bet ($0.04) returned to LLregs
LLregs collected $0.05 from pot
LLregs: doesn't show hand
*** SUMMARY ***
Total pot $0.05 | Rake $0
Seat 1: TigerYear (button) folded before Flop (didn't bet)
Seat 2: Lizzan618 (small blind) folded before Flop
Seat 3: CrazyFairfox (big blind) folded before Flop
Seat 4: WalkingDude19 folded before Flop (didn't bet)
Seat 5: LLregs collected ($0.05)
Seat 6: ARES_312 folded before Flop (didn't bet)

PokerStars Zoom Hand #247965847625:  Hold'em No Limit ($0.01/$0.02) - 2023/12/30 20:19:32 WET [2023/12/30 15:19:32 ET]
Table 'Halley' 6-max Seat #1 is the button
Seat 1: se62dor1961 ($1.01 in chips)
Seat 2: LLregs ($5.13 in chips)
Seat 3: conspy84 ($6.03 in chips)
Seat 4: djulio94rike ($2.03 in chips)
Seat 5: leedsrounder ($2.64 in chips)
Seat 6: Schoemeister ($3.35 in chips)
LLregs: posts small blind $0.01
conspy84: posts big blind $0.02
*** HOLE CARDS ***
Dealt to LLregs [Qc 6h]
djulio94rike: folds
leedsrounder: folds
Schoemeister: raises $0.04 to $0.06
se62dor1961: folds
LLregs: folds
conspy84: folds
Uncalled bet ($0.04) returned to Schoemeister
Schoemeister collected $0.05 from pot
Schoemeister: doesn't show hand
*** SUMMARY ***
Total pot $0.05 | Rake $0
Seat 1: se62dor1961 (button) folded before Flop (didn't bet)
Seat 2: LLregs (small blind) folded before Flop
Seat 3: conspy84 (big blind) folded before Flop
Seat 4: djulio94rike folded before Flop (didn't bet)
Seat 5: leedsrounder folded before Flop (didn't bet)
Seat 6: Schoemeister collected ($0.05)

PokerStars Zoom Hand #247965858023:  Hold'em No Limit ($0.01/$0.02) - 2023/12/30 20:19:58 WET [2023/12/30 15:19:58 ET]
Table 'Halley' 6-max Seat #1 is the button
Seat 1: FrancoGaston74 ($2.30 in chips)
Seat 2: Shmatrixs ($2.58 in chips)
Seat 3: LLregs ($5.15 in chips)
Seat 4: rrluis1930 ($2.01 in chips)
Seat 5: m_christova ($2.69 in chips)
Seat 6: esox_l ($2.39 in chips)
Shmatrixs: posts small blind $0.01
LLregs: posts big blind $0.02
*** HOLE CARDS ***
Dealt to LLregs [Ac 9s]
rrluis1930: folds
m_christova: folds
esox_l: raises $0.03 to $0.05
FrancoGaston74: folds
Shmatrixs: folds
LLregs: calls $0.03
*** FLOP *** [4d 5h Jc]
LLregs: checks
esox_l: bets $0.07
LLregs: folds
Uncalled bet ($0.07) returned to esox_l
esox_l collected $0.11 from pot
esox_l: doesn't show hand
*** SUMMARY ***
Total pot $0.11 | Rake $0
Board [4d 5h Jc]
Seat 1: FrancoGaston74 (button) folded before Flop (didn't bet)
Seat 2: Shmatrixs (small blind) folded before Flop
Seat 3: LLregs (big blind) folded on the Flop
Seat 4: rrluis1930 folded before Flop (didn't bet)
Seat 5: m_christova folded before Flop (didn't bet)
Seat 6: esox_l collected ($0.11)

PokerStars Zoom Hand #247965871197:  Hold'em No Limit ($0.01/$0.02) - 2023/12/30 20:20:31 WET [2023/12/30 15:20:31 ET]
Table 'Halley' 6-max Seat #1 is the button
Seat 1: BossTH4 ($3.78 in chips)
Seat 2: Zanyman222 ($2.12 in chips)
Seat 3: Dimoni797979 ($0.78 in chips)
Seat 4: LLregs ($5.10 in chips)
Seat 5: WalkingDude19 ($2 in chips)
Seat 6: djmcool ($2.25 in chips)
Zanyman222: posts small blind $0.01
Dimoni797979: posts big blind $0.02
*** HOLE CARDS ***
Dealt to LLregs [3s Qh]
LLregs: folds
WalkingDude19: folds
djmcool: raises $0.04 to $0.06
BossTH4: folds
Zanyman222: folds
Dimoni797979: folds
Uncalled bet ($0.04) returned to djmcool
djmcool collected $0.05 from pot
djmcool: doesn't show hand
*** SUMMARY ***
Total pot $0.05 | Rake $0
Seat 1: BossTH4 (button) folded before Flop (didn't bet)
Seat 2: Zanyman222 (small blind) folded before Flop
Seat 3: Dimoni797979 (big blind) folded before Flop
Seat 4: LLregs folded before Flop (didn't bet)
Seat 5: WalkingDude19 folded before Flop (didn't bet)
Seat 6: djmcool collected ($0.05)

PokerStars Zoom Hand #247965877604:  Hold'em No Limit ($0.01/$0.02) - 2023/12/30 20:20:48 WET [2023/12/30 15:20:48 ET]
Table 'Halley' 6-max Seat #1 is the button
Seat 1: enilno rats ($6.27 in chips)
Seat 2: LLregs ($5.10 in chips)
Seat 3: MR.BUMFLUFF ($2.80 in chips)
Seat 4: rjana165 ($1.95 in chips)
Seat 5: bettanye ($2.32 in chips)
Seat 6: WEBOO1 ($4.71 in chips)
LLregs: posts small blind $0.01
MR.BUMFLUFF: posts big blind $0.02
*** HOLE CARDS ***
Dealt to LLregs [5c Jh]
rjana165: folds
bettanye: folds
WEBOO1: folds
enilno rats: folds
LLregs: folds
Uncalled bet ($0.01) returned to MR.BUMFLUFF
MR.BUMFLUFF collected $0.02 from pot
MR.BUMFLUFF: doesn't show hand
*** SUMMARY ***
Total pot $0.02 | Rake $0
Seat 1: enilno rats (button) folded before Flop (didn't bet)
Seat 2: LLregs (small blind) folded before Flop
Seat 3: MR.BUMFLUFF (big blind) collected ($0.02)
Seat 4: rjana165 folded before Flop (didn't bet)
Seat 5: bettanye folded before Flop (didn't bet)
Seat 6: WEBOO1 folded before Flop (didn't bet)

PokerStars Zoom Hand #247965872333:  Hold'em No Limit ($0.01/$0.02) - 2023/12/30 20:20:34 WET [2023/12/30 15:20:34 ET]
Table 'Halley' 6-max Seat #1 is the button
Seat 1: TigerYear ($3.40 in chips)
Seat 2: IanMacDaddy ($2.55 in chips)
Seat 3: Schoemeister ($3.18 in chips)
Seat 4: BadBeat Bert ($0.88 in chips)
Seat 5: conspy84 ($2.27 in chips)
Seat 6: LLregs ($5.10 in chips)
IanMacDaddy: posts small blind $0.01
Schoemeister: posts big blind $0.02
*** HOLE CARDS ***
Dealt to LLregs [Ks 8d]
BadBeat Bert: folds
conspy84: folds
LLregs: folds
TigerYear: folds
IanMacDaddy: raises $0.03 to $0.05
Schoemeister: calls $0.03
*** FLOP *** [5c Ah Ac]
IanMacDaddy: bets $0.03
Schoemeister: folds
Uncalled bet ($0.03) returned to IanMacDaddy
IanMacDaddy collected $0.10 from pot
IanMacDaddy: doesn't show hand
*** SUMMARY ***
Total pot $0.10 | Rake $0
Board [5c Ah Ac]
Seat 1: TigerYear (button) folded before Flop (didn't bet)
Seat 2: IanMacDaddy (small blind) collected ($0.10)
Seat 3: Schoemeister (big blind) folded on the Flop
Seat 4: BadBeat Bert folded before Flop (didn't bet)
Seat 5: conspy84 folded before Flop (didn't bet)
Seat 6: LLregs folded before Flop (didn't bet)

PokerStars Zoom Hand #247965879295:  Hold'em No Limit ($0.01/$0.02) - 2023/12/30 20:20:52 WET [2023/12/30 15:20:52 ET]
Table 'Halley' 6-max Seat #1 is the button
Seat 1: Anouk512 ($2 in chips)
Seat 2: rjana165 ($1.95 in chips)
Seat 3: DanRussel ($2.04 in chips)
Seat 4: WEBOO1 ($4.71 in chips)
Seat 5: WolveroX ($1.76 in chips)
Seat 6: LLregs ($5.09 in chips)
rjana165: posts small blind $0.01
DanRussel: posts big blind $0.02
*** HOLE CARDS ***
Dealt to LLregs [7c 4s]
WEBOO1: folds
WolveroX: folds
LLregs: folds
Anouk512: raises $0.02 to $0.04
rjana165: folds
DanRussel: folds
Uncalled bet ($0.02) returned to Anouk512
Anouk512 collected $0.05 from pot
Anouk512: doesn't show hand
*** SUMMARY ***
Total pot $0.05 | Rake $0
Seat 1: Anouk512 (button) collected ($0.05)
Seat 2: rjana165 (small blind) folded before Flop
Seat 3: DanRussel (big blind) folded before Flop
Seat 4: WEBOO1 folded before Flop (didn't bet)
Seat 5: WolveroX folded before Flop (didn't bet)
Seat 6: LLregs folded before Flop (didn't bet)

PokerStars Zoom Hand #247965880855:  Hold'em No Limit ($0.01/$0.02) - 2023/12/30 20:20:56 WET [2023/12/30 15:20:56 ET]
Table 'Halley' 6-max Seat #1 is the button
Seat 1: LLregs ($5.09 in chips)
Seat 2: WEBOO1 ($4.71 in chips)
Seat 3: Pietras_09 ($2 in chips)
Seat 4: bakayoko31 ($1.51 in chips)
Seat 5: as123st ($3.43 in chips)
Seat 6: Tornado$ky ($2.83 in chips)
WEBOO1: posts small blind $0.01
Pietras_09: posts big blind $0.02
*** HOLE CARDS ***
Dealt to LLregs [4c As]
bakayoko31: folds
as123st: folds
Tornado$ky: folds
LLregs: folds
WEBOO1: folds
Uncalled bet ($0.01) returned to Pietras_09
Pietras_09 collected $0.02 from pot
Pietras_09: doesn't show hand
*** SUMMARY ***
Total pot $0.02 | Rake $0
Seat 1: LLregs (button) folded before Flop (didn't bet)
Seat 2: WEBOO1 (small blind) folded before Flop
Seat 3: Pietras_09 (big blind) collected ($0.02)
Seat 4: bakayoko31 folded before Flop (didn't bet)
Seat 5: as123st folded before Flop (didn't bet)
Seat 6: Tornado$ky folded before Flop (didn't bet)

PokerStars Zoom Hand #247965882492:  Hold'em No Limit ($0.01/$0.02) - 2023/12/30 20:21:00 WET [2023/12/30 15:21:00 ET]
Table 'Halley' 6-max Seat #1 is the button
Seat 1: Silvers14 ($2.35 in chips)
Seat 2: gio119 ($2 in chips)
Seat 3: LLregs ($5.09 in chips)
Seat 4: HarryHaller77 ($2.25 in chips)
Seat 5: Bhaal89 ($3.94 in chips)
Seat 6: PR3SUR3 ($4.08 in chips)
gio119: posts small blind $0.01
LLregs: posts big blind $0.02
*** HOLE CARDS ***
Dealt to LLregs [2h Ks]
HarryHaller77: folds
Bhaal89: folds
PR3SUR3: folds
Silvers14: folds
gio119: folds
Uncalled bet ($0.01) returned to LLregs
LLregs collected $0.02 from pot
LLregs: doesn't show hand
*** SUMMARY ***
Total pot $0.02 | Rake $0
Seat 1: Silvers14 (button) folded before Flop (didn't bet)
Seat 2: gio119 (small blind) folded before Flop
Seat 3: LLregs (big blind) collected ($0.02)
Seat 4: HarryHaller77 folded before Flop (didn't bet)
Seat 5: Bhaal89 folded before Flop (didn't bet)
Seat 6: PR3SUR3 folded before Flop (didn't bet)

PokerStars Zoom Hand #247965876081:  Hold'em No Limit ($0.01/$0.02) - 2023/12/30 20:20:44 WET [2023/12/30 15:20:44 ET]
Table 'Halley' 6-max Seat #1 is the button
Seat 1: milous7 ($1.63 in chips)
Seat 2: djmcool ($4.17 in chips)
Seat 3: somidwey ($2.35 in chips)
Seat 4: LLregs ($5.10 in chips)
Seat 5: bakayoko31 ($1.51 in chips)
Seat 6: nuttymuch ($6.58 in chips)
djmcool: posts small blind $0.01
somidwey: posts big blind $0.02
*** HOLE CARDS ***
Dealt to LLregs [Ad 6c]
LLregs: folds
bakayoko31: folds
nuttymuch: folds
milous7: folds
djmcool: raises $0.04 to $0.06
somidwey: raises $0.12 to $0.18
djmcool: calls $0.12
*** FLOP *** [Qs 4h 5c]
djmcool: checks
somidwey: checks
*** TURN *** [Qs 4h 5c] [9d]
djmcool: checks
somidwey: checks
*** RIVER *** [Qs 4h 5c 9d] [Js]
djmcool: checks
somidwey: checks
*** SHOW DOWN ***
djmcool: shows [5h 7h] (a pair of Fives)
somidwey: shows [Tc Jh] (a pair of Jacks)
somidwey collected $0.35 from pot
*** SUMMARY ***
Total pot $0.36 | Rake $0.01
Board [Qs 4h 5c 9d Js]
Seat 1: milous7 (button) folded before Flop (didn't bet)
Seat 2: djmcool (small blind) showed [5h 7h] and lost with a pair of Fives
Seat 3: somidwey (big blind) showed [Tc Jh] and won ($0.35) with a pair of Jacks
Seat 4: LLregs folded before Flop (didn't bet)
Seat 5: bakayoko31 folded before Flop (didn't bet)
Seat 6: nuttymuch folded before Flop (didn't bet)

PokerStars Zoom Hand #247965887257:  Hold'em No Limit ($0.01/$0.02) - 2023/12/30 20:21:12 WET [2023/12/30 15:21:12 ET]
Table 'Halley' 6-max Seat #1 is the button
Seat 1: BadBeat Bert ($0.84 in chips)
Seat 2: edhillm ($2.12 in chips)
Seat 3: xTheBulletsx ($2 in chips)
Seat 4: FrancoGaston74 ($2 in chips)
Seat 5: LLregs ($5.10 in chips)
Seat 6: Tornado$ky ($3.23 in chips)
edhillm: posts small blind $0.01
xTheBulletsx: posts big blind $0.02
*** HOLE CARDS ***
Dealt to LLregs [2c Kd]
FrancoGaston74: folds
LLregs: folds
Tornado$ky: folds
BadBeat Bert: calls $0.02
edhillm: raises $0.04 to $0.06
xTheBulletsx: raises $0.16 to $0.22
BadBeat Bert: folds
edhillm: folds
Uncalled bet ($0.16) returned to xTheBulletsx
xTheBulletsx collected $0.14 from pot
xTheBulletsx: doesn't show hand
*** SUMMARY ***
Total pot $0.14 | Rake $0
Seat 1: BadBeat Bert (button) folded before Flop
Seat 2: edhillm (small blind) folded before Flop
Seat 3: xTheBulletsx (big blind) collected ($0.14)
Seat 4: FrancoGaston74 folded before Flop (didn't bet)
Seat 5: LLregs folded before Flop (didn't bet)
Seat 6: Tornado$ky folded before Flop (didn't bet)

PokerStars Zoom Hand #247965888747:  Hold'em No Limit ($0.01/$0.02) - 2023/12/30 20:21:16 WET [2023/12/30 15:21:16 ET]
Table 'Halley' 6-max Seat #1 is the button
Seat 1: ichithekill ($2.09 in chips)
Seat 2: Tornado$ky ($3.23 in chips)
Seat 3: Kamylo20 ($2.72 in chips)
Seat 4: LLregs ($5.10 in chips)
Seat 5: rjana165 ($1.92 in chips)
Seat 6: Zanyman222 ($2.14 in chips)
Tornado$ky: posts small blind $0.01
Kamylo20: posts big blind $0.02
*** HOLE CARDS ***
Dealt to LLregs [5c 2h]
LLregs: folds
rjana165: calls $0.02
Zanyman222: calls $0.02
ichithekill: folds
Tornado$ky: folds
Kamylo20: checks
*** FLOP *** [Qd Jc 2s]
Kamylo20: checks
rjana165: checks
Zanyman222: bets $0.02
Kamylo20: folds
rjana165: folds
Uncalled bet ($0.02) returned to Zanyman222
Zanyman222 collected $0.07 from pot
Zanyman222: doesn't show hand
*** SUMMARY ***
Total pot $0.07 | Rake $0
Board [Qd Jc 2s]
Seat 1: ichithekill (button) folded before Flop (didn't bet)
Seat 2: Tornado$ky (small blind) folded before Flop
Seat 3: Kamylo20 (big blind) folded on the Flop
Seat 4: LLregs folded before Flop (didn't bet)
Seat 5: rjana165 folded on the Flop
Seat 6: Zanyman222 collected ($0.07)

PokerStars Zoom Hand #247965890317:  Hold'em No Limit ($0.01/$0.02) - 2023/12/30 20:21:20 WET [2023/12/30 15:21:20 ET]
Table 'Halley' 6-max Seat #1 is the button
Seat 1: cr@sh test ($2 in chips)
Seat 2: as123st ($4.15 in chips)
Seat 3: djmcool ($2.27 in chips)
Seat 4: Lauritsen95 ($1.92 in chips)
Seat 5: LLregs ($5.10 in chips)
Seat 6: peto322 ($4.04 in chips)
as123st: posts small blind $0.01
djmcool: posts big blind $0.02
*** HOLE CARDS ***
Dealt to LLregs [Ts 6s]
peto322 is disconnected
Lauritsen95: folds
LLregs: folds
peto322 has timed out while disconnected
peto322: folds
cr@sh test: folds
as123st: folds
Uncalled bet ($0.01) returned to djmcool
djmcool collected $0.02 from pot
djmcool: doesn't show hand
*** SUMMARY ***
Total pot $0.02 | Rake $0
Seat 1: cr@sh test (button) folded before Flop (didn't bet)
Seat 2: as123st (small blind) folded before Flop
Seat 3: djmcool (big blind) collected ($0.02)
Seat 4: Lauritsen95 folded before Flop (didn't bet)
Seat 5: LLregs folded before Flop (didn't bet)
Seat 6: peto322 folded before Flop (didn't bet)

PokerStars Zoom Hand #247965895559:  Hold'em No Limit ($0.01/$0.02) - 2023/12/30 20:21:33 WET [2023/12/30 15:21:33 ET]
Table 'Halley' 6-max Seat #1 is the button
Seat 1: Dimoni797979 ($1.90 in chips)
Seat 2: LLregs ($5.10 in chips)
Seat 3: diokyn ($2.98 in chips)
Seat 4: esox_l ($2.29 in chips)
Seat 5: Jarovit ($2.92 in chips)
Seat 6: 232489410 ($2.42 in chips)
LLregs: posts small blind $0.01
diokyn: posts big blind $0.02
*** HOLE CARDS ***
Dealt to LLregs [8h Ah]
esox_l: folds
Jarovit: calls $0.02
232489410: folds
Dimoni797979: folds
LLregs: raises $0.04 to $0.06
diokyn: folds
Jarovit: calls $0.04
*** FLOP *** [5d 3h 8s]
LLregs: bets $0.05
Jarovit: calls $0.05
*** TURN *** [5d 3h 8s] [Qs]
LLregs: bets $0.05
Jarovit: raises $0.17 to $0.22
LLregs: calls $0.17
*** RIVER *** [5d 3h 8s Qs] [Jc]
LLregs: checks
Jarovit: bets $0.66
LLregs: calls $0.66
*** SHOW DOWN ***
Jarovit: shows [Ks Td] (high card King)
LLregs: shows [8h Ah] (a pair of Eights)
LLregs collected $1.93 from pot
*** SUMMARY ***
Total pot $2 | Rake $0.07
Board [5d 3h 8s Qs Jc]
Seat 1: Dimoni797979 (button) folded before Flop (didn't bet)
Seat 2: LLregs (small blind) showed [8h Ah] and won ($1.93) with a pair of Eights
Seat 3: diokyn (big blind) folded before Flop
Seat 4: esox_l folded before Flop (didn't bet)
Seat 5: Jarovit showed [Ks Td] and lost with high card King
Seat 6: 232489410 folded before Flop (didn't bet)

PokerStars Zoom Hand #247965893987:  Hold'em No Limit ($0.01/$0.02) - 2023/12/30 20:21:29 WET [2023/12/30 15:21:29 ET]
Table 'Halley' 6-max Seat #1 is the button
Seat 1: Svetlana-ck ($1.34 in chips)
Seat 2: conspy84 ($4.01 in chips)
Seat 3: Rockoteki ($4.70 in chips)
Seat 4: LLregs ($5.10 in chips)
Seat 5: Fasteddie35 ($3.94 in chips)
Seat 6: batya1212 ($2.44 in chips)
conspy84: posts small blind $0.01
Rockoteki: posts big blind $0.02
*** HOLE CARDS ***
Dealt to LLregs [9h 3h]
LLregs: folds
Fasteddie35: raises $0.03 to $0.05
batya1212: calls $0.05
Svetlana-ck: calls $0.05
conspy84: calls $0.04
Rockoteki: calls $0.03
*** FLOP *** [Kd Qs Jd]
conspy84: checks
Rockoteki: checks
Fasteddie35: checks
batya1212: bets $0.09
Svetlana-ck: folds
conspy84: folds
Rockoteki: folds
Fasteddie35: calls $0.09
*** TURN *** [Kd Qs Jd] [5s]
Fasteddie35: checks
batya1212: checks
*** RIVER *** [Kd Qs Jd 5s] [Ad]
Fasteddie35: checks
batya1212: checks
*** SHOW DOWN ***
Fasteddie35: shows [Ks 6s] (a pair of Kings)
batya1212: shows [Jh Qh] (two pair, Queens and Jacks)
batya1212 collected $0.41 from pot
*** SUMMARY ***
Total pot $0.43 | Rake $0.02
Board [Kd Qs Jd 5s Ad]
Seat 1: Svetlana-ck (button) folded on the Flop
Seat 2: conspy84 (small blind) folded on the Flop
Seat 3: Rockoteki (big blind) folded on the Flop
Seat 4: LLregs folded before Flop (didn't bet)
Seat 5: Fasteddie35 showed [Ks 6s] and lost with a pair of Kings
Seat 6: batya1212 showed [Jh Qh] and won ($0.41) with two pair, Queens and Jacks

PokerStars Zoom Hand #247965915274:  Hold'em No Limit ($0.01/$0.02) - 2023/12/30 20:22:23 WET [2023/12/30 15:22:23 ET]
Table 'Halley' 6-max Seat #1 is the button
Seat 1: gvc33 ($0.53 in chips)
Seat 2: Tornado$ky ($2.78 in chips)
Seat 3: LLregs ($6.04 in chips)
Seat 4: conspy84 ($2.26 in chips)
Seat 5: Harold_Seven ($1.58 in chips)
Seat 6: JaUm_V ($11.87 in chips)
Tornado$ky: posts small blind $0.01
LLregs: posts big blind $0.02
*** HOLE CARDS ***
Dealt to LLregs [7h Kh]
conspy84: folds
Harold_Seven: raises $0.04 to $0.06
JaUm_V: folds
gvc33: folds
Tornado$ky: folds
LLregs: calls $0.04
*** FLOP *** [3s 9d Th]
LLregs: checks
Harold_Seven: bets $0.06
LLregs: folds
Uncalled bet ($0.06) returned to Harold_Seven
Harold_Seven collected $0.13 from pot
Harold_Seven: doesn't show hand
*** SUMMARY ***
Total pot $0.13 | Rake $0
Board [3s 9d Th]
Seat 1: gvc33 (button) folded before Flop (didn't bet)
Seat 2: Tornado$ky (small blind) folded before Flop
Seat 3: LLregs (big blind) folded on the Flop
Seat 4: conspy84 folded before Flop (didn't bet)
Seat 5: Harold_Seven collected ($0.13)
Seat 6: JaUm_V folded before Flop (didn't bet)

PokerStars Zoom Hand #247965913456:  Hold'em No Limit ($0.01/$0.02) - 2023/12/30 20:22:18 WET [2023/12/30 15:22:18 ET]
Table 'Halley' 6-max Seat #1 is the button
Seat 1: LLregs ($6.04 in chips)
Seat 2: zhuk201355 ($0.74 in chips)
Seat 3: craz400 ($1 in chips)
Seat 4: Lizzan618 ($2.55 in chips)
Seat 5: Jova3378 ($0.93 in chips)
Seat 6: BossTH4 ($4.15 in chips)
zhuk201355: posts small blind $0.01
craz400: posts big blind $0.02
*** HOLE CARDS ***
Dealt to LLregs [Ts 4s]
Lizzan618: folds
Jova3378: folds
BossTH4: folds
LLregs: folds
zhuk201355: raises $0.02 to $0.04
craz400: raises $0.02 to $0.06
zhuk201355: calls $0.02
*** FLOP *** [Qd 6h 3s]
zhuk201355: bets $0.02
craz400: calls $0.02
*** TURN *** [Qd 6h 3s] [Qs]
zhuk201355: bets $0.02
craz400: raises $0.10 to $0.12
zhuk201355: calls $0.10
*** RIVER *** [Qd 6h 3s Qs] [5s]
zhuk201355: bets $0.02
craz400: raises $0.43 to $0.45
zhuk201355: folds
Uncalled bet ($0.43) returned to craz400
craz400 collected $0.42 from pot
craz400: doesn't show hand
*** SUMMARY ***
Total pot $0.44 | Rake $0.02
Board [Qd 6h 3s Qs 5s]
Seat 1: LLregs (button) folded before Flop (didn't bet)
Seat 2: zhuk201355 (small blind) folded on the River
Seat 3: craz400 (big blind) collected ($0.42)
Seat 4: Lizzan618 folded before Flop (didn't bet)
Seat 5: Jova3378 folded before Flop (didn't bet)
Seat 6: BossTH4 folded before Flop (didn't bet)

PokerStars Zoom Hand #247965926089:  Hold'em No Limit ($0.01/$0.02) - 2023/12/30 20:22:50 WET [2023/12/30 15:22:50 ET]
Table 'Halley' 6-max Seat #1 is the button
Seat 1: Beduin250 ($2.38 in chips)
Seat 2: TigerYear ($2.08 in chips)
Seat 3: K.Tyler111 ($2 in chips)
Seat 4: diokyn ($2.95 in chips)
Seat 5: djmcool ($2.14 in chips)
Seat 6: LLregs ($5.98 in chips)
TigerYear: posts small blind $0.01
K.Tyler111: posts big blind $0.02
*** HOLE CARDS ***
Dealt to LLregs [Kh Jc]
diokyn: folds
djmcool: folds
LLregs: raises $0.04 to $0.06
Beduin250: folds
TigerYear: folds
K.Tyler111: folds
Uncalled bet ($0.04) returned to LLregs
LLregs collected $0.05 from pot
LLregs: doesn't show hand
*** SUMMARY ***
Total pot $0.05 | Rake $0
Seat 1: Beduin250 (button) folded before Flop (didn't bet)
Seat 2: TigerYear (small blind) folded before Flop
Seat 3: K.Tyler111 (big blind) folded before Flop
Seat 4: diokyn folded before Flop (didn't bet)
Seat 5: djmcool folded before Flop (didn't bet)
Seat 6: LLregs collected ($0.05)

PokerStars Zoom Hand #247965931190:  Hold'em No Limit ($0.01/$0.02) - 2023/12/30 20:23:03 WET [2023/12/30 15:23:03 ET]
Table 'Halley' 6-max Seat #1 is the button
Seat 1: Kamylo20 ($3.44 in chips)
Seat 2: LLregs ($6.01 in chips)
Seat 3: Tornado$ky ($2.10 in chips)
Seat 4: FERNANDO R01997 ($2.49 in chips)
Seat 5: 888lifeIS ($2 in chips)
Seat 6: conspy84 ($3.96 in chips)
LLregs: posts small blind $0.01
Tornado$ky: posts big blind $0.02
*** HOLE CARDS ***
Dealt to LLregs [8s Ts]
FERNANDO R01997: folds
888lifeIS: folds
conspy84: folds
Kamylo20: folds
LLregs: raises $0.04 to $0.06
Tornado$ky: calls $0.04
*** FLOP *** [6d 8c 2c]
LLregs: checks
Tornado$ky: checks
*** TURN *** [6d 8c 2c] [4c]
LLregs: checks
Tornado$ky: checks
*** RIVER *** [6d 8c 2c 4c] [Ac]
LLregs: bets $0.03
Tornado$ky: folds
Uncalled bet ($0.03) returned to LLregs
LLregs collected $0.12 from pot
LLregs: doesn't show hand
*** SUMMARY ***
Total pot $0.12 | Rake $0
Board [6d 8c 2c 4c Ac]
Seat 1: Kamylo20 (button) folded before Flop (didn't bet)
Seat 2: LLregs (small blind) collected ($0.12)
Seat 3: Tornado$ky (big blind) folded on the River
Seat 4: FERNANDO R01997 folded before Flop (didn't bet)
Seat 5: 888lifeIS folded before Flop (didn't bet)
Seat 6: conspy84 folded before Flop (didn't bet)

PokerStars Zoom Hand #247965943954:  Hold'em No Limit ($0.01/$0.02) - 2023/12/30 20:23:35 WET [2023/12/30 15:23:35 ET]
Table 'Halley' 6-max Seat #1 is the button
Seat 1: LLregs ($6.07 in chips)
Seat 2: gepard35 ($2.57 in chips)
Seat 3: kuelas ($2.06 in chips)
Seat 4: ifiret68 ($2.34 in chips)
Seat 5: ichithekill ($2.05 in chips)
Seat 6: santogr893 ($5.45 in chips)
gepard35: posts small blind $0.01
kuelas: posts big blind $0.02
*** HOLE CARDS ***
Dealt to LLregs [6c As]
ifiret68: folds
ichithekill: folds
santogr893: folds
LLregs: raises $0.04 to $0.06
gepard35: calls $0.05
kuelas: calls $0.04
*** FLOP *** [Ks 8d Kc]
gepard35: checks
kuelas: checks
LLregs: checks
*** TURN *** [Ks 8d Kc] [7s]
gepard35: checks
kuelas: bets $0.09
LLregs: folds
gepard35: folds
Uncalled bet ($0.09) returned to kuelas
kuelas collected $0.17 from pot
kuelas: doesn't show hand
*** SUMMARY ***
Total pot $0.18 | Rake $0.01
Board [Ks 8d Kc 7s]
Seat 1: LLregs (button) folded on the Turn
Seat 2: gepard35 (small blind) folded on the Turn
Seat 3: kuelas (big blind) collected ($0.17)
Seat 4: ifiret68 folded before Flop (didn't bet)
Seat 5: ichithekill folded before Flop (didn't bet)
Seat 6: santogr893 folded before Flop (didn't bet)

PokerStars Zoom Hand #247965957303:  Hold'em No Limit ($0.01/$0.02) - 2023/12/30 20:24:09 WET [2023/12/30 15:24:09 ET]
Table 'Halley' 6-max Seat #1 is the button
Seat 1: jamam333 ($2.48 in chips)
Seat 2: ajimvr ($3.39 in chips)
Seat 3: tooloco ($0.99 in chips)
Seat 4: Vitaliy v775 ($2.35 in chips)
Seat 5: MFanderson ($3.56 in chips)
Seat 6: LLregs ($6.01 in chips)
ajimvr: posts small blind $0.01
tooloco: posts big blind $0.02
*** HOLE CARDS ***
Dealt to LLregs [6h 3h]
Vitaliy v775: folds
MFanderson: folds
LLregs: folds
jamam333: folds
ajimvr: folds
Uncalled bet ($0.01) returned to tooloco
tooloco collected $0.02 from pot
tooloco: doesn't show hand
*** SUMMARY ***
Total pot $0.02 | Rake $0
Seat 1: jamam333 (button) folded before Flop (didn't bet)
Seat 2: ajimvr (small blind) folded before Flop
Seat 3: tooloco (big blind) collected ($0.02)
Seat 4: Vitaliy v775 folded before Flop (didn't bet)
Seat 5: MFanderson folded before Flop (didn't bet)
Seat 6: LLregs folded before Flop (didn't bet)

PokerStars Zoom Hand #247965958859:  Hold'em No Limit ($0.01/$0.02) - 2023/12/30 20:24:13 WET [2023/12/30 15:24:13 ET]
Table 'Halley' 6-max Seat #1 is the button
Seat 1: rjana165 ($1.94 in chips)
Seat 2: conspy84 ($3.48 in chips)
Seat 3: ajimvr ($3.38 in chips)
Seat 4: RamGur ($2.19 in chips)
Seat 5: LLregs ($6.01 in chips)
Seat 6: KKisthere ($0.82 in chips)
conspy84: posts small blind $0.01
ajimvr: posts big blind $0.02
*** HOLE CARDS ***
Dealt to LLregs [7d 9d]
KKisthere is disconnected
RamGur: folds
LLregs: raises $0.04 to $0.06
KKisthere has timed out while disconnected
KKisthere: folds
rjana165: folds
conspy84: calls $0.05
ajimvr: folds
*** FLOP *** [Ad 5c Ts]
conspy84: bets $0.04
LLregs: calls $0.04
*** TURN *** [Ad 5c Ts] [7s]
conspy84: bets $0.08
LLregs: calls $0.08
*** RIVER *** [Ad 5c Ts 7s] [3s]
conspy84: checks
LLregs: bets $0.22
conspy84: calls $0.22
*** SHOW DOWN ***
LLregs: shows [7d 9d] (a pair of Sevens)
conspy84: shows [Ah 5h] (two pair, Aces and Fives)
conspy84 collected $0.78 from pot
*** SUMMARY ***
Total pot $0.82 | Rake $0.04
Board [Ad 5c Ts 7s 3s]
Seat 1: rjana165 (button) folded before Flop (didn't bet)
Seat 2: conspy84 (small blind) showed [Ah 5h] and won ($0.78) with two pair, Aces and Fives
Seat 3: ajimvr (big blind) folded before Flop
Seat 4: RamGur folded before Flop (didn't bet)
Seat 5: LLregs showed [7d 9d] and lost with a pair of Sevens
Seat 6: KKisthere folded before Flop (didn't bet)

PokerStars Zoom Hand #247965996936:  Hold'em No Limit ($0.01/$0.02) - 2023/12/30 20:25:50 WET [2023/12/30 15:25:50 ET]
Table 'Halley' 6-max Seat #1 is the button
Seat 1: LazyHazy69 ($0.62 in chips)
Seat 2: davidbarrels ($0.94 in chips)
Seat 3: LLregs ($5.61 in chips)
Seat 4: conspy84 ($3.86 in chips)
Seat 5: edhillm ($2.26 in chips)
Seat 6: LETZaGoMARIO ($2.31 in chips)
davidbarrels: posts small blind $0.01
LLregs: posts big blind $0.02
*** HOLE CARDS ***
Dealt to LLregs [6c 9h]
conspy84: folds
edhillm: folds
LETZaGoMARIO: folds
LazyHazy69: calls $0.02
davidbarrels: folds
LLregs: checks
*** FLOP *** [7s 3d Td]
LLregs: checks
LazyHazy69: checks
*** TURN *** [7s 3d Td] [Qs]
LLregs: checks
LazyHazy69: checks
*** RIVER *** [7s 3d Td Qs] [2h]
LLregs: checks
LazyHazy69: checks
*** SHOW DOWN ***
LLregs: shows [6c 9h] (high card Queen)
LazyHazy69: shows [7c 5s] (a pair of Sevens)
LazyHazy69 collected $0.05 from pot
*** SUMMARY ***
Total pot $0.05 | Rake $0
Board [7s 3d Td Qs 2h]
Seat 1: LazyHazy69 (button) showed [7c 5s] and won ($0.05) with a pair of Sevens
Seat 2: davidbarrels (small blind) folded before Flop
Seat 3: LLregs (big blind) showed [6c 9h] and lost with high card Queen
Seat 4: conspy84 folded before Flop (didn't bet)
Seat 5: edhillm folded before Flop (didn't bet)
Seat 6: LETZaGoMARIO folded before Flop (didn't bet)

PokerStars Zoom Hand #247966012021:  Hold'em No Limit ($0.01/$0.02) - 2023/12/30 20:26:28 WET [2023/12/30 15:26:28 ET]
Table 'Halley' 6-max Seat #1 is the button
Seat 1: pietrek2 ($8.91 in chips)
Seat 2: LLregs ($5.59 in chips)
Seat 3: tooloco ($0.96 in chips)
Seat 4: Dimoni797979 ($3.51 in chips)
Seat 5: SannBy ($7.31 in chips)
Seat 6: Ukr Troll ($6.23 in chips)
LLregs: posts small blind $0.01
tooloco: posts big blind $0.02
*** HOLE CARDS ***
Dealt to LLregs [Ks Jd]
Dimoni797979: folds
SannBy: folds
Ukr Troll: folds
pietrek2: folds
LLregs: raises $0.04 to $0.06
tooloco: folds
Uncalled bet ($0.04) returned to LLregs
LLregs collected $0.04 from pot
LLregs: doesn't show hand
*** SUMMARY ***
Total pot $0.04 | Rake $0
Seat 1: pietrek2 (button) folded before Flop (didn't bet)
Seat 2: LLregs (small blind) collected ($0.04)
Seat 3: tooloco (big blind) folded before Flop
Seat 4: Dimoni797979 folded before Flop (didn't bet)
Seat 5: SannBy folded before Flop (didn't bet)
Seat 6: Ukr Troll folded before Flop (didn't bet)

PokerStars Zoom Hand #247966009663:  Hold'em No Limit ($0.01/$0.02) - 2023/12/30 20:26:22 WET [2023/12/30 15:26:22 ET]
Table 'Halley' 6-max Seat #1 is the button
Seat 1: conspy84 ($4.38 in chips)
Seat 2: LazyHazy69 ($0.65 in chips)
Seat 3: mangalisa ($6.33 in chips)
Seat 4: gepard35 ($2.97 in chips)
Seat 5: gio119 ($2.27 in chips)
Seat 6: LLregs ($5.59 in chips)
LazyHazy69: posts small blind $0.01
mangalisa: posts big blind $0.02
*** HOLE CARDS ***
Dealt to LLregs [Jh 5d]
gepard35: folds
gio119: folds
LLregs: folds
conspy84: folds
LazyHazy69: calls $0.01
mangalisa: raises $0.02 to $0.04
LazyHazy69: calls $0.02
*** FLOP *** [6c 7s Qd]
LazyHazy69: checks
mangalisa: checks
*** TURN *** [6c 7s Qd] [Ad]
LazyHazy69: checks
mangalisa: checks
*** RIVER *** [6c 7s Qd Ad] [2c]
LazyHazy69: bets $0.61 and is all-in
mangalisa: folds
Uncalled bet ($0.61) returned to LazyHazy69
LazyHazy69 collected $0.08 from pot
LazyHazy69: doesn't show hand
*** SUMMARY ***
Total pot $0.08 | Rake $0
Board [6c 7s Qd Ad 2c]
Seat 1: conspy84 (button) folded before Flop (didn't bet)
Seat 2: LazyHazy69 (small blind) collected ($0.08)
Seat 3: mangalisa (big blind) folded on the River
Seat 4: gepard35 folded before Flop (didn't bet)
Seat 5: gio119 folded before Flop (didn't bet)
Seat 6: LLregs folded before Flop (didn't bet)

PokerStars Zoom Hand #247966017605:  Hold'em No Limit ($0.01/$0.02) - 2023/12/30 20:26:42 WET [2023/12/30 15:26:42 ET]
Table 'Halley' 6-max Seat #1 is the button
Seat 1: LLregs ($5.61 in chips)
Seat 2: vovan22-99 ($1.80 in chips)
Seat 3: djmcool ($4.42 in chips)
Seat 4: ds_pearce2 ($2.03 in chips)
Seat 5: ARES_312 ($2.27 in chips)
Seat 6: mangalisa ($2.02 in chips)
vovan22-99: posts small blind $0.01
djmcool: posts big blind $0.02
*** HOLE CARDS ***
Dealt to LLregs [2h 7d]
ds_pearce2: folds
ARES_312: folds
mangalisa: folds
LLregs: folds
vovan22-99: raises $0.04 to $0.06
djmcool: calls $0.04
*** FLOP *** [Qd 4s Ac]
vovan22-99: checks
djmcool: bets $0.06
vovan22-99: folds
Uncalled bet ($0.06) returned to djmcool
djmcool collected $0.12 from pot
djmcool: doesn't show hand
*** SUMMARY ***
Total pot $0.12 | Rake $0
Board [Qd 4s Ac]
Seat 1: LLregs (button) folded before Flop (didn't bet)
Seat 2: vovan22-99 (small blind) folded on the Flop
Seat 3: djmcool (big blind) collected ($0.12)
Seat 4: ds_pearce2 folded before Flop (didn't bet)
Seat 5: ARES_312 folded before Flop (didn't bet)
Seat 6: mangalisa folded before Flop (didn't bet)

PokerStars Zoom Hand #247966018940:  Hold'em No Limit ($0.01/$0.02) - 2023/12/30 20:26:45 WET [2023/12/30 15:26:45 ET]
Table 'Halley' 6-max Seat #1 is the button
Seat 1: Fasteddie35 ($3.10 in chips)
Seat 2: WalkingDude19 ($2.95 in chips)
Seat 3: AAandanAA ($2.83 in chips)
Seat 4: conspy84 ($5.43 in chips)
Seat 5: LLregs ($5.61 in chips)
Seat 6: Sperick ($2.12 in chips)
WalkingDude19: posts small blind $0.01
AAandanAA: posts big blind $0.02
*** HOLE CARDS ***
Dealt to LLregs [7d Jd]
conspy84: folds
LLregs: folds
Sperick: raises $0.03 to $0.05
Fasteddie35: folds
WalkingDude19: folds
AAandanAA: calls $0.03
*** FLOP *** [6c Ts 9c]
AAandanAA: checks
Sperick: bets $0.06
AAandanAA: folds
Uncalled bet ($0.06) returned to Sperick
Sperick collected $0.11 from pot
Sperick: doesn't show hand
*** SUMMARY ***
Total pot $0.11 | Rake $0
Board [6c Ts 9c]
Seat 1: Fasteddie35 (button) folded before Flop (didn't bet)
Seat 2: WalkingDude19 (small blind) folded before Flop
Seat 3: AAandanAA (big blind) folded on the Flop
Seat 4: conspy84 folded before Flop (didn't bet)
Seat 5: LLregs folded before Flop (didn't bet)
Seat 6: Sperick collected ($0.11)

PokerStars Zoom Hand #247966024623:  Hold'em No Limit ($0.01/$0.02) - 2023/12/30 20:27:00 WET [2023/12/30 15:27:00 ET]
Table 'Halley' 6-max Seat #1 is the button
Seat 1: Dimoni797979 ($3.48 in chips)
Seat 2: misawo ($2.60 in chips)
Seat 3: roz534 ($1.88 in chips)
Seat 4: LLregs ($5.61 in chips)
Seat 5: JaUm_V ($8.10 in chips)
Seat 6: PR3SUR3 ($3.93 in chips)
misawo: posts small blind $0.01
roz534: posts big blind $0.02
*** HOLE CARDS ***
Dealt to LLregs [8d 6d]
LLregs has timed out
LLregs: folds
JaUm_V: raises $0.03 to $0.05
PR3SUR3: folds
Dimoni797979: folds
misawo: folds
roz534: folds
Uncalled bet ($0.03) returned to JaUm_V
JaUm_V collected $0.05 from pot
JaUm_V: doesn't show hand
*** SUMMARY ***
Total pot $0.05 | Rake $0
Seat 1: Dimoni797979 (button) folded before Flop (didn't bet)
Seat 2: misawo (small blind) folded before Flop
Seat 3: roz534 (big blind) folded before Flop
Seat 4: LLregs folded before Flop (didn't bet)
Seat 5: JaUm_V collected ($0.05)
Seat 6: PR3SUR3 folded before Flop (didn't bet)

PokerStars Zoom Hand #247967442884:  Hold'em No Limit ($0.01/$0.02) - 2023/12/30 21:28:25 WET [2023/12/30 16:28:25 ET]
Table 'Halley' 6-max Seat #1 is the button
Seat 1: ezequielgss ($1.12 in chips)
Seat 2: KixarN ($7.86 in chips)
Seat 3: LLregs ($5.61 in chips)
Seat 4: andre8276 ($2 in chips)
Seat 5: micdik ($1.14 in chips)
Seat 6: WalkingDude19 ($3.73 in chips)
KixarN: posts small blind $0.01
LLregs: posts big blind $0.02
*** HOLE CARDS ***
Dealt to LLregs [9s 2h]
andre8276: folds
micdik: folds
WalkingDude19: folds
ezequielgss: folds
KixarN: folds
Uncalled bet ($0.01) returned to LLregs
LLregs collected $0.02 from pot
LLregs: doesn't show hand
*** SUMMARY ***
Total pot $0.02 | Rake $0
Seat 1: ezequielgss (button) folded before Flop (didn't bet)
Seat 2: KixarN (small blind) folded before Flop
Seat 3: LLregs (big blind) collected ($0.02)
Seat 4: andre8276 folded before Flop (didn't bet)
Seat 5: micdik folded before Flop (didn't bet)
Seat 6: WalkingDude19 folded before Flop (didn't bet)

PokerStars Zoom Hand #247967446115:  Hold'em No Limit ($0.01/$0.02) - 2023/12/30 21:28:33 WET [2023/12/30 16:28:33 ET]
Table 'Halley' 6-max Seat #1 is the button
Seat 1: LLregs ($5.62 in chips)
Seat 2: Mamirox ($2.19 in chips)
Seat 3: Forever smile3 ($2.46 in chips)
Seat 4: ssk2000 ($5.46 in chips)
Seat 5: GFB1941 ($4.01 in chips)
Seat 6: ONIPIKA ($2.29 in chips)
Mamirox: posts small blind $0.01
Forever smile3: posts big blind $0.02
*** HOLE CARDS ***
Dealt to LLregs [Ks 6s]
ssk2000: folds
GFB1941: folds
ONIPIKA: folds
LLregs: raises $0.04 to $0.06
Mamirox: folds
Forever smile3: folds
Uncalled bet ($0.04) returned to LLregs
LLregs collected $0.05 from pot
LLregs: doesn't show hand
*** SUMMARY ***
Total pot $0.05 | Rake $0
Seat 1: LLregs (button) collected ($0.05)
Seat 2: Mamirox (small blind) folded before Flop
Seat 3: Forever smile3 (big blind) folded before Flop
Seat 4: ssk2000 folded before Flop (didn't bet)
Seat 5: GFB1941 folded before Flop (didn't bet)
Seat 6: ONIPIKA folded before Flop (didn't bet)

PokerStars Zoom Hand #247967481292:  Hold'em No Limit ($0.01/$0.02) - 2023/12/30 21:30:01 WET [2023/12/30 16:30:01 ET]
Table 'Halley' 6-max Seat #1 is the button
Seat 1: Ukr Troll ($2.41 in chips)
Seat 2: LLregs ($5.65 in chips)
Seat 3: Dspecial77 ($2.49 in chips)
Seat 4: SchmittNieto ($2 in chips)
Seat 5: NDX92 ($2.18 in chips)
Seat 6: andre8276 ($3.34 in chips)
LLregs: posts small blind $0.01
Dspecial77: posts big blind $0.02
*** HOLE CARDS ***
Dealt to LLregs [2s Td]
SchmittNieto: folds
NDX92: folds
andre8276: raises $0.04 to $0.06
Ukr Troll: calls $0.06
LLregs: folds
Dspecial77: folds
*** FLOP *** [3h Kd Kh]
andre8276: bets $0.07
Ukr Troll: folds
Uncalled bet ($0.07) returned to andre8276
andre8276 collected $0.14 from pot
andre8276: doesn't show hand
*** SUMMARY ***
Total pot $0.15 | Rake $0.01
Board [3h Kd Kh]
Seat 1: Ukr Troll (button) folded on the Flop
Seat 2: LLregs (small blind) folded before Flop
Seat 3: Dspecial77 (big blind) folded before Flop
Seat 4: SchmittNieto folded before Flop (didn't bet)
Seat 5: NDX92 folded before Flop (didn't bet)
Seat 6: andre8276 collected ($0.14)

PokerStars Zoom Hand #247967485321:  Hold'em No Limit ($0.01/$0.02) - 2023/12/30 21:30:11 WET [2023/12/30 16:30:11 ET]
Table 'Halley' 6-max Seat #1 is the button
Seat 1: ONIPIKA ($2.29 in chips)
Seat 2: diokyn ($1.98 in chips)
Seat 3: LLregs ($5.64 in chips)
Seat 4: ds_pearce2 ($2.14 in chips)
Seat 5: Tomoncrackk ($2.35 in chips)
Seat 6: kevindth ($2.74 in chips)
diokyn: posts small blind $0.01
LLregs: posts big blind $0.02
*** HOLE CARDS ***
Dealt to LLregs [2h 9d]
ds_pearce2: folds
Tomoncrackk: folds
kevindth: folds
ONIPIKA: raises $0.04 to $0.06
diokyn: folds
LLregs: folds
Uncalled bet ($0.04) returned to ONIPIKA
ONIPIKA collected $0.05 from pot
ONIPIKA: doesn't show hand
*** SUMMARY ***
Total pot $0.05 | Rake $0
Seat 1: ONIPIKA (button) collected ($0.05)
Seat 2: diokyn (small blind) folded before Flop
Seat 3: LLregs (big blind) folded before Flop
Seat 4: ds_pearce2 folded before Flop (didn't bet)
Seat 5: Tomoncrackk folded before Flop (didn't bet)
Seat 6: kevindth folded before Flop (didn't bet)

PokerStars Zoom Hand #247967483288:  Hold'em No Limit ($0.01/$0.02) - 2023/12/30 21:30:06 WET [2023/12/30 16:30:06 ET]
Table 'Halley' 6-max Seat #1 is the button
Seat 1: gepard35 ($5.46 in chips)
Seat 2: ONIPIKA ($2.55 in chips)
Seat 3: 5ars33r ($1.99 in chips)
Seat 4: K.Tyler111 ($2 in chips)
Seat 5: LLregs ($5.64 in chips)
Seat 6: 1857Dan ($1.75 in chips)
ONIPIKA: posts small blind $0.01
5ars33r: posts big blind $0.02
*** HOLE CARDS ***
Dealt to LLregs [Td 5d]
K.Tyler111: raises $0.04 to $0.06
LLregs: folds
1857Dan: raises $0.12 to $0.18
gepard35: folds
ONIPIKA: folds
5ars33r: folds
K.Tyler111: raises $0.47 to $0.65
1857Dan: raises $1.10 to $1.75 and is all-in
K.Tyler111: calls $1.10
*** FLOP *** [4h Ad Th]
*** TURN *** [4h Ad Th] [3h]
*** RIVER *** [4h Ad Th 3h] [Jh]
*** SHOW DOWN ***
K.Tyler111: shows [Qc Qd] (a pair of Queens)
1857Dan: shows [As Kc] (a pair of Aces)
1857Dan collected $3.41 from pot
*** SUMMARY ***
Total pot $3.53 | Rake $0.12
Board [4h Ad Th 3h Jh]
Seat 1: gepard35 (button) folded before Flop (didn't bet)
Seat 2: ONIPIKA (small blind) folded before Flop
Seat 3: 5ars33r (big blind) folded before Flop
Seat 4: K.Tyler111 showed [Qc Qd] and lost with a pair of Queens
Seat 5: LLregs folded before Flop (didn't bet)
Seat 6: 1857Dan showed [As Kc] and won ($3.41) with a pair of Aces

PokerStars Zoom Hand #247967490191:  Hold'em No Limit ($0.01/$0.02) - 2023/12/30 21:30:23 WET [2023/12/30 16:30:23 ET]
Table 'Halley' 6-max Seat #1 is the button
Seat 1: mikasafin ($2.63 in chips)
Seat 2: Bergländer ($2.16 in chips)
Seat 3: Ilikefossil ($2.91 in chips)
Seat 4: frankquanki ($1.05 in chips)
Seat 5: Yatesy82 ($1.06 in chips)
Seat 6: LLregs ($5.62 in chips)
Bergländer: posts small blind $0.01
Ilikefossil: posts big blind $0.02
*** HOLE CARDS ***
Dealt to LLregs [6c 7s]
frankquanki: folds
Yatesy82: folds
LLregs: folds
mikasafin: folds
Bergländer: calls $0.01
Ilikefossil: checks
*** FLOP *** [5s 9h 5d]
Bergländer: checks
Ilikefossil: checks
*** TURN *** [5s 9h 5d] [2h]
Bergländer: checks
Ilikefossil: bets $0.02
Bergländer: calls $0.02
*** RIVER *** [5s 9h 5d 2h] [4c]
Bergländer: checks
Ilikefossil: checks
*** SHOW DOWN ***
Bergländer: shows [Jd 8h] (a pair of Fives)
Ilikefossil: shows [Kh 2c] (two pair, Fives and Deuces)
Ilikefossil collected $0.08 from pot
*** SUMMARY ***
Total pot $0.08 | Rake $0
Board [5s 9h 5d 2h 4c]
Seat 1: mikasafin (button) folded before Flop (didn't bet)
Seat 2: Bergländer (small blind) showed [Jd 8h] and lost with a pair of Fives
Seat 3: Ilikefossil (big blind) showed [Kh 2c] and won ($0.08) with two pair, Fives and Deuces
Seat 4: frankquanki folded before Flop (didn't bet)
Seat 5: Yatesy82 folded before Flop (didn't bet)
Seat 6: LLregs folded before Flop (didn't bet)

PokerStars Zoom Hand #247967495267:  Hold'em No Limit ($0.01/$0.02) - 2023/12/30 21:30:36 WET [2023/12/30 16:30:36 ET]
Table 'Halley' 6-max Seat #1 is the button
Seat 1: MATIASdaKING32 ($3.88 in chips)
Seat 2: RefinedRisky ($1.94 in chips)
Seat 3: ds_pearce2 ($1.99 in chips)
Seat 4: my sapphire ($2 in chips)
Seat 5: Quorthon_Zei ($4.22 in chips)
Seat 6: LLregs ($5.62 in chips)
RefinedRisky: posts small blind $0.01
ds_pearce2: posts big blind $0.02
*** HOLE CARDS ***
Dealt to LLregs [5h 7d]
my sapphire: folds
Quorthon_Zei: folds
LLregs: folds
MATIASdaKING32: raises $0.02 to $0.04
RefinedRisky: calls $0.03
ds_pearce2: folds
*** FLOP *** [As Ah 7c]
RefinedRisky: bets $0.05
MATIASdaKING32: folds
Uncalled bet ($0.05) returned to RefinedRisky
RefinedRisky collected $0.10 from pot
RefinedRisky: doesn't show hand
*** SUMMARY ***
Total pot $0.10 | Rake $0
Board [As Ah 7c]
Seat 1: MATIASdaKING32 (button) folded on the Flop
Seat 2: RefinedRisky (small blind) collected ($0.10)
Seat 3: ds_pearce2 (big blind) folded before Flop
Seat 4: my sapphire folded before Flop (didn't bet)
Seat 5: Quorthon_Zei folded before Flop (didn't bet)
Seat 6: LLregs folded before Flop (didn't bet)

PokerStars Zoom Hand #247967497318:  Hold'em No Limit ($0.01/$0.02) - 2023/12/30 21:30:41 WET [2023/12/30 16:30:41 ET]
Table 'Halley' 6-max Seat #1 is the button
Seat 1: VvacheslavSV ($1.64 in chips)
Seat 2: LLregs ($5.62 in chips)
Seat 3: habbadadda2 ($2.66 in chips)
Seat 4: ssk2000 ($5.52 in chips)
Seat 5: HellBambi ($2.82 in chips)
Seat 6: Kotolen ($4.37 in chips)
LLregs: posts small blind $0.01
habbadadda2: posts big blind $0.02
*** HOLE CARDS ***
Dealt to LLregs [Qs Tc]
ssk2000: folds
HellBambi: raises $0.03 to $0.05
Kotolen: raises $0.13 to $0.18
VvacheslavSV: folds
LLregs: folds
habbadadda2: folds
HellBambi: folds
Uncalled bet ($0.13) returned to Kotolen
Kotolen collected $0.13 from pot
Kotolen: doesn't show hand
*** SUMMARY ***
Total pot $0.13 | Rake $0
Seat 1: VvacheslavSV (button) folded before Flop (didn't bet)
Seat 2: LLregs (small blind) folded before Flop
Seat 3: habbadadda2 (big blind) folded before Flop
Seat 4: ssk2000 folded before Flop (didn't bet)
Seat 5: HellBambi folded before Flop
Seat 6: Kotolen collected ($0.13)

PokerStars Zoom Hand #247967493194:  Hold'em No Limit ($0.01/$0.02) - 2023/12/30 21:30:31 WET [2023/12/30 16:30:31 ET]
Table 'Halley' 6-max Seat #1 is the button
Seat 1: twillage ($2.11 in chips)
Seat 2: andre8276 ($3.40 in chips)
Seat 3: jindjifill ($2.70 in chips)
Seat 4: LLregs ($5.62 in chips)
Seat 5: Giocrik ($1.92 in chips)
Seat 6: EwanHusahmi ($2.39 in chips)
andre8276: posts small blind $0.01
jindjifill: posts big blind $0.02
*** HOLE CARDS ***
Dealt to LLregs [7s 2h]
LLregs: folds
Giocrik: folds
EwanHusahmi: calls $0.02
twillage: folds
andre8276: calls $0.01
jindjifill: checks
*** FLOP *** [2c Th 4s]
andre8276: checks
jindjifill: checks
EwanHusahmi: checks
*** TURN *** [2c Th 4s] [Jc]
andre8276: checks
jindjifill: checks
EwanHusahmi: checks
*** RIVER *** [2c Th 4s Jc] [9d]
andre8276: checks
jindjifill: checks
EwanHusahmi: checks
*** SHOW DOWN ***
andre8276: shows [5h 4h] (a pair of Fours)
jindjifill: shows [Kd 9h] (a pair of Nines)
EwanHusahmi: shows [Ah 5s] (high card Ace)
jindjifill collected $0.06 from pot
*** SUMMARY ***
Total pot $0.06 | Rake $0
Board [2c Th 4s Jc 9d]
Seat 1: twillage (button) folded before Flop (didn't bet)
Seat 2: andre8276 (small blind) showed [5h 4h] and lost with a pair of Fours
Seat 3: jindjifill (big blind) showed [Kd 9h] and won ($0.06) with a pair of Nines
Seat 4: LLregs folded before Flop (didn't bet)
Seat 5: Giocrik folded before Flop (didn't bet)
Seat 6: EwanHusahmi showed [Ah 5s] and lost with high card Ace

PokerStars Zoom Hand #247967440470:  Hold'em No Limit ($0.01/$0.02) - 2023/12/30 21:28:19 WET [2023/12/30 16:28:19 ET]
Table 'Halley' 6-max Seat #1 is the button
Seat 1: gismouck ($2.07 in chips)
Seat 2: mtes272209 ($0.54 in chips)
Seat 3: KKAAbrnAAKK ($2.80 in chips)
Seat 4: LLregs ($5.61 in chips)
Seat 5: praznina ($1.78 in chips)
Seat 6: du.s.t.8o8 ($2.38 in chips)
mtes272209: posts small blind $0.01
KKAAbrnAAKK: posts big blind $0.02
*** HOLE CARDS ***
Dealt to LLregs [Jc Th]
LLregs: folds
praznina has timed out
praznina: folds
du.s.t.8o8: folds
gismouck: raises $0.03 to $0.05
mtes272209: calls $0.04
KKAAbrnAAKK: raises $0.13 to $0.18
gismouck: folds
mtes272209: calls $0.13
*** FLOP *** [5c Kh 5d]
mtes272209: checks
KKAAbrnAAKK: bets $0.12
mtes272209: raises $0.24 to $0.36 and is all-in
KKAAbrnAAKK is disconnected
KKAAbrnAAKK has timed out while disconnected
KKAAbrnAAKK: folds
Uncalled bet ($0.24) returned to mtes272209
mtes272209 collected $0.63 from pot
mtes272209: doesn't show hand
*** SUMMARY ***
Total pot $0.65 | Rake $0.02
Board [5c Kh 5d]
Seat 1: gismouck (button) folded before Flop
Seat 2: mtes272209 (small blind) collected ($0.63)
Seat 3: KKAAbrnAAKK (big blind) folded on the Flop
Seat 4: LLregs folded before Flop (didn't bet)
Seat 5: praznina folded before Flop (didn't bet)
Seat 6: du.s.t.8o8 folded before Flop (didn't bet)

PokerStars Zoom Hand #247967505924:  Hold'em No Limit ($0.01/$0.02) - 2023/12/30 21:31:03 WET [2023/12/30 16:31:03 ET]
Table 'Halley' 6-max Seat #1 is the button
Seat 1: LLregs ($5.61 in chips)
Seat 2: koinodoino ($1.88 in chips)
Seat 3: 888lifeIS ($2 in chips)
Seat 4: ChessMaster2002 ($4.07 in chips)
Seat 5: kakani78 ($2 in chips)
Seat 6: dcd113 ($1.94 in chips)
koinodoino: posts small blind $0.01
888lifeIS: posts big blind $0.02
*** HOLE CARDS ***
Dealt to LLregs [4h Ac]
ChessMaster2002: folds
kakani78: folds
dcd113: folds
LLregs: folds
koinodoino: raises $0.02 to $0.04
888lifeIS: folds
Uncalled bet ($0.02) returned to koinodoino
koinodoino collected $0.04 from pot
koinodoino: doesn't show hand
*** SUMMARY ***
Total pot $0.04 | Rake $0
Seat 1: LLregs (button) folded before Flop (didn't bet)
Seat 2: koinodoino (small blind) collected ($0.04)
Seat 3: 888lifeIS (big blind) folded before Flop
Seat 4: ChessMaster2002 folded before Flop (didn't bet)
Seat 5: kakani78 folded before Flop (didn't bet)
Seat 6: dcd113 folded before Flop (didn't bet)

PokerStars Zoom Hand #247967511071:  Hold'em No Limit ($0.01/$0.02) - 2023/12/30 21:31:16 WET [2023/12/30 16:31:16 ET]
Table 'Halley' 6-max Seat #1 is the button
Seat 1: emopokera ($1.91 in chips)
Seat 2: Lilica494 ($1.91 in chips)
Seat 3: bmrao ($2.06 in chips)
Seat 4: LLregs ($5.61 in chips)
Seat 5: ChessMaster2002 ($2 in chips)
Seat 6: greyman34940 ($2.45 in chips)
Lilica494: posts small blind $0.01
bmrao: posts big blind $0.02
*** HOLE CARDS ***
Dealt to LLregs [8c Ac]
LLregs: raises $0.04 to $0.06
ChessMaster2002: folds
greyman34940: folds
emopokera: folds
Lilica494: calls $0.05
bmrao: calls $0.04
*** FLOP *** [4c Qd 3d]
Lilica494: checks
bmrao: bets $0.09
LLregs: folds
Lilica494: folds
Uncalled bet ($0.09) returned to bmrao
bmrao collected $0.17 from pot
bmrao: doesn't show hand
*** SUMMARY ***
Total pot $0.18 | Rake $0.01
Board [4c Qd 3d]
Seat 1: emopokera (button) folded before Flop (didn't bet)
Seat 2: Lilica494 (small blind) folded on the Flop
Seat 3: bmrao (big blind) collected ($0.17)
Seat 4: LLregs folded on the Flop
Seat 5: ChessMaster2002 folded before Flop (didn't bet)
Seat 6: greyman34940 folded before Flop (didn't bet)

PokerStars Zoom Hand #247967522346:  Hold'em No Limit ($0.01/$0.02) - 2023/12/30 21:31:44 WET [2023/12/30 16:31:44 ET]
Table 'Halley' 6-max Seat #1 is the button
Seat 1: LLregs ($5.55 in chips)
Seat 2: wanderer7660 ($1.98 in chips)
Seat 3: Dspecial77 ($2.45 in chips)
Seat 4: ds_pearce2 ($1.97 in chips)
Seat 5: Kamylo20 ($3.12 in chips)
Seat 6: ialovenian ($1.88 in chips)
wanderer7660: posts small blind $0.01
Dspecial77: posts big blind $0.02
*** HOLE CARDS ***
Dealt to LLregs [7c 5c]
ds_pearce2: folds
Kamylo20: folds
ialovenian: folds
LLregs: folds
wanderer7660: raises $0.04 to $0.06
Dspecial77: folds
Uncalled bet ($0.04) returned to wanderer7660
wanderer7660 collected $0.04 from pot
wanderer7660: doesn't show hand
*** SUMMARY ***
Total pot $0.04 | Rake $0
Seat 1: LLregs (button) folded before Flop (didn't bet)
Seat 2: wanderer7660 (small blind) collected ($0.04)
Seat 3: Dspecial77 (big blind) folded before Flop
Seat 4: ds_pearce2 folded before Flop (didn't bet)
Seat 5: Kamylo20 folded before Flop (didn't bet)
Seat 6: ialovenian folded before Flop (didn't bet)

PokerStars Zoom Hand #247967531039:  Hold'em No Limit ($0.01/$0.02) - 2023/12/30 21:32:06 WET [2023/12/30 16:32:06 ET]
Table 'Halley' 6-max Seat #1 is the button
Seat 1: hybridi ($2.05 in chips)
Seat 2: mixi08 ($1.91 in chips)
Seat 3: LLregs ($5.55 in chips)
Seat 4: ssk2000 ($3.32 in chips)
Seat 5: zepatta ($2.28 in chips)
Seat 6: Limpingpolice ($1.93 in chips)
mixi08: posts small blind $0.01
LLregs: posts big blind $0.02
*** HOLE CARDS ***
Dealt to LLregs [8h 2s]
ssk2000: folds
zepatta: folds
Limpingpolice: raises $0.04 to $0.06
hybridi: folds
mixi08: folds
LLregs: folds
Uncalled bet ($0.04) returned to Limpingpolice
Limpingpolice collected $0.05 from pot
Limpingpolice: doesn't show hand
*** SUMMARY ***
Total pot $0.05 | Rake $0
Seat 1: hybridi (button) folded before Flop (didn't bet)
Seat 2: mixi08 (small blind) folded before Flop
Seat 3: LLregs (big blind) folded before Flop
Seat 4: ssk2000 folded before Flop (didn't bet)
Seat 5: zepatta folded before Flop (didn't bet)
Seat 6: Limpingpolice collected ($0.05)

PokerStars Zoom Hand #247967554818:  Hold'em No Limit ($0.01/$0.02) - 2023/12/30 21:33:06 WET [2023/12/30 16:33:06 ET]
Table 'Halley' 6-max Seat #1 is the button
Seat 1: Tomoncrackk ($5.42 in chips)
Seat 2: Pelucaa11 ($1 in chips)
Seat 3: GODMARS911 ($1.43 in chips)
Seat 4: LLregs ($5.52 in chips)
Seat 5: L4OTS8 ($2.19 in chips)
Seat 6: emopokera ($1.83 in chips)
Pelucaa11: posts small blind $0.01
GODMARS911: posts big blind $0.02
*** HOLE CARDS ***
Dealt to LLregs [Td 5h]
LLregs: folds
L4OTS8: folds
emopokera: folds
Tomoncrackk: folds
Pelucaa11: raises $0.02 to $0.04
GODMARS911: folds
Uncalled bet ($0.02) returned to Pelucaa11
Pelucaa11 collected $0.04 from pot
Pelucaa11: doesn't show hand
*** SUMMARY ***
Total pot $0.04 | Rake $0
Seat 1: Tomoncrackk (button) folded before Flop (didn't bet)
Seat 2: Pelucaa11 (small blind) collected ($0.04)
Seat 3: GODMARS911 (big blind) folded before Flop
Seat 4: LLregs folded before Flop (didn't bet)
Seat 5: L4OTS8 folded before Flop (didn't bet)
Seat 6: emopokera folded before Flop (didn't bet)

PokerStars Zoom Hand #247967544494:  Hold'em No Limit ($0.01/$0.02) - 2023/12/30 21:32:40 WET [2023/12/30 16:32:40 ET]
Table 'Halley' 6-max Seat #1 is the button
Seat 1: ds_pearce2 ($1.91 in chips)
Seat 2: LLregs ($5.53 in chips)
Seat 3: KUK015 ($1.61 in chips)
Seat 4: RTedeschi19 ($1.53 in chips)
Seat 5: wanderer7660 ($2.03 in chips)
Seat 6: McLaude669 ($1.54 in chips)
LLregs: posts small blind $0.01
KUK015: posts big blind $0.02
*** HOLE CARDS ***
Dealt to LLregs [Qh 5s]
RTedeschi19: folds
wanderer7660: folds
McLaude669: folds
ds_pearce2: raises $0.03 to $0.05
LLregs: folds
KUK015: calls $0.03
*** FLOP *** [Jh 6h 3d]
KUK015: checks
ds_pearce2: bets $0.06
KUK015: calls $0.06
*** TURN *** [Jh 6h 3d] [Kd]
KUK015: checks
ds_pearce2: bets $0.11
KUK015: folds
Uncalled bet ($0.11) returned to ds_pearce2
ds_pearce2 collected $0.22 from pot
ds_pearce2: doesn't show hand
*** SUMMARY ***
Total pot $0.23 | Rake $0.01
Board [Jh 6h 3d Kd]
Seat 1: ds_pearce2 (button) collected ($0.22)
Seat 2: LLregs (small blind) folded before Flop
Seat 3: KUK015 (big blind) folded on the Turn
Seat 4: RTedeschi19 folded before Flop (didn't bet)
Seat 5: wanderer7660 folded before Flop (didn't bet)
Seat 6: McLaude669 folded before Flop (didn't bet)

PokerStars Zoom Hand #247967556733:  Hold'em No Limit ($0.01/$0.02) - 2023/12/30 21:33:11 WET [2023/12/30 16:33:11 ET]
Table 'Halley' 6-max Seat #1 is the button
Seat 1: cachusky ($2.89 in chips)
Seat 2: habbadadda2 ($4.81 in chips)
Seat 3: marioleaoo ($3.99 in chips)
Seat 4: jesterka20 ($0.87 in chips)
Seat 5: despot17 ($2.05 in chips)
Seat 6: LLregs ($5.52 in chips)
habbadadda2: posts small blind $0.01
marioleaoo: posts big blind $0.02
*** HOLE CARDS ***
Dealt to LLregs [9d Ah]
jesterka20: folds
despot17: folds
LLregs: raises $0.04 to $0.06
cachusky: folds
habbadadda2: folds
marioleaoo: folds
Uncalled bet ($0.04) returned to LLregs
LLregs collected $0.05 from pot
LLregs: doesn't show hand
*** SUMMARY ***
Total pot $0.05 | Rake $0
Seat 1: cachusky (button) folded before Flop (didn't bet)
Seat 2: habbadadda2 (small blind) folded before Flop
Seat 3: marioleaoo (big blind) folded before Flop
Seat 4: jesterka20 folded before Flop (didn't bet)
Seat 5: despot17 folded before Flop (didn't bet)
Seat 6: LLregs collected ($0.05)

PokerStars Zoom Hand #247967549467:  Hold'em No Limit ($0.01/$0.02) - 2023/12/30 21:32:53 WET [2023/12/30 16:32:53 ET]
Table 'Halley' 6-max Seat #1 is the button
Seat 1: 888lifeIS ($2 in chips)
Seat 2: batya1212 ($2 in chips)
Seat 3: Dimoni797979 ($2.67 in chips)
Seat 4: greyman34940 ($2.79 in chips)
Seat 5: LLregs ($5.52 in chips)
Seat 6: WalkingDude19 ($5.12 in chips)
batya1212: posts small blind $0.01
Dimoni797979: posts big blind $0.02
*** HOLE CARDS ***
Dealt to LLregs [6s 2c]
greyman34940: folds
LLregs: folds
WalkingDude19: folds
888lifeIS: folds
batya1212: raises $0.05 to $0.07
Dimoni797979: calls $0.05
*** FLOP *** [7h Td 4h]
batya1212: checks
Dimoni797979: bets $0.07
batya1212: calls $0.07
*** TURN *** [7h Td 4h] [3h]
batya1212: checks
Dimoni797979: checks
*** RIVER *** [7h Td 4h 3h] [Jh]
batya1212: bets $0.02
Dimoni797979: calls $0.02
*** SHOW DOWN ***
batya1212: shows [Js Ad] (a pair of Jacks)
Dimoni797979: shows [9h 8c] (a flush, Jack high)
Dimoni797979 collected $0.31 from pot
*** SUMMARY ***
Total pot $0.32 | Rake $0.01
Board [7h Td 4h 3h Jh]
Seat 1: 888lifeIS (button) folded before Flop (didn't bet)
Seat 2: batya1212 (small blind) showed [Js Ad] and lost with a pair of Jacks
Seat 3: Dimoni797979 (big blind) showed [9h 8c] and won ($0.31) with a flush, Jack high
Seat 4: greyman34940 folded before Flop (didn't bet)
Seat 5: LLregs folded before Flop (didn't bet)
Seat 6: WalkingDude19 folded before Flop (didn't bet)

PokerStars Zoom Hand #247967564329:  Hold'em No Limit ($0.01/$0.02) - 2023/12/30 21:33:30 WET [2023/12/30 16:33:30 ET]
Table 'Halley' 6-max Seat #1 is the button
Seat 1: cjht1 ($1.85 in chips)
Seat 2: The hack ($2.03 in chips)
Seat 3: shavarun ($2.27 in chips)
Seat 4: LLregs ($5.55 in chips)
Seat 5: FlyingAm1sh ($2.21 in chips)
Seat 6: kasse112 ($5.14 in chips)
The hack: posts small blind $0.01
shavarun: posts big blind $0.02
*** HOLE CARDS ***
Dealt to LLregs [9h Jd]
LLregs: folds
FlyingAm1sh: folds
kasse112: folds
cjht1: folds
The hack: folds
Uncalled bet ($0.01) returned to shavarun
shavarun collected $0.02 from pot
shavarun: doesn't show hand
*** SUMMARY ***
Total pot $0.02 | Rake $0
Seat 1: cjht1 (button) folded before Flop (didn't bet)
Seat 2: The hack (small blind) folded before Flop
Seat 3: shavarun (big blind) collected ($0.02)
Seat 4: LLregs folded before Flop (didn't bet)
Seat 5: FlyingAm1sh folded before Flop (didn't bet)
Seat 6: kasse112 folded before Flop (didn't bet)

PokerStars Zoom Hand #247967571187:  Hold'em No Limit ($0.01/$0.02) - 2023/12/30 21:33:47 WET [2023/12/30 16:33:47 ET]
Table 'Halley' 6-max Seat #1 is the button
Seat 1: batya1212 ($2 in chips)
Seat 2: LLregs ($5.53 in chips)
Seat 3: bbttidr ($0.99 in chips)
Seat 4: HarryHaller77 ($2 in chips)
Seat 5: ds_pearce2 ($6.05 in chips)
Seat 6: panosarg88 ($2.03 in chips)
LLregs: posts small blind $0.01
bbttidr: posts big blind $0.02
*** HOLE CARDS ***
Dealt to LLregs [9d Jc]
HarryHaller77: folds
ds_pearce2: folds
panosarg88: folds
batya1212: folds
LLregs: raises $0.04 to $0.06
bbttidr: folds
Uncalled bet ($0.04) returned to LLregs
LLregs collected $0.04 from pot
LLregs: doesn't show hand
*** SUMMARY ***
Total pot $0.04 | Rake $0
Seat 1: batya1212 (button) folded before Flop (didn't bet)
Seat 2: LLregs (small blind) collected ($0.04)
Seat 3: bbttidr (big blind) folded before Flop
Seat 4: HarryHaller77 folded before Flop (didn't bet)
Seat 5: ds_pearce2 folded before Flop (didn't bet)
Seat 6: panosarg88 folded before Flop (didn't bet)

PokerStars Zoom Hand #247967566392:  Hold'em No Limit ($0.01/$0.02) - 2023/12/30 21:33:35 WET [2023/12/30 16:33:35 ET]
Table 'Halley' 6-max Seat #1 is the button
Seat 1: The hack ($2.02 in chips)
Seat 2: dmitriy2426 ($1.77 in chips)
Seat 3: LLregs ($5.55 in chips)
Seat 4: dragonJ250 ($5.39 in chips)
Seat 5: Touhy16 ($1.64 in chips)
Seat 6: Livio100 ($1.54 in chips)
dmitriy2426: posts small blind $0.01
LLregs: posts big blind $0.02
*** HOLE CARDS ***
Dealt to LLregs [3d 5h]
dragonJ250: folds
Touhy16: calls $0.02
Livio100: raises $0.02 to $0.04
The hack: folds
dmitriy2426: folds
LLregs: folds
Touhy16: calls $0.02
*** FLOP *** [Jc 6d Ac]
Touhy16: checks
Livio100: checks
*** TURN *** [Jc 6d Ac] [8c]
Touhy16: bets $0.02
Livio100: calls $0.02
*** RIVER *** [Jc 6d Ac 8c] [9s]
Touhy16: bets $0.02
Livio100: folds
Uncalled bet ($0.02) returned to Touhy16
Touhy16 collected $0.14 from pot
Touhy16: doesn't show hand
*** SUMMARY ***
Total pot $0.15 | Rake $0.01
Board [Jc 6d Ac 8c 9s]
Seat 1: The hack (button) folded before Flop (didn't bet)
Seat 2: dmitriy2426 (small blind) folded before Flop
Seat 3: LLregs (big blind) folded before Flop
Seat 4: dragonJ250 folded before Flop (didn't bet)
Seat 5: Touhy16 collected ($0.14)
Seat 6: Livio100 folded on the River

PokerStars Zoom Hand #247967579128:  Hold'em No Limit ($0.01/$0.02) - 2023/12/30 21:34:07 WET [2023/12/30 16:34:07 ET]
Table 'Halley' 6-max Seat #1 is the button
Seat 1: LLregs ($5.55 in chips)
Seat 2: my sapphire ($2.34 in chips)
Seat 3: Poccoon ($3.68 in chips)
Seat 4: karagua7 ($1.41 in chips)
Seat 5: pessimist53 ($0.73 in chips)
Seat 6: cjht1 ($1.67 in chips)
my sapphire: posts small blind $0.01
Poccoon: posts big blind $0.02
*** HOLE CARDS ***
Dealt to LLregs [As Qs]
karagua7: calls $0.02
pessimist53: folds
cjht1: folds
LLregs: raises $0.04 to $0.06
my sapphire: calls $0.05
Poccoon: folds
karagua7: calls $0.04
*** FLOP *** [Qd 3d Ts]
my sapphire: checks
karagua7: bets $0.06
LLregs: raises $0.12 to $0.18
my sapphire: folds
karagua7: calls $0.12
*** TURN *** [Qd 3d Ts] [2h]
karagua7: bets $0.06
LLregs: calls $0.06
*** RIVER *** [Qd 3d Ts 2h] [Js]
karagua7: bets $0.20
LLregs: calls $0.20
*** SHOW DOWN ***
karagua7: shows [Qc Tc] (two pair, Queens and Tens)
LLregs: mucks hand
karagua7 collected $1.04 from pot
*** SUMMARY ***
Total pot $1.08 | Rake $0.04
Board [Qd 3d Ts 2h Js]
Seat 1: LLregs (button) mucked [As Qs]
Seat 2: my sapphire (small blind) folded on the Flop
Seat 3: Poccoon (big blind) folded before Flop
Seat 4: karagua7 showed [Qc Tc] and won ($1.04) with two pair, Queens and Tens
Seat 5: pessimist53 folded before Flop (didn't bet)
Seat 6: cjht1 folded before Flop (didn't bet)

PokerStars Zoom Hand #247967618588:  Hold'em No Limit ($0.01/$0.02) - 2023/12/30 21:35:47 WET [2023/12/30 16:35:47 ET]
Table 'Halley' 6-max Seat #1 is the button
Seat 1: 07ijmando ($2.17 in chips)
Seat 2: MrZombieOO ($3.40 in chips)
Seat 3: crowfish.cz ($1.68 in chips)
Seat 4: Libin13 ($1.55 in chips)
Seat 5: batya1212 ($2.19 in chips)
Seat 6: LLregs ($5.05 in chips)
MrZombieOO: posts small blind $0.01
crowfish.cz: posts big blind $0.02
*** HOLE CARDS ***
Dealt to LLregs [As Qs]
Libin13: folds
batya1212: folds
LLregs: raises $0.04 to $0.06
07ijmando: folds
MrZombieOO: folds
crowfish.cz: folds
Uncalled bet ($0.04) returned to LLregs
LLregs collected $0.05 from pot
LLregs: doesn't show hand
*** SUMMARY ***
Total pot $0.05 | Rake $0
Seat 1: 07ijmando (button) folded before Flop (didn't bet)
Seat 2: MrZombieOO (small blind) folded before Flop
Seat 3: crowfish.cz (big blind) folded before Flop
Seat 4: Libin13 folded before Flop (didn't bet)
Seat 5: batya1212 folded before Flop (didn't bet)
Seat 6: LLregs collected ($0.05)

PokerStars Zoom Hand #247967630104:  Hold'em No Limit ($0.01/$0.02) - 2023/12/30 21:36:16 WET [2023/12/30 16:36:16 ET]
Table 'Halley' 6-max Seat #1 is the button
Seat 1: özi31 ($4.16 in chips)
Seat 2: jindjifill ($2.93 in chips)
Seat 3: Ilikefossil ($3.17 in chips)
Seat 4: micdik ($3.08 in chips)
Seat 5: LLregs ($5.08 in chips)
Seat 6: 888lifeIS ($2.44 in chips)
jindjifill: posts small blind $0.01
Ilikefossil: posts big blind $0.02
*** HOLE CARDS ***
Dealt to LLregs [6s 2d]
micdik: folds
LLregs: folds
888lifeIS: folds
özi31: folds
jindjifill: folds
Uncalled bet ($0.01) returned to Ilikefossil
Ilikefossil collected $0.02 from pot
Ilikefossil: doesn't show hand
*** SUMMARY ***
Total pot $0.02 | Rake $0
Seat 1: özi31 (button) folded before Flop (didn't bet)
Seat 2: jindjifill (small blind) folded before Flop
Seat 3: Ilikefossil (big blind) collected ($0.02)
Seat 4: micdik folded before Flop (didn't bet)
Seat 5: LLregs folded before Flop (didn't bet)
Seat 6: 888lifeIS folded before Flop (didn't bet)

PokerStars Zoom Hand #247967631963:  Hold'em No Limit ($0.01/$0.02) - 2023/12/30 21:36:21 WET [2023/12/30 16:36:21 ET]
Table 'Halley' 6-max Seat #1 is the button
Seat 1: isaeg ($2.74 in chips)
Seat 2: jesterka20 ($0.59 in chips)
Seat 3: LLregs ($5.08 in chips)
Seat 4: soldado47player ($1.59 in chips)
Seat 5: Clark_Kent_1991 ($0.89 in chips)
Seat 6: kohagyma ($3.30 in chips)
jesterka20: posts small blind $0.01
LLregs: posts big blind $0.02
*** HOLE CARDS ***
Dealt to LLregs [3h Kc]
soldado47player: folds
Clark_Kent_1991: folds
kohagyma: folds
isaeg: folds
jesterka20: folds
Uncalled bet ($0.01) returned to LLregs
LLregs collected $0.02 from pot
LLregs: doesn't show hand
*** SUMMARY ***
Total pot $0.02 | Rake $0
Seat 1: isaeg (button) folded before Flop (didn't bet)
Seat 2: jesterka20 (small blind) folded before Flop
Seat 3: LLregs (big blind) collected ($0.02)
Seat 4: soldado47player folded before Flop (didn't bet)
Seat 5: Clark_Kent_1991 folded before Flop (didn't bet)
Seat 6: kohagyma folded before Flop (didn't bet)

PokerStars Zoom Hand #247967625213:  Hold'em No Limit ($0.01/$0.02) - 2023/12/30 21:36:04 WET [2023/12/30 16:36:04 ET]
Table 'Halley' 6-max Seat #1 is the button
Seat 1: vomhof.F ($5.04 in chips)
Seat 2: Limpingpolice ($2.63 in chips)
Seat 3: drmtconner ($0.70 in chips)
Seat 4: fililipekk ($1.46 in chips)
Seat 5: LLregs ($5.08 in chips)
Seat 6: NDX92 ($2 in chips)
Limpingpolice: posts small blind $0.01
drmtconner: posts big blind $0.02
*** HOLE CARDS ***
Dealt to LLregs [7d Qs]
fililipekk: raises $0.06 to $0.08
LLregs: folds
NDX92: folds
vomhof.F: raises $0.12 to $0.20
Limpingpolice: folds
drmtconner: folds
fililipekk: raises $1.26 to $1.46 and is all-in
vomhof.F: calls $1.26
*** FLOP *** [4d 8h Ks]
*** TURN *** [4d 8h Ks] [2h]
*** RIVER *** [4d 8h Ks 2h] [9s]
*** SHOW DOWN ***
fililipekk: shows [Ts Js] (high card King)
vomhof.F: shows [Ad As] (a pair of Aces)
vomhof.F collected $2.85 from pot
*** SUMMARY ***
Total pot $2.95 | Rake $0.10
Board [4d 8h Ks 2h 9s]
Seat 1: vomhof.F (button) showed [Ad As] and won ($2.85) with a pair of Aces
Seat 2: Limpingpolice (small blind) folded before Flop
Seat 3: drmtconner (big blind) folded before Flop
Seat 4: fililipekk showed [Ts Js] and lost with high card King
Seat 5: LLregs folded before Flop (didn't bet)
Seat 6: NDX92 folded before Flop (didn't bet)

PokerStars Zoom Hand #247967635103:  Hold'em No Limit ($0.01/$0.02) - 2023/12/30 21:36:28 WET [2023/12/30 16:36:28 ET]
Table 'Halley' 6-max Seat #1 is the button
Seat 1: LLregs ($5.09 in chips)
Seat 2: ichithekill ($2 in chips)
Seat 3: e.r.i.c03030 ($1.93 in chips)
Seat 4: isaeg ($2.74 in chips)
Seat 5: hybridi ($4.32 in chips)
Seat 6: KUK015 ($0.07 in chips)
ichithekill: posts small blind $0.01
e.r.i.c03030: posts big blind $0.02
*** HOLE CARDS ***
Dealt to LLregs [5h Kc]
isaeg: folds
hybridi: folds
KUK015: raises $0.05 to $0.07 and is all-in
LLregs: folds
ichithekill: calls $0.06
e.r.i.c03030: calls $0.05
*** FLOP *** [Ks Tc 3h]
ichithekill: bets $0.07
e.r.i.c03030: calls $0.07
*** TURN *** [Ks Tc 3h] [6h]
ichithekill: bets $0.18
e.r.i.c03030: calls $0.18
*** RIVER *** [Ks Tc 3h 6h] [3s]
ichithekill: checks
e.r.i.c03030: checks
*** SHOW DOWN ***
ichithekill: shows [Qd Jd] (a pair of Threes)
e.r.i.c03030: shows [9h 9c] (two pair, Nines and Threes)
e.r.i.c03030 collected $0.49 from side pot
KUK015: mucks hand
e.r.i.c03030 collected $0.20 from main pot
*** SUMMARY ***
Total pot $0.71 Main pot $0.20. Side pot $0.49. | Rake $0.02
Board [Ks Tc 3h 6h 3s]
Seat 1: LLregs (button) folded before Flop (didn't bet)
Seat 2: ichithekill (small blind) showed [Qd Jd] and lost with a pair of Threes
Seat 3: e.r.i.c03030 (big blind) showed [9h 9c] and won ($0.69) with two pair, Nines and Threes
Seat 4: isaeg folded before Flop (didn't bet)
Seat 5: hybridi folded before Flop (didn't bet)
Seat 6: KUK015 mucked [6d Qc]

PokerStars Zoom Hand #247967638774:  Hold'em No Limit ($0.01/$0.02) - 2023/12/30 21:36:38 WET [2023/12/30 16:36:38 ET]
Table 'Halley' 6-max Seat #1 is the button
Seat 1: julle112 ($1.98 in chips)
Seat 2: marcio14 ($2 in chips)
Seat 3: dexzill ($1 in chips)
Seat 4: algorithmk9999 ($1.76 in chips)
Seat 5: sandrão71 ($0.51 in chips)
Seat 6: LLregs ($5.09 in chips)
marcio14: posts small blind $0.01
dexzill: posts big blind $0.02
*** HOLE CARDS ***
Dealt to LLregs [Ts Js]
algorithmk9999: folds
sandrão71: folds
LLregs: raises $0.04 to $0.06
julle112: folds
marcio14: folds
dexzill: calls $0.04
*** FLOP *** [8s Kc 4s]
dexzill: bets $0.04
LLregs: calls $0.04
*** TURN *** [8s Kc 4s] [3s]
dexzill: bets $0.10
LLregs: calls $0.10
*** RIVER *** [8s Kc 4s 3s] [5h]
dexzill: bets $0.20
LLregs: raises $4.69 to $4.89 and is all-in
dexzill: folds
Uncalled bet ($4.69) returned to LLregs
LLregs collected $0.78 from pot
LLregs: doesn't show hand
*** SUMMARY ***
Total pot $0.81 | Rake $0.03
Board [8s Kc 4s 3s 5h]
Seat 1: julle112 (button) folded before Flop (didn't bet)
Seat 2: marcio14 (small blind) folded before Flop
Seat 3: dexzill (big blind) folded on the River
Seat 4: algorithmk9999 folded before Flop (didn't bet)
Seat 5: sandrão71 folded before Flop (didn't bet)
Seat 6: LLregs collected ($0.78)

PokerStars Zoom Hand #247967650242:  Hold'em No Limit ($0.01/$0.02) - 2023/12/30 21:37:07 WET [2023/12/30 16:37:07 ET]
Table 'Halley' 6-max Seat #1 is the button
Seat 1: thasjengsta ($3.21 in chips)
Seat 2: LLregs ($5.47 in chips)
Seat 3: JanTee19 ($3.08 in chips)
Seat 4: cachusky ($2.77 in chips)
Seat 5: rrluis1930 ($2 in chips)
Seat 6: Limpingpolice ($2.04 in chips)
LLregs: posts small blind $0.01
JanTee19: posts big blind $0.02
*** HOLE CARDS ***
Dealt to LLregs [9d Tc]
cachusky: folds
rrluis1930: folds
Limpingpolice: folds
thasjengsta: raises $0.03 to $0.05
LLregs: folds
JanTee19: folds
Uncalled bet ($0.03) returned to thasjengsta
thasjengsta collected $0.05 from pot
thasjengsta: doesn't show hand
*** SUMMARY ***
Total pot $0.05 | Rake $0
Seat 1: thasjengsta (button) collected ($0.05)
Seat 2: LLregs (small blind) folded before Flop
Seat 3: JanTee19 (big blind) folded before Flop
Seat 4: cachusky folded before Flop (didn't bet)
Seat 5: rrluis1930 folded before Flop (didn't bet)
Seat 6: Limpingpolice folded before Flop (didn't bet)

PokerStars Zoom Hand #247967658113:  Hold'em No Limit ($0.01/$0.02) - 2023/12/30 21:37:27 WET [2023/12/30 16:37:27 ET]
Table 'Halley' 6-max Seat #1 is the button
Seat 1: habbadadda2 ($4.49 in chips)
Seat 2: frankquanki ($1.03 in chips)
Seat 3: LLregs ($5.46 in chips)
Seat 4: Luckman 53 ($1.50 in chips)
Seat 5: FlyingAm1sh ($2.05 in chips)
Seat 6: ZorroZoltan ($1.98 in chips)
frankquanki: posts small blind $0.01
LLregs: posts big blind $0.02
*** HOLE CARDS ***
Dealt to LLregs [Kh 4h]
Luckman 53: folds
FlyingAm1sh: folds
ZorroZoltan: folds
habbadadda2: raises $0.06 to $0.08
frankquanki: folds
LLregs: calls $0.06
*** FLOP *** [3c 4c Td]
LLregs: checks
habbadadda2: bets $0.10
LLregs: calls $0.10
*** TURN *** [3c 4c Td] [9h]
LLregs: checks
habbadadda2: bets $0.22
LLregs: folds
Uncalled bet ($0.22) returned to habbadadda2
habbadadda2 collected $0.36 from pot
habbadadda2: doesn't show hand
*** SUMMARY ***
Total pot $0.37 | Rake $0.01
Board [3c 4c Td 9h]
Seat 1: habbadadda2 (button) collected ($0.36)
Seat 2: frankquanki (small blind) folded before Flop
Seat 3: LLregs (big blind) folded on the Turn
Seat 4: Luckman 53 folded before Flop (didn't bet)
Seat 5: FlyingAm1sh folded before Flop (didn't bet)
Seat 6: ZorroZoltan folded before Flop (didn't bet)

PokerStars Zoom Hand #247967687535:  Hold'em No Limit ($0.01/$0.02) - 2023/12/30 21:38:41 WET [2023/12/30 16:38:41 ET]
Table 'Halley' 6-max Seat #1 is the button
Seat 1: Ukr Troll ($7.04 in chips)
Seat 2: GarotoMaroto#1 ($0.63 in chips)
Seat 3: 5ars33r ($1.93 in chips)
Seat 4: rrluis1930 ($2.05 in chips)
Seat 5: LLregs ($5.28 in chips)
Seat 6: Poccoon ($3.40 in chips)
GarotoMaroto#1: posts small blind $0.01
5ars33r: posts big blind $0.02
*** HOLE CARDS ***
Dealt to LLregs [4s Kd]
rrluis1930: folds
LLregs: folds
Poccoon: folds
Ukr Troll: folds
GarotoMaroto#1: folds
Uncalled bet ($0.01) returned to 5ars33r
5ars33r collected $0.02 from pot
5ars33r: doesn't show hand
*** SUMMARY ***
Total pot $0.02 | Rake $0
Seat 1: Ukr Troll (button) folded before Flop (didn't bet)
Seat 2: GarotoMaroto#1 (small blind) folded before Flop
Seat 3: 5ars33r (big blind) collected ($0.02)
Seat 4: rrluis1930 folded before Flop (didn't bet)
Seat 5: LLregs folded before Flop (didn't bet)
Seat 6: Poccoon folded before Flop (didn't bet)

PokerStars Zoom Hand #247967690673:  Hold'em No Limit ($0.01/$0.02) - 2023/12/30 21:38:49 WET [2023/12/30 16:38:49 ET]
Table 'Halley' 6-max Seat #1 is the button
Seat 1: LLregs ($5.28 in chips)
Seat 2: 888lifeIS ($2 in chips)
Seat 3: Dimoni797979 ($1.72 in chips)
Seat 4: andre8276 ($1.89 in chips)
Seat 5: JaUm_V ($5.02 in chips)
Seat 6: habbadadda2 ($2.89 in chips)
888lifeIS: posts small blind $0.01
Dimoni797979: posts big blind $0.02
*** HOLE CARDS ***
Dealt to LLregs [Qs 7d]
andre8276: folds
JaUm_V: folds
habbadadda2: folds
LLregs: folds
888lifeIS: raises $0.02 to $0.04
Dimoni797979: folds
Uncalled bet ($0.02) returned to 888lifeIS
888lifeIS collected $0.04 from pot
888lifeIS: doesn't show hand
*** SUMMARY ***
Total pot $0.04 | Rake $0
Seat 1: LLregs (button) folded before Flop (didn't bet)
Seat 2: 888lifeIS (small blind) collected ($0.04)
Seat 3: Dimoni797979 (big blind) folded before Flop
Seat 4: andre8276 folded before Flop (didn't bet)
Seat 5: JaUm_V folded before Flop (didn't bet)
Seat 6: habbadadda2 folded before Flop (didn't bet)

PokerStars Zoom Hand #247967689125:  Hold'em No Limit ($0.01/$0.02) - 2023/12/30 21:38:45 WET [2023/12/30 16:38:45 ET]
Table 'Halley' 6-max Seat #1 is the button
Seat 1: GODMARS911 ($1.38 in chips)
Seat 2: McLaude669 ($1.75 in chips)
Seat 3: Tha_Saint7 ($2 in chips)
Seat 4: LLregs ($5.28 in chips)
Seat 5: Lilica494 ($0.40 in chips)
Seat 6: kasse112 ($2.15 in chips)
McLaude669: posts small blind $0.01
Tha_Saint7: posts big blind $0.02
*** HOLE CARDS ***
Dealt to LLregs [8h 9c]
LLregs: folds
Lilica494: folds
kasse112: raises $0.04 to $0.06
GODMARS911: folds
McLaude669: calls $0.05
Tha_Saint7: folds
*** FLOP *** [Ts Jc 3c]
McLaude669: checks
kasse112: bets $0.08
McLaude669: folds
Uncalled bet ($0.08) returned to kasse112
kasse112 collected $0.14 from pot
kasse112: doesn't show hand
*** SUMMARY ***
Total pot $0.14 | Rake $0
Board [Ts Jc 3c]
Seat 1: GODMARS911 (button) folded before Flop (didn't bet)
Seat 2: McLaude669 (small blind) folded on the Flop
Seat 3: Tha_Saint7 (big blind) folded before Flop
Seat 4: LLregs folded before Flop (didn't bet)
Seat 5: Lilica494 folded before Flop (didn't bet)
Seat 6: kasse112 collected ($0.14)

PokerStars Zoom Hand #247967692218:  Hold'em No Limit ($0.01/$0.02) - 2023/12/30 21:38:53 WET [2023/12/30 16:38:53 ET]
Table 'Halley' 6-max Seat #1 is the button
Seat 1: ComePancito ($1.02 in chips)
Seat 2: ONIPIKA ($3 in chips)
Seat 3: Dovahkiin80 ($4.78 in chips)
Seat 4: conspy84 ($1.36 in chips)
Seat 5: LLregs ($5.28 in chips)
Seat 6: High Fumph ($1.78 in chips)
ONIPIKA: posts small blind $0.01
Dovahkiin80: posts big blind $0.02
*** HOLE CARDS ***
Dealt to LLregs [8h 3s]
conspy84: folds
LLregs: folds
High Fumph: folds
ComePancito: calls $0.02
ONIPIKA: folds
Dovahkiin80: raises $0.08 to $0.10
ComePancito: folds
Uncalled bet ($0.08) returned to Dovahkiin80
Dovahkiin80 collected $0.05 from pot
Dovahkiin80: doesn't show hand
*** SUMMARY ***
Total pot $0.05 | Rake $0
Seat 1: ComePancito (button) folded before Flop
Seat 2: ONIPIKA (small blind) folded before Flop
Seat 3: Dovahkiin80 (big blind) collected ($0.05)
Seat 4: conspy84 folded before Flop (didn't bet)
Seat 5: LLregs folded before Flop (didn't bet)
Seat 6: High Fumph folded before Flop (didn't bet)

PokerStars Zoom Hand #247967693465:  Hold'em No Limit ($0.01/$0.02) - 2023/12/30 21:38:56 WET [2023/12/30 16:38:56 ET]
Table 'Halley' 6-max Seat #1 is the button
Seat 1: greyman34940 ($2.71 in chips)
Seat 2: LLregs ($5.28 in chips)
Seat 3: TamiSieche ($2.64 in chips)
Seat 4: Bergländer ($1.67 in chips)
Seat 5: Tha_Saint7 ($2 in chips)
Seat 6: my sapphire ($1.95 in chips)
LLregs: posts small blind $0.01
TamiSieche: posts big blind $0.02
*** HOLE CARDS ***
Dealt to LLregs [Js 3h]
Bergländer: folds
Tha_Saint7: raises $0.04 to $0.06
my sapphire: calls $0.06
greyman34940: folds
LLregs: folds
TamiSieche: folds
*** FLOP *** [6s Td 8d]
Tha_Saint7: checks
my sapphire: checks
*** TURN *** [6s Td 8d] [3d]
Tha_Saint7: checks
my sapphire: checks
*** RIVER *** [6s Td 8d 3d] [5s]
Tha_Saint7: bets $0.04
my sapphire: folds
Uncalled bet ($0.04) returned to Tha_Saint7
Tha_Saint7 collected $0.14 from pot
Tha_Saint7: doesn't show hand
*** SUMMARY ***
Total pot $0.15 | Rake $0.01
Board [6s Td 8d 3d 5s]
Seat 1: greyman34940 (button) folded before Flop (didn't bet)
Seat 2: LLregs (small blind) folded before Flop
Seat 3: TamiSieche (big blind) folded before Flop
Seat 4: Bergländer folded before Flop (didn't bet)
Seat 5: Tha_Saint7 collected ($0.14)
Seat 6: my sapphire folded on the River

PokerStars Zoom Hand #247967700636:  Hold'em No Limit ($0.01/$0.02) - 2023/12/30 21:39:14 WET [2023/12/30 16:39:14 ET]
Table 'Halley' 6-max Seat #1 is the button
Seat 1: rrluis1930 ($4.86 in chips)
Seat 2: jwoww56 ($3.50 in chips)
Seat 3: söni78 ($3.55 in chips)
Seat 4: emopokera ($0.86 in chips)
Seat 5: Luiz_Ace ($4.42 in chips)
Seat 6: LLregs ($5.27 in chips)
jwoww56: posts small blind $0.01
söni78: posts big blind $0.02
*** HOLE CARDS ***
Dealt to LLregs [7d 9s]
emopokera: folds
Luiz_Ace: folds
LLregs: folds
rrluis1930: folds
jwoww56: calls $0.01
söni78: checks
*** FLOP *** [2h 8s Td]
jwoww56: checks
söni78: checks
*** TURN *** [2h 8s Td] [9h]
jwoww56: bets $0.02
söni78: folds
Uncalled bet ($0.02) returned to jwoww56
jwoww56 collected $0.04 from pot
jwoww56: doesn't show hand
*** SUMMARY ***
Total pot $0.04 | Rake $0
Board [2h 8s Td 9h]
Seat 1: rrluis1930 (button) folded before Flop (didn't bet)
Seat 2: jwoww56 (small blind) collected ($0.04)
Seat 3: söni78 (big blind) folded on the Turn
Seat 4: emopokera folded before Flop (didn't bet)
Seat 5: Luiz_Ace folded before Flop (didn't bet)
Seat 6: LLregs folded before Flop (didn't bet)

PokerStars Zoom Hand #247967701909:  Hold'em No Limit ($0.01/$0.02) - 2023/12/30 21:39:17 WET [2023/12/30 16:39:17 ET]
Table 'Halley' 6-max Seat #1 is the button
Seat 1: TamiSieche ($2.62 in chips)
Seat 2: özi31 ($3.38 in chips)
Seat 3: LLregs ($5.27 in chips)
Seat 4: graves80 ($2.61 in chips)
Seat 5: ChessMaster2002 ($5.26 in chips)
Seat 6: Giocrik ($2.50 in chips)
özi31: posts small blind $0.01
LLregs: posts big blind $0.02
*** HOLE CARDS ***
Dealt to LLregs [3h Jd]
graves80: folds
ChessMaster2002: folds
Giocrik: folds
TamiSieche: folds
özi31: raises $0.04 to $0.06
LLregs: calls $0.04
*** FLOP *** [Jh 4d Ah]
özi31: checks
LLregs: bets $0.06
özi31: calls $0.06
*** TURN *** [Jh 4d Ah] [7d]
özi31: checks
LLregs: bets $0.05
özi31: raises $0.05 to $0.10
LLregs: calls $0.05
*** RIVER *** [Jh 4d Ah 7d] [Qh]
özi31: bets $0.42
LLregs: folds
Uncalled bet ($0.42) returned to özi31
özi31 collected $0.42 from pot
özi31: doesn't show hand
*** SUMMARY ***
Total pot $0.44 | Rake $0.02
Board [Jh 4d Ah 7d Qh]
Seat 1: TamiSieche (button) folded before Flop (didn't bet)
Seat 2: özi31 (small blind) collected ($0.42)
Seat 3: LLregs (big blind) folded on the River
Seat 4: graves80 folded before Flop (didn't bet)
Seat 5: ChessMaster2002 folded before Flop (didn't bet)
Seat 6: Giocrik folded before Flop (didn't bet)

PokerStars Zoom Hand #247967724966:  Hold'em No Limit ($0.01/$0.02) - 2023/12/30 21:40:16 WET [2023/12/30 16:40:16 ET]
Table 'Halley' 6-max Seat #1 is the button
Seat 1: papakulikov ($1.97 in chips)
Seat 2: LLregs ($5.05 in chips)
Seat 3: Qcallteamz ($1 in chips)
Seat 4: RefinedRisky ($3.23 in chips)
Seat 5: kohagyma ($2.81 in chips)
Seat 6: Babettka ($1.93 in chips)
LLregs: posts small blind $0.01
Qcallteamz: posts big blind $0.02
*** HOLE CARDS ***
Dealt to LLregs [Jh 5c]
RefinedRisky: folds
kohagyma: folds
Babettka: folds
papakulikov: folds
LLregs: folds
Uncalled bet ($0.01) returned to Qcallteamz
Qcallteamz collected $0.02 from pot
Qcallteamz: doesn't show hand
*** SUMMARY ***
Total pot $0.02 | Rake $0
Seat 1: papakulikov (button) folded before Flop (didn't bet)
Seat 2: LLregs (small blind) folded before Flop
Seat 3: Qcallteamz (big blind) collected ($0.02)
Seat 4: RefinedRisky folded before Flop (didn't bet)
Seat 5: kohagyma folded before Flop (didn't bet)
Seat 6: Babettka folded before Flop (didn't bet)

PokerStars Zoom Hand #247967727560:  Hold'em No Limit ($0.01/$0.02) - 2023/12/30 21:40:22 WET [2023/12/30 16:40:22 ET]
Table 'Halley' 6-max Seat #1 is the button
Seat 1: jwoww56 ($3.15 in chips)
Seat 2: danRa120 ($1.11 in chips)
Seat 3: gone_fishing14 ($2.04 in chips)
Seat 4: dmitriy2426 ($2.28 in chips)
Seat 5: jindjifill ($3.23 in chips)
Seat 6: LLregs ($5.04 in chips)
danRa120: posts small blind $0.01
gone_fishing14: posts big blind $0.02
*** HOLE CARDS ***
Dealt to LLregs [8s 9c]
dmitriy2426: folds
jindjifill: folds
LLregs: folds
jwoww56: raises $0.04 to $0.06
danRa120: folds
gone_fishing14: folds
Uncalled bet ($0.04) returned to jwoww56
jwoww56 collected $0.05 from pot
jwoww56: doesn't show hand
*** SUMMARY ***
Total pot $0.05 | Rake $0
Seat 1: jwoww56 (button) collected ($0.05)
Seat 2: danRa120 (small blind) folded before Flop
Seat 3: gone_fishing14 (big blind) folded before Flop
Seat 4: dmitriy2426 folded before Flop (didn't bet)
Seat 5: jindjifill folded before Flop (didn't bet)
Seat 6: LLregs folded before Flop (didn't bet)

PokerStars Zoom Hand #247967729263:  Hold'em No Limit ($0.01/$0.02) - 2023/12/30 21:40:27 WET [2023/12/30 16:40:27 ET]
Table 'Halley' 6-max Seat #1 is the button
Seat 1: Dspecial77 ($2.12 in chips)
Seat 2: Its all Real ($2.01 in chips)
Seat 3: dmitriy2426 ($2.28 in chips)
Seat 4: LLregs ($5.04 in chips)
Seat 5: marcio14 ($2.37 in chips)
Seat 6: mellen00 ($2 in chips)
Its all Real: posts small blind $0.01
dmitriy2426: posts big blind $0.02
*** HOLE CARDS ***
Dealt to LLregs [Kd 2d]
LLregs: folds
marcio14: folds
mellen00: raises $0.04 to $0.06
Dspecial77: folds
Its all Real: folds
dmitriy2426: folds
Uncalled bet ($0.04) returned to mellen00
mellen00 collected $0.05 from pot
mellen00: doesn't show hand
*** SUMMARY ***
Total pot $0.05 | Rake $0
Seat 1: Dspecial77 (button) folded before Flop (didn't bet)
Seat 2: Its all Real (small blind) folded before Flop
Seat 3: dmitriy2426 (big blind) folded before Flop
Seat 4: LLregs folded before Flop (didn't bet)
Seat 5: marcio14 folded before Flop (didn't bet)
Seat 6: mellen00 collected ($0.05)

PokerStars Zoom Hand #247967723407:  Hold'em No Limit ($0.01/$0.02) - 2023/12/30 21:40:12 WET [2023/12/30 16:40:12 ET]
Table 'Halley' 6-max Seat #1 is the button
Seat 1: High Fumph ($3.91 in chips)
Seat 2: Babettka ($1.94 in chips)
Seat 3: CasardoCB ($2 in chips)
Seat 4: shavarun ($1.78 in chips)
Seat 5: LLregs ($5.05 in chips)
Seat 6: mtes272209 ($1.21 in chips)
Babettka: posts small blind $0.01
CasardoCB: posts big blind $0.02
*** HOLE CARDS ***
Dealt to LLregs [2h 5d]
shavarun: folds
LLregs: folds
mtes272209: calls $0.02
High Fumph: folds
Babettka: folds
CasardoCB: checks
*** FLOP *** [Kc Jc 9h]
CasardoCB: checks
mtes272209: checks
*** TURN *** [Kc Jc 9h] [Kh]
CasardoCB: checks
mtes272209: bets $0.05
CasardoCB: folds
Uncalled bet ($0.05) returned to mtes272209
mtes272209 collected $0.05 from pot
mtes272209: doesn't show hand
*** SUMMARY ***
Total pot $0.05 | Rake $0
Board [Kc Jc 9h Kh]
Seat 1: High Fumph (button) folded before Flop (didn't bet)
Seat 2: Babettka (small blind) folded before Flop
Seat 3: CasardoCB (big blind) folded on the Turn
Seat 4: shavarun folded before Flop (didn't bet)
Seat 5: LLregs folded before Flop (didn't bet)
Seat 6: mtes272209 collected ($0.05)

PokerStars Zoom Hand #247967732400:  Hold'em No Limit ($0.01/$0.02) - 2023/12/30 21:40:35 WET [2023/12/30 16:40:35 ET]
Table 'Halley' 6-max Seat #1 is the button
Seat 1: LLregs ($5.04 in chips)
Seat 2: dmitriy2426 ($2.26 in chips)
Seat 3: diokyn ($0.74 in chips)
Seat 4: jbarrios007 ($3.11 in chips)
Seat 5: Doctorkenz ($3.11 in chips)
Seat 6: ChessMaster2002 ($4.30 in chips)
dmitriy2426: posts small blind $0.01
diokyn: posts big blind $0.02
*** HOLE CARDS ***
Dealt to LLregs [Jc Tc]
jbarrios007: raises $0.04 to $0.06
Doctorkenz: folds
ChessMaster2002: folds
LLregs: calls $0.06
dmitriy2426: folds
diokyn: folds
*** FLOP *** [9d 2h 6h]
jbarrios007: bets $0.11
LLregs: folds
Uncalled bet ($0.11) returned to jbarrios007
jbarrios007 collected $0.14 from pot
jbarrios007: doesn't show hand
*** SUMMARY ***
Total pot $0.15 | Rake $0.01
Board [9d 2h 6h]
Seat 1: LLregs (button) folded on the Flop
Seat 2: dmitriy2426 (small blind) folded before Flop
Seat 3: diokyn (big blind) folded before Flop
Seat 4: jbarrios007 collected ($0.14)
Seat 5: Doctorkenz folded before Flop (didn't bet)
Seat 6: ChessMaster2002 folded before Flop (didn't bet)

PokerStars Zoom Hand #247967730815:  Hold'em No Limit ($0.01/$0.02) - 2023/12/30 21:40:31 WET [2023/12/30 16:40:31 ET]
Table 'Halley' 6-max Seat #1 is the button
Seat 1: Bergländer ($1.73 in chips)
Seat 2: CasardoCB ($1.98 in chips)
Seat 3: Loosax ($1.95 in chips)
Seat 4: LLregs ($5.04 in chips)
Seat 5: ErnieBel ($2 in chips)
Seat 6: Quantum771 ($2 in chips)
CasardoCB: posts small blind $0.01
Loosax: posts big blind $0.02
*** HOLE CARDS ***
Dealt to LLregs [6c 3c]
LLregs: folds
ErnieBel: folds
Quantum771: raises $0.03 to $0.05
Bergländer: calls $0.05
CasardoCB: folds
Loosax: folds
*** FLOP *** [3d Ts 7s]
Quantum771: bets $0.08
Bergländer: folds
Uncalled bet ($0.08) returned to Quantum771
Quantum771 collected $0.13 from pot
Quantum771: doesn't show hand
*** SUMMARY ***
Total pot $0.13 | Rake $0
Board [3d Ts 7s]
Seat 1: Bergländer (button) folded on the Flop
Seat 2: CasardoCB (small blind) folded before Flop
Seat 3: Loosax (big blind) folded before Flop
Seat 4: LLregs folded before Flop (didn't bet)
Seat 5: ErnieBel folded before Flop (didn't bet)
Seat 6: Quantum771 collected ($0.13)

PokerStars Zoom Hand #247967717395:  Hold'em No Limit ($0.01/$0.02) - 2023/12/30 21:39:56 WET [2023/12/30 16:39:56 ET]
Table 'Halley' 6-max Seat #1 is the button
Seat 1: LLregs ($5.05 in chips)
Seat 2: STAROVERchik ($1.02 in chips)
Seat 3: conspy84 ($1.36 in chips)
Seat 4: 1976 T ($0.85 in chips)
Seat 5: mikasafin ($2 in chips)
Seat 6: ira21gew ($2.35 in chips)
STAROVERchik: posts small blind $0.01
conspy84: posts big blind $0.02
*** HOLE CARDS ***
Dealt to LLregs [Kd 9h]
1976 T: calls $0.02
mikasafin: folds
ira21gew: calls $0.02
LLregs: folds
STAROVERchik: calls $0.01
conspy84: raises $0.06 to $0.08
1976 T: calls $0.06
ira21gew: calls $0.06
STAROVERchik: calls $0.06
*** FLOP *** [6c Qc Ts]
STAROVERchik: checks
conspy84: bets $0.04
1976 T: folds
ira21gew: calls $0.04
STAROVERchik: calls $0.04
*** TURN *** [6c Qc Ts] [Qh]
STAROVERchik: checks
conspy84: bets $0.04
ira21gew: folds
STAROVERchik: calls $0.04
*** RIVER *** [6c Qc Ts Qh] [7c]
STAROVERchik: checks
conspy84: bets $0.24
STAROVERchik: folds
Uncalled bet ($0.24) returned to conspy84
conspy84 collected $0.50 from pot
conspy84: doesn't show hand
*** SUMMARY ***
Total pot $0.52 | Rake $0.02
Board [6c Qc Ts Qh 7c]
Seat 1: LLregs (button) folded before Flop (didn't bet)
Seat 2: STAROVERchik (small blind) folded on the River
Seat 3: conspy84 (big blind) collected ($0.50)
Seat 4: 1976 T folded on the Flop
Seat 5: mikasafin folded before Flop (didn't bet)
Seat 6: ira21gew folded on the Turn

PokerStars Zoom Hand #247967739771:  Hold'em No Limit ($0.01/$0.02) - 2023/12/30 21:40:54 WET [2023/12/30 16:40:54 ET]
Table 'Halley' 6-max Seat #1 is the button
Seat 1: habbadadda2 ($4.61 in chips)
Seat 2: Kotolen ($4.02 in chips)
Seat 3: LLregs ($4.98 in chips)
Seat 4: monitl ($0.86 in chips)
Seat 5: Poccoon ($3.32 in chips)
Seat 6: freefrolloff ($1.91 in chips)
Kotolen: posts small blind $0.01
LLregs: posts big blind $0.02
*** HOLE CARDS ***
Dealt to LLregs [Qs 7s]
monitl: calls $0.02
Poccoon: folds
freefrolloff: folds
habbadadda2: folds
Kotolen: folds
LLregs: raises $0.04 to $0.06
monitl: calls $0.04
*** FLOP *** [9c 5s Ac]
LLregs: checks
monitl: bets $0.08
LLregs: folds
Uncalled bet ($0.08) returned to monitl
monitl collected $0.13 from pot
monitl: doesn't show hand
*** SUMMARY ***
Total pot $0.13 | Rake $0
Board [9c 5s Ac]
Seat 1: habbadadda2 (button) folded before Flop (didn't bet)
Seat 2: Kotolen (small blind) folded before Flop
Seat 3: LLregs (big blind) folded on the Flop
Seat 4: monitl collected ($0.13)
Seat 5: Poccoon folded before Flop (didn't bet)
Seat 6: freefrolloff folded before Flop (didn't bet)

PokerStars Zoom Hand #247967754260:  Hold'em No Limit ($0.01/$0.02) - 2023/12/30 21:41:31 WET [2023/12/30 16:41:31 ET]
Table 'Halley' 6-max Seat #1 is the button
Seat 1: diokyn ($3.79 in chips)
Seat 2: LLregs ($4.92 in chips)
Seat 3: ira21gew ($2.11 in chips)
Seat 4: Cifuli ($4.90 in chips)
Seat 5: dealmekkplease ($2.01 in chips)
Seat 6: milliekenton ($1.50 in chips)
LLregs: posts small blind $0.01
ira21gew: posts big blind $0.02
*** HOLE CARDS ***
Dealt to LLregs [4h 6c]
Cifuli: folds
dealmekkplease: folds
milliekenton: folds
diokyn: folds
LLregs: folds
Uncalled bet ($0.01) returned to ira21gew
ira21gew collected $0.02 from pot
ira21gew: doesn't show hand
*** SUMMARY ***
Total pot $0.02 | Rake $0
Seat 1: diokyn (button) folded before Flop (didn't bet)
Seat 2: LLregs (small blind) folded before Flop
Seat 3: ira21gew (big blind) collected ($0.02)
Seat 4: Cifuli folded before Flop (didn't bet)
Seat 5: dealmekkplease folded before Flop (didn't bet)
Seat 6: milliekenton folded before Flop (didn't bet)

PokerStars Zoom Hand #247967753195:  Hold'em No Limit ($0.01/$0.02) - 2023/12/30 21:41:28 WET [2023/12/30 16:41:28 ET]
Table 'Halley' 6-max Seat #1 is the button
Seat 1: dealmekkplease ($2.01 in chips)
Seat 2: Tomoncrackk ($2.72 in chips)
Seat 3: vitalikto ($3.19 in chips)
Seat 4: The hack ($2.31 in chips)
Seat 5: CasardoCB ($1.96 in chips)
Seat 6: LLregs ($4.92 in chips)
Tomoncrackk: posts small blind $0.01
vitalikto: posts big blind $0.02
*** HOLE CARDS ***
Dealt to LLregs [Jc 9d]
The hack: folds
CasardoCB: raises $0.03 to $0.05
LLregs: folds
dealmekkplease: folds
Tomoncrackk: folds
vitalikto: calls $0.03
*** FLOP *** [As Qc Kh]
vitalikto: checks
CasardoCB: checks
*** TURN *** [As Qc Kh] [4h]
vitalikto: bets $0.06
CasardoCB: folds
Uncalled bet ($0.06) returned to vitalikto
vitalikto collected $0.11 from pot
vitalikto: doesn't show hand
*** SUMMARY ***
Total pot $0.11 | Rake $0
Board [As Qc Kh 4h]
Seat 1: dealmekkplease (button) folded before Flop (didn't bet)
Seat 2: Tomoncrackk (small blind) folded before Flop
Seat 3: vitalikto (big blind) collected ($0.11)
Seat 4: The hack folded before Flop (didn't bet)
Seat 5: CasardoCB folded on the Turn
Seat 6: LLregs folded before Flop (didn't bet)

PokerStars Zoom Hand #247967757603:  Hold'em No Limit ($0.01/$0.02) - 2023/12/30 21:41:40 WET [2023/12/30 16:41:40 ET]
Table 'Halley' 6-max Seat #1 is the button
Seat 1: Molineux2002 ($1.81 in chips)
Seat 2: andre8276 ($1.76 in chips)
Seat 3: JuanChu070 ($4.08 in chips)
Seat 4: TOP_XD ($0.82 in chips)
Seat 5: LLregs ($4.91 in chips)
Seat 6: bandini111 ($5.41 in chips)
andre8276: posts small blind $0.01
JuanChu070: posts big blind $0.02
*** HOLE CARDS ***
Dealt to LLregs [3s 3c]
TOP_XD: folds
LLregs: raises $0.04 to $0.06
bandini111: folds
Molineux2002: folds
andre8276: folds
JuanChu070: folds
Uncalled bet ($0.04) returned to LLregs
LLregs collected $0.05 from pot
LLregs: doesn't show hand
*** SUMMARY ***
Total pot $0.05 | Rake $0
Seat 1: Molineux2002 (button) folded before Flop (didn't bet)
Seat 2: andre8276 (small blind) folded before Flop
Seat 3: JuanChu070 (big blind) folded before Flop
Seat 4: TOP_XD folded before Flop (didn't bet)
Seat 5: LLregs collected ($0.05)
Seat 6: bandini111 folded before Flop (didn't bet)

PokerStars Zoom Hand #247967764621:  Hold'em No Limit ($0.01/$0.02) - 2023/12/30 21:41:58 WET [2023/12/30 16:41:58 ET]
Table 'Halley' 6-max Seat #1 is the button
Seat 1: LLregs ($4.94 in chips)
Seat 2: Dimoni797979 ($3.79 in chips)
Seat 3: dmitriy2426 ($2.16 in chips)
Seat 4: placebo1970 ($0.49 in chips)
Seat 5: artificialchaos ($4.46 in chips)
Seat 6: cc_midel ($2.42 in chips)
Dimoni797979: posts small blind $0.01
dmitriy2426: posts big blind $0.02
*** HOLE CARDS ***
Dealt to LLregs [Th Qd]
placebo1970: folds
artificialchaos: folds
cc_midel: folds
LLregs: raises $0.04 to $0.06
Dimoni797979: folds
dmitriy2426: folds
Uncalled bet ($0.04) returned to LLregs
LLregs collected $0.05 from pot
LLregs: doesn't show hand
*** SUMMARY ***
Total pot $0.05 | Rake $0
Seat 1: LLregs (button) collected ($0.05)
Seat 2: Dimoni797979 (small blind) folded before Flop
Seat 3: dmitriy2426 (big blind) folded before Flop
Seat 4: placebo1970 folded before Flop (didn't bet)
Seat 5: artificialchaos folded before Flop (didn't bet)
Seat 6: cc_midel folded before Flop (didn't bet)

PokerStars Zoom Hand #247967769370:  Hold'em No Limit ($0.01/$0.02) - 2023/12/30 21:42:10 WET [2023/12/30 16:42:10 ET]
Table 'Halley' 6-max Seat #1 is the button
Seat 1: Dimoni797979 ($1.44 in chips)
Seat 2: NineHi72 ($5.44 in chips)
Seat 3: LLregs ($4.97 in chips)
Seat 4: Bumbidu ($0.40 in chips)
Seat 5: naruhoka ($2.07 in chips)
Seat 6: gismouck ($2.09 in chips)
NineHi72: posts small blind $0.01
LLregs: posts big blind $0.02
*** HOLE CARDS ***
Dealt to LLregs [Ks 5c]
Bumbidu: folds
naruhoka: folds
gismouck: folds
Dimoni797979: raises $0.02 to $0.04
NineHi72: folds
LLregs: folds
Uncalled bet ($0.02) returned to Dimoni797979
Dimoni797979 collected $0.05 from pot
Dimoni797979: doesn't show hand
*** SUMMARY ***
Total pot $0.05 | Rake $0
Seat 1: Dimoni797979 (button) collected ($0.05)
Seat 2: NineHi72 (small blind) folded before Flop
Seat 3: LLregs (big blind) folded before Flop
Seat 4: Bumbidu folded before Flop (didn't bet)
Seat 5: naruhoka folded before Flop (didn't bet)
Seat 6: gismouck folded before Flop (didn't bet)

PokerStars Zoom Hand #247967777852:  Hold'em No Limit ($0.01/$0.02) - 2023/12/30 21:42:31 WET [2023/12/30 16:42:31 ET]
Table 'Halley' 6-max Seat #1 is the button
Seat 1: TamiSieche ($2.44 in chips)
Seat 2: conspy84 ($2.62 in chips)
Seat 3: Quantum771 ($2 in chips)
Seat 4: evgeshona85 ($0.93 in chips)
Seat 5: LLregs ($4.95 in chips)
Seat 6: reidy0102 ($2.81 in chips)
conspy84: posts small blind $0.01
Quantum771: posts big blind $0.02
*** HOLE CARDS ***
Dealt to LLregs [As 6c]
evgeshona85: folds
LLregs: folds
reidy0102: folds
TamiSieche: folds
conspy84: folds
Uncalled bet ($0.01) returned to Quantum771
Quantum771 collected $0.02 from pot
Quantum771: doesn't show hand
*** SUMMARY ***
Total pot $0.02 | Rake $0
Seat 1: TamiSieche (button) folded before Flop (didn't bet)
Seat 2: conspy84 (small blind) folded before Flop
Seat 3: Quantum771 (big blind) collected ($0.02)
Seat 4: evgeshona85 folded before Flop (didn't bet)
Seat 5: LLregs folded before Flop (didn't bet)
Seat 6: reidy0102 folded before Flop (didn't bet)

PokerStars Zoom Hand #247967780369:  Hold'em No Limit ($0.01/$0.02) - 2023/12/30 21:42:38 WET [2023/12/30 16:42:38 ET]
Table 'Halley' 6-max Seat #1 is the button
Seat 1: Giocrik ($2.31 in chips)
Seat 2: LLregs ($4.95 in chips)
Seat 3: Bigirii ($2 in chips)
Seat 4: Gaigel ($2.03 in chips)
Seat 5: agaru11177 ($1.98 in chips)
Seat 6: JaUm_V ($7.58 in chips)
LLregs: posts small blind $0.01
Bigirii: posts big blind $0.02
*** HOLE CARDS ***
Dealt to LLregs [5s Ac]
Gaigel: folds
agaru11177: folds
JaUm_V: folds
Giocrik: folds
LLregs: raises $0.04 to $0.06
Bigirii: calls $0.04
*** FLOP *** [Qd 9d Jc]
LLregs: checks
Bigirii: bets $0.12
LLregs: folds
Uncalled bet ($0.12) returned to Bigirii
Bigirii collected $0.12 from pot
Bigirii: doesn't show hand
*** SUMMARY ***
Total pot $0.12 | Rake $0
Board [Qd 9d Jc]
Seat 1: Giocrik (button) folded before Flop (didn't bet)
Seat 2: LLregs (small blind) folded on the Flop
Seat 3: Bigirii (big blind) collected ($0.12)
Seat 4: Gaigel folded before Flop (didn't bet)
Seat 5: agaru11177 folded before Flop (didn't bet)
Seat 6: JaUm_V folded before Flop (didn't bet)

PokerStars Zoom Hand #247967791993:  Hold'em No Limit ($0.01/$0.02) - 2023/12/30 21:43:07 WET [2023/12/30 16:43:07 ET]
Table 'Halley' 6-max Seat #1 is the button
Seat 1: kasse112 ($5.15 in chips)
Seat 2: IanMacDaddy ($2.03 in chips)
Seat 3: pessimist53 ($0.88 in chips)
Seat 4: LLregs ($4.89 in chips)
Seat 5: kingdieter1 ($2.06 in chips)
Seat 6: Cifuli ($4.73 in chips)
IanMacDaddy: posts small blind $0.01
pessimist53: posts big blind $0.02
*** HOLE CARDS ***
Dealt to LLregs [5s Qs]
LLregs: folds
kingdieter1: folds
Cifuli: calls $0.02
kasse112: folds
IanMacDaddy: folds
pessimist53: checks
*** FLOP *** [8h Kh 8c]
pessimist53: checks
Cifuli: bets $0.02
pessimist53: folds
Uncalled bet ($0.02) returned to Cifuli
Cifuli collected $0.05 from pot
Cifuli: doesn't show hand
*** SUMMARY ***
Total pot $0.05 | Rake $0
Board [8h Kh 8c]
Seat 1: kasse112 (button) folded before Flop (didn't bet)
Seat 2: IanMacDaddy (small blind) folded before Flop
Seat 3: pessimist53 (big blind) folded on the Flop
Seat 4: LLregs folded before Flop (didn't bet)
Seat 5: kingdieter1 folded before Flop (didn't bet)
Seat 6: Cifuli collected ($0.05)

PokerStars Zoom Hand #247967776463:  Hold'em No Limit ($0.01/$0.02) - 2023/12/30 21:42:28 WET [2023/12/30 16:42:28 ET]
Table 'Halley' 6-max Seat #1 is the button
Seat 1: söni78 ($3.57 in chips)
Seat 2: FlyingAm1sh ($2.03 in chips)
Seat 3: agaru11177 ($2 in chips)
Seat 4: Odysseia ($5.50 in chips)
Seat 5: Xabitpoker ($1.61 in chips)
Seat 6: LLregs ($4.95 in chips)
FlyingAm1sh: posts small blind $0.01
agaru11177: posts big blind $0.02
*** HOLE CARDS ***
Dealt to LLregs [6h 8d]
Odysseia: folds
Xabitpoker: folds
LLregs: folds
söni78: raises $0.02 to $0.04
FlyingAm1sh: raises $0.14 to $0.18
agaru11177: folds
söni78: calls $0.14
*** FLOP *** [9s Jh 6s]
FlyingAm1sh: bets $0.12
söni78: calls $0.12
*** TURN *** [9s Jh 6s] [8s]
FlyingAm1sh: checks
söni78: bets $0.30
FlyingAm1sh: calls $0.30
*** RIVER *** [9s Jh 6s 8s] [8c]
FlyingAm1sh: checks
söni78: checks
*** SHOW DOWN ***
FlyingAm1sh: shows [Qd Td] (a straight, Eight to Queen)
söni78: mucks hand
FlyingAm1sh collected $1.18 from pot
*** SUMMARY ***
Total pot $1.22 | Rake $0.04
Board [9s Jh 6s 8s 8c]
Seat 1: söni78 (button) mucked [Js Ad]
Seat 2: FlyingAm1sh (small blind) showed [Qd Td] and won ($1.18) with a straight, Eight to Queen
Seat 3: agaru11177 (big blind) folded before Flop
Seat 4: Odysseia folded before Flop (didn't bet)
Seat 5: Xabitpoker folded before Flop (didn't bet)
Seat 6: LLregs folded before Flop (didn't bet)

PokerStars Zoom Hand #247967798287:  Hold'em No Limit ($0.01/$0.02) - 2023/12/30 21:43:24 WET [2023/12/30 16:43:24 ET]
Table 'Halley' 6-max Seat #1 is the button
Seat 1: LLregs ($4.87 in chips)
Seat 2: my sapphire ($0.96 in chips)
Seat 3: shovetoi ($2.71 in chips)
Seat 4: jbarrios007 ($3.22 in chips)
Seat 5: igrok$148 ($1.06 in chips)
Seat 6: arkins00 ($2.05 in chips)
my sapphire: posts small blind $0.01
shovetoi: posts big blind $0.02
*** HOLE CARDS ***
Dealt to LLregs [8s 5c]
jbarrios007: folds
igrok$148: folds
arkins00: folds
LLregs: folds
my sapphire: folds
Uncalled bet ($0.01) returned to shovetoi
shovetoi collected $0.02 from pot
shovetoi: doesn't show hand
*** SUMMARY ***
Total pot $0.02 | Rake $0
Seat 1: LLregs (button) folded before Flop (didn't bet)
Seat 2: my sapphire (small blind) folded before Flop
Seat 3: shovetoi (big blind) collected ($0.02)
Seat 4: jbarrios007 folded before Flop (didn't bet)
Seat 5: igrok$148 folded before Flop (didn't bet)
Seat 6: arkins00 folded before Flop (didn't bet)

PokerStars Zoom Hand #247967800221:  Hold'em No Limit ($0.01/$0.02) - 2023/12/30 21:43:29 WET [2023/12/30 16:43:29 ET]
Table 'Halley' 6-max Seat #1 is the button
Seat 1: pessimist53 ($0.86 in chips)
Seat 2: marioleaoo ($4.48 in chips)
Seat 3: thasjengsta ($2.17 in chips)
Seat 4: emopokera ($0.83 in chips)
Seat 5: Kotolen ($4.19 in chips)
Seat 6: LLregs ($4.87 in chips)
marioleaoo: posts small blind $0.01
thasjengsta: posts big blind $0.02
*** HOLE CARDS ***
Dealt to LLregs [4d Kc]
emopokera: folds
Kotolen: folds
LLregs: folds
pessimist53: folds
marioleaoo: folds
Uncalled bet ($0.01) returned to thasjengsta
thasjengsta collected $0.02 from pot
thasjengsta: doesn't show hand
*** SUMMARY ***
Total pot $0.02 | Rake $0
Seat 1: pessimist53 (button) folded before Flop (didn't bet)
Seat 2: marioleaoo (small blind) folded before Flop
Seat 3: thasjengsta (big blind) collected ($0.02)
Seat 4: emopokera folded before Flop (didn't bet)
Seat 5: Kotolen folded before Flop (didn't bet)
Seat 6: LLregs folded before Flop (didn't bet)

PokerStars Zoom Hand #247967779201:  Hold'em No Limit ($0.01/$0.02) - 2023/12/30 21:42:35 WET [2023/12/30 16:42:35 ET]
Table 'Halley' 6-max Seat #1 is the button
Seat 1: NineHi72 ($5.44 in chips)
Seat 2: bbttidr ($0.48 in chips)
Seat 3: JaUm_V ($4.99 in chips)
Seat 4: LLregs ($4.95 in chips)
Seat 5: danielito577 ($0.84 in chips)
Seat 6: artificialchaos ($4.43 in chips)
bbttidr: posts small blind $0.01
JaUm_V: posts big blind $0.02
*** HOLE CARDS ***
Dealt to LLregs [3c 6h]
LLregs: folds
danielito577: raises $0.04 to $0.06
artificialchaos: folds
NineHi72: raises $0.10 to $0.16
bbttidr: folds
JaUm_V: folds
danielito577: calls $0.10
*** FLOP *** [6s 3d 7d]
danielito577: checks
NineHi72: bets $0.08
danielito577: calls $0.08
*** TURN *** [6s 3d 7d] [9c]
danielito577: checks
NineHi72: bets $0.12
danielito577: calls $0.12
*** RIVER *** [6s 3d 7d 9c] [6c]
danielito577: checks
NineHi72: bets $0.48
danielito577: folds
Uncalled bet ($0.48) returned to NineHi72
NineHi72 collected $0.71 from pot
NineHi72: doesn't show hand
*** SUMMARY ***
Total pot $0.75 | Rake $0.04
Board [6s 3d 7d 9c 6c]
Seat 1: NineHi72 (button) collected ($0.71)
Seat 2: bbttidr (small blind) folded before Flop
Seat 3: JaUm_V (big blind) folded before Flop
Seat 4: LLregs folded before Flop (didn't bet)
Seat 5: danielito577 folded on the River
Seat 6: artificialchaos folded before Flop (didn't bet)

PokerStars Zoom Hand #247967802139:  Hold'em No Limit ($0.01/$0.02) - 2023/12/30 21:43:34 WET [2023/12/30 16:43:34 ET]
Table 'Halley' 6-max Seat #1 is the button
Seat 1: my sapphire ($1.02 in chips)
Seat 2: LLregs ($4.87 in chips)
Seat 3: marioleaoo ($4.47 in chips)
Seat 4: Qcallteamz ($0.89 in chips)
Seat 5: JanTee19 ($2 in chips)
Seat 6: JaUm_V ($8.50 in chips)
LLregs: posts small blind $0.01
marioleaoo: posts big blind $0.02
*** HOLE CARDS ***
Dealt to LLregs [2s 3d]
Qcallteamz: folds
JanTee19: folds
JaUm_V: raises $0.03 to $0.05
my sapphire: folds
LLregs: folds
marioleaoo: folds
Uncalled bet ($0.03) returned to JaUm_V
JaUm_V collected $0.05 from pot
JaUm_V: doesn't show hand
*** SUMMARY ***
Total pot $0.05 | Rake $0
Seat 1: my sapphire (button) folded before Flop (didn't bet)
Seat 2: LLregs (small blind) folded before Flop
Seat 3: marioleaoo (big blind) folded before Flop
Seat 4: Qcallteamz folded before Flop (didn't bet)
Seat 5: JanTee19 folded before Flop (didn't bet)
Seat 6: JaUm_V collected ($0.05)

PokerStars Zoom Hand #247967793461:  Hold'em No Limit ($0.01/$0.02) - 2023/12/30 21:43:11 WET [2023/12/30 16:43:11 ET]
Table 'Halley' 6-max Seat #1 is the button
Seat 1: Pere Ubu ($1.34 in chips)
Seat 2: ChessMaster2002 ($2.70 in chips)
Seat 3: LLregs ($4.89 in chips)
Seat 4: gone_fishing14 ($1.91 in chips)
Seat 5: Yatesy82 ($0.40 in chips)
Seat 6: mtes272209 ($1.62 in chips)
ChessMaster2002: posts small blind $0.01
LLregs: posts big blind $0.02
*** HOLE CARDS ***
Dealt to LLregs [8s Js]
gone_fishing14: folds
Yatesy82: calls $0.02
mtes272209: raises $0.07 to $0.09
Pere Ubu: folds
ChessMaster2002: folds
LLregs: folds
Yatesy82: calls $0.07
*** FLOP *** [7d 6s Jd]
Yatesy82: checks
mtes272209: bets $0.10
Yatesy82: calls $0.10
*** TURN *** [7d 6s Jd] [Qd]
Yatesy82: checks
mtes272209: bets $0.20
Yatesy82: calls $0.20
*** RIVER *** [7d 6s Jd Qd] [Qc]
Yatesy82: checks
mtes272209: bets $0.02
Yatesy82: calls $0.01 and is all-in
Uncalled bet ($0.01) returned to mtes272209
*** SHOW DOWN ***
mtes272209: shows [2h 2c] (two pair, Queens and Deuces)
Yatesy82: shows [As Kc] (a pair of Queens)
mtes272209 collected $0.80 from pot
*** SUMMARY ***
Total pot $0.83 | Rake $0.03
Board [7d 6s Jd Qd Qc]
Seat 1: Pere Ubu (button) folded before Flop (didn't bet)
Seat 2: ChessMaster2002 (small blind) folded before Flop
Seat 3: LLregs (big blind) folded before Flop
Seat 4: gone_fishing14 folded before Flop (didn't bet)
Seat 5: Yatesy82 showed [As Kc] and lost with a pair of Queens
Seat 6: mtes272209 showed [2h 2c] and won ($0.80) with two pair, Queens and Deuces

PokerStars Zoom Hand #247967803213:  Hold'em No Limit ($0.01/$0.02) - 2023/12/30 21:43:36 WET [2023/12/30 16:43:36 ET]
Table 'Halley' 6-max Seat #1 is the button
Seat 1: Beduin250 ($2.11 in chips)
Seat 2: thasjengsta ($2.18 in chips)
Seat 3: evgeshona85 ($0.96 in chips)
Seat 4: Quantum771 ($2.20 in chips)
Seat 5: LLregs ($4.86 in chips)
Seat 6: Jekasikus ($2.01 in chips)
thasjengsta: posts small blind $0.01
evgeshona85: posts big blind $0.02
*** HOLE CARDS ***
Dealt to LLregs [Qc 9s]
Quantum771: folds
LLregs: folds
Jekasikus: raises $0.04 to $0.06
Beduin250: folds
thasjengsta: folds
evgeshona85: folds
Uncalled bet ($0.04) returned to Jekasikus
Jekasikus collected $0.05 from pot
Jekasikus: doesn't show hand
*** SUMMARY ***
Total pot $0.05 | Rake $0
Seat 1: Beduin250 (button) folded before Flop (didn't bet)
Seat 2: thasjengsta (small blind) folded before Flop
Seat 3: evgeshona85 (big blind) folded before Flop
Seat 4: Quantum771 folded before Flop (didn't bet)
Seat 5: LLregs folded before Flop (didn't bet)
Seat 6: Jekasikus collected ($0.05)

PokerStars Zoom Hand #247967805389:  Hold'em No Limit ($0.01/$0.02) - 2023/12/30 21:43:42 WET [2023/12/30 16:43:42 ET]
Table 'Halley' 6-max Seat #1 is the button
Seat 1: ErnieBel ($2.64 in chips)
Seat 2: Gaigel ($4.94 in chips)
Seat 3: LLregs ($4.86 in chips)
Seat 4: JOG@DOR1013 ($3.38 in chips)
Seat 5: Quantum771 ($2.20 in chips)
Seat 6: JaUm_V ($7.55 in chips)
Gaigel: posts small blind $0.01
LLregs: posts big blind $0.02
*** HOLE CARDS ***
Dealt to LLregs [As Ad]
JOG@DOR1013: folds
Quantum771: folds
JaUm_V: folds
ErnieBel: folds
Gaigel: folds
Uncalled bet ($0.01) returned to LLregs
LLregs collected $0.02 from pot
LLregs: doesn't show hand
*** SUMMARY ***
Total pot $0.02 | Rake $0
Seat 1: ErnieBel (button) folded before Flop (didn't bet)
Seat 2: Gaigel (small blind) folded before Flop
Seat 3: LLregs (big blind) collected ($0.02)
Seat 4: JOG@DOR1013 folded before Flop (didn't bet)
Seat 5: Quantum771 folded before Flop (didn't bet)
Seat 6: JaUm_V folded before Flop (didn't bet)

PokerStars Zoom Hand #247967814341:  Hold'em No Limit ($0.01/$0.02) - 2023/12/30 21:44:05 WET [2023/12/30 16:44:05 ET]
Table 'Halley' 6-max Seat #1 is the button
Seat 1: LLregs ($4.87 in chips)
Seat 2: kakani78 ($2.40 in chips)
Seat 3: grodsnok ($1.07 in chips)
Seat 4: emopokera ($1.87 in chips)
Seat 5: Giocrik ($2.84 in chips)
Seat 6: kuelas ($1.93 in chips)
kakani78: posts small blind $0.01
grodsnok: posts big blind $0.02
*** HOLE CARDS ***
Dealt to LLregs [2c 2h]
emopokera: folds
Giocrik: folds
kuelas: folds
LLregs: raises $0.04 to $0.06
kakani78: folds
grodsnok: folds
Uncalled bet ($0.04) returned to LLregs
LLregs collected $0.05 from pot
LLregs: doesn't show hand
*** SUMMARY ***
Total pot $0.05 | Rake $0
Seat 1: LLregs (button) collected ($0.05)
Seat 2: kakani78 (small blind) folded before Flop
Seat 3: grodsnok (big blind) folded before Flop
Seat 4: emopokera folded before Flop (didn't bet)
Seat 5: Giocrik folded before Flop (didn't bet)
Seat 6: kuelas folded before Flop (didn't bet)

PokerStars Zoom Hand #247967812875:  Hold'em No Limit ($0.01/$0.02) - 2023/12/30 21:44:01 WET [2023/12/30 16:44:01 ET]
Table 'Halley' 6-max Seat #1 is the button
Seat 1: danRa120 ($1.50 in chips)
Seat 2: DannielMo480 ($2.03 in chips)
Seat 3: nosiar ($2.03 in chips)
Seat 4: LLregs ($4.87 in chips)
Seat 5: igrok$148 ($1.03 in chips)
Seat 6: thasjengsta ($2.02 in chips)
DannielMo480: posts small blind $0.01
nosiar: posts big blind $0.02
*** HOLE CARDS ***
Dealt to LLregs [Td 4c]
LLregs: folds
igrok$148: folds
thasjengsta: raises $0.03 to $0.05
danRa120: raises $0.10 to $0.15
DannielMo480: folds
nosiar: folds
thasjengsta: raises $0.27 to $0.42
danRa120: folds
Uncalled bet ($0.27) returned to thasjengsta
thasjengsta collected $0.33 from pot
thasjengsta: doesn't show hand
*** SUMMARY ***
Total pot $0.33 | Rake $0
Seat 1: danRa120 (button) folded before Flop
Seat 2: DannielMo480 (small blind) folded before Flop
Seat 3: nosiar (big blind) folded before Flop
Seat 4: LLregs folded before Flop (didn't bet)
Seat 5: igrok$148 folded before Flop (didn't bet)
Seat 6: thasjengsta collected ($0.33)

PokerStars Zoom Hand #247967811351:  Hold'em No Limit ($0.01/$0.02) - 2023/12/30 21:43:57 WET [2023/12/30 16:43:57 ET]
Table 'Halley' 6-max Seat #1 is the button
Seat 1: batya1212 ($2 in chips)
Seat 2: TheOliver ($2.27 in chips)
Seat 3: charlieandpie ($1.73 in chips)
Seat 4: sandrão71 ($0.17 in chips)
Seat 5: LLregs ($4.87 in chips)
Seat 6: ErnieBel ($2.26 in chips)
TheOliver: posts small blind $0.01
charlieandpie: posts big blind $0.02
*** HOLE CARDS ***
Dealt to LLregs [7c Ks]
sandrão71: folds
LLregs: folds
ErnieBel: folds
batya1212: folds
TheOliver: raises $0.04 to $0.06
charlieandpie: calls $0.04
*** FLOP *** [4d 3h 6c]
TheOliver: bets $0.06
charlieandpie: calls $0.06
*** TURN *** [4d 3h 6c] [Qc]
TheOliver: bets $0.14
charlieandpie: calls $0.14
*** RIVER *** [4d 3h 6c Qc] [7s]
TheOliver: bets $0.25
charlieandpie: folds
Uncalled bet ($0.25) returned to TheOliver
TheOliver collected $0.50 from pot
TheOliver: doesn't show hand
*** SUMMARY ***
Total pot $0.52 | Rake $0.02
Board [4d 3h 6c Qc 7s]
Seat 1: batya1212 (button) folded before Flop (didn't bet)
Seat 2: TheOliver (small blind) collected ($0.50)
Seat 3: charlieandpie (big blind) folded on the River
Seat 4: sandrão71 folded before Flop (didn't bet)
Seat 5: LLregs folded before Flop (didn't bet)
Seat 6: ErnieBel folded before Flop (didn't bet)

PokerStars Zoom Hand #247967821945:  Hold'em No Limit ($0.01/$0.02) - 2023/12/30 21:44:24 WET [2023/12/30 16:44:24 ET]
Table 'Halley' 6-max Seat #1 is the button
Seat 1: habbadadda2 ($3.49 in chips)
Seat 2: LLregs ($4.90 in chips)
Seat 3: Pere Ubu ($1.36 in chips)
Seat 4: danRa120 ($1.35 in chips)
Seat 5: emopokera ($2.09 in chips)
Seat 6: Odysseia ($5.55 in chips)
LLregs: posts small blind $0.01
Pere Ubu: posts big blind $0.02
*** HOLE CARDS ***
Dealt to LLregs [Qh 4d]
danRa120: folds
emopokera: folds
Odysseia: folds
habbadadda2: raises $0.04 to $0.06
LLregs: folds
Pere Ubu: folds
Uncalled bet ($0.04) returned to habbadadda2
habbadadda2 collected $0.05 from pot
habbadadda2: doesn't show hand
*** SUMMARY ***
Total pot $0.05 | Rake $0
Seat 1: habbadadda2 (button) collected ($0.05)
Seat 2: LLregs (small blind) folded before Flop
Seat 3: Pere Ubu (big blind) folded before Flop
Seat 4: danRa120 folded before Flop (didn't bet)
Seat 5: emopokera folded before Flop (didn't bet)
Seat 6: Odysseia folded before Flop (didn't bet)

PokerStars Zoom Hand #247967820884:  Hold'em No Limit ($0.01/$0.02) - 2023/12/30 21:44:21 WET [2023/12/30 16:44:21 ET]
Table 'Halley' 6-max Seat #1 is the button
Seat 1: Tomoncrackk ($7.22 in chips)
Seat 2: yukon Ronald ($0.91 in chips)
Seat 3: emopokera ($0.79 in chips)
Seat 4: LLregs ($4.90 in chips)
Seat 5: KixarN ($7.83 in chips)
Seat 6: The hack ($2.39 in chips)
yukon Ronald: posts small blind $0.01
emopokera: posts big blind $0.02
*** HOLE CARDS ***
Dealt to LLregs [6h 9s]
LLregs: folds
KixarN: folds
The hack: folds
Tomoncrackk: raises $0.03 to $0.05
yukon Ronald: calls $0.04
emopokera: folds
*** FLOP *** [Qh Qc Kc]
yukon Ronald: checks
Tomoncrackk: bets $0.07
yukon Ronald: folds
Uncalled bet ($0.07) returned to Tomoncrackk
Tomoncrackk collected $0.12 from pot
Tomoncrackk: doesn't show hand
*** SUMMARY ***
Total pot $0.12 | Rake $0
Board [Qh Qc Kc]
Seat 1: Tomoncrackk (button) collected ($0.12)
Seat 2: yukon Ronald (small blind) folded on the Flop
Seat 3: emopokera (big blind) folded before Flop
Seat 4: LLregs folded before Flop (didn't bet)
Seat 5: KixarN folded before Flop (didn't bet)
Seat 6: The hack folded before Flop (didn't bet)

PokerStars Zoom Hand #247967825789:  Hold'em No Limit ($0.01/$0.02) - 2023/12/30 21:44:34 WET [2023/12/30 16:44:34 ET]
Table 'Halley' 6-max Seat #1 is the button
Seat 1: LLregs ($4.89 in chips)
Seat 2: WalkingDude19 ($2 in chips)
Seat 3: 0*jcanoa*0 ($1.17 in chips)
Seat 4: GrmBl3 ($2 in chips)
Seat 5: Giocrik ($2.34 in chips)
Seat 6: dragonJ250 ($6.96 in chips)
WalkingDude19: posts small blind $0.01
0*jcanoa*0: posts big blind $0.02
*** HOLE CARDS ***
Dealt to LLregs [Td Qs]
GrmBl3: folds
Giocrik: raises $0.04 to $0.06
dragonJ250: calls $0.06
LLregs: folds
WalkingDude19: raises $0.18 to $0.24
0*jcanoa*0: folds
Giocrik: calls $0.18
dragonJ250: folds
*** FLOP *** [Qd 7d 2c]
WalkingDude19: bets $0.44
Giocrik: folds
Uncalled bet ($0.44) returned to WalkingDude19
WalkingDude19 collected $0.54 from pot
WalkingDude19: doesn't show hand
*** SUMMARY ***
Total pot $0.56 | Rake $0.02
Board [Qd 7d 2c]
Seat 1: LLregs (button) folded before Flop (didn't bet)
Seat 2: WalkingDude19 (small blind) collected ($0.54)
Seat 3: 0*jcanoa*0 (big blind) folded before Flop
Seat 4: GrmBl3 folded before Flop (didn't bet)
Seat 5: Giocrik folded on the Flop
Seat 6: dragonJ250 folded before Flop

PokerStars Zoom Hand #247967830059:  Hold'em No Limit ($0.01/$0.02) - 2023/12/30 21:44:45 WET [2023/12/30 16:44:45 ET]
Table 'Halley' 6-max Seat #1 is the button
Seat 1: joseleo61 ($2 in chips)
Seat 2: Kamylo20 ($2.71 in chips)
Seat 3: LLregs ($4.89 in chips)
Seat 4: Sevenfold85 ($2.35 in chips)
Seat 5: ChessMaster2002 ($4.29 in chips)
Seat 6: JanTee19 ($2.09 in chips)
Kamylo20: posts small blind $0.01
LLregs: posts big blind $0.02
*** HOLE CARDS ***
Dealt to LLregs [4c Qh]
Sevenfold85: folds
ChessMaster2002: raises $0.04 to $0.06
JanTee19: folds
joseleo61: folds
Kamylo20: folds
LLregs: folds
Uncalled bet ($0.04) returned to ChessMaster2002
ChessMaster2002 collected $0.05 from pot
ChessMaster2002: doesn't show hand
*** SUMMARY ***
Total pot $0.05 | Rake $0
Seat 1: joseleo61 (button) folded before Flop (didn't bet)
Seat 2: Kamylo20 (small blind) folded before Flop
Seat 3: LLregs (big blind) folded before Flop
Seat 4: Sevenfold85 folded before Flop (didn't bet)
Seat 5: ChessMaster2002 collected ($0.05)
Seat 6: JanTee19 folded before Flop (didn't bet)

PokerStars Zoom Hand #247967839846:  Hold'em No Limit ($0.01/$0.02) - 2023/12/30 21:45:10 WET [2023/12/30 16:45:10 ET]
Table 'Halley' 6-max Seat #1 is the button
Seat 1: OMG77777 ($1.95 in chips)
Seat 2: shavarun ($1.89 in chips)
Seat 3: jbarrios007 ($1.56 in chips)
Seat 4: LLregs ($4.87 in chips)
Seat 5: placebo1970 ($0.30 in chips)
Seat 6: ChessMaster2002 ($2 in chips)
shavarun: posts small blind $0.01
jbarrios007: posts big blind $0.02
*** HOLE CARDS ***
Dealt to LLregs [7h Ac]
LLregs: folds
placebo1970: folds
ChessMaster2002: folds
OMG77777: folds
shavarun: folds
Uncalled bet ($0.01) returned to jbarrios007
jbarrios007 collected $0.02 from pot
jbarrios007: doesn't show hand
*** SUMMARY ***
Total pot $0.02 | Rake $0
Seat 1: OMG77777 (button) folded before Flop (didn't bet)
Seat 2: shavarun (small blind) folded before Flop
Seat 3: jbarrios007 (big blind) collected ($0.02)
Seat 4: LLregs folded before Flop (didn't bet)
Seat 5: placebo1970 folded before Flop (didn't bet)
Seat 6: ChessMaster2002 folded before Flop (didn't bet)

PokerStars Zoom Hand #247967823794:  Hold'em No Limit ($0.01/$0.02) - 2023/12/30 21:44:29 WET [2023/12/30 16:44:29 ET]
Table 'Halley' 6-max Seat #1 is the button
Seat 1: WalkingDude19 ($2.32 in chips)
Seat 2: Loucomeloo ($2 in chips)
Seat 3: DanRussel ($1.65 in chips)
Seat 4: Bigirii ($1.97 in chips)
Seat 5: ds_pearce2 ($2.52 in chips)
Seat 6: LLregs ($4.89 in chips)
Loucomeloo: posts small blind $0.01
DanRussel: posts big blind $0.02
*** HOLE CARDS ***
Dealt to LLregs [2c 5s]
Bigirii: raises $0.02 to $0.04
ds_pearce2: raises $0.11 to $0.15
LLregs: folds
WalkingDude19: folds
Loucomeloo: folds
DanRussel: folds
Bigirii: calls $0.11
*** FLOP *** [8d Kh Ks]
Bigirii: checks
ds_pearce2: bets $0.10
Bigirii: calls $0.10
*** TURN *** [8d Kh Ks] [Th]
Bigirii: checks
ds_pearce2: checks
*** RIVER *** [8d Kh Ks Th] [9h]
Bigirii: bets $0.51
ds_pearce2: folds
Uncalled bet ($0.51) returned to Bigirii
Bigirii collected $0.51 from pot
Bigirii: doesn't show hand
*** SUMMARY ***
Total pot $0.53 | Rake $0.02
Board [8d Kh Ks Th 9h]
Seat 1: WalkingDude19 (button) folded before Flop (didn't bet)
Seat 2: Loucomeloo (small blind) folded before Flop
Seat 3: DanRussel (big blind) folded before Flop
Seat 4: Bigirii collected ($0.51)
Seat 5: ds_pearce2 folded on the River
Seat 6: LLregs folded before Flop (didn't bet)

PokerStars Zoom Hand #247967846216:  Hold'em No Limit ($0.01/$0.02) - 2023/12/30 21:45:26 WET [2023/12/30 16:45:26 ET]
Table 'Halley' 6-max Seat #1 is the button
Seat 1: CasardoCB ($2.51 in chips)
Seat 2: 3ener ($4.50 in chips)
Seat 3: ggnavarrovaz ($3.73 in chips)
Seat 4: Ukr Troll ($8.47 in chips)
Seat 5: rrluis1930 ($2 in chips)
Seat 6: LLregs ($4.86 in chips)
3ener: posts small blind $0.01
ggnavarrovaz: posts big blind $0.02
*** HOLE CARDS ***
Dealt to LLregs [9h Jc]
Ukr Troll: folds
rrluis1930: raises $0.03 to $0.05
LLregs: folds
CasardoCB: folds
3ener: folds
ggnavarrovaz: folds
Uncalled bet ($0.03) returned to rrluis1930
rrluis1930 collected $0.05 from pot
rrluis1930: doesn't show hand
*** SUMMARY ***
Total pot $0.05 | Rake $0
Seat 1: CasardoCB (button) folded before Flop (didn't bet)
Seat 2: 3ener (small blind) folded before Flop
Seat 3: ggnavarrovaz (big blind) folded before Flop
Seat 4: Ukr Troll folded before Flop (didn't bet)
Seat 5: rrluis1930 collected ($0.05)
Seat 6: LLregs folded before Flop (didn't bet)

PokerStars Zoom Hand #247967843051:  Hold'em No Limit ($0.01/$0.02) - 2023/12/30 21:45:18 WET [2023/12/30 16:45:18 ET]
Table 'Halley' 6-max Seat #1 is the button
Seat 1: JOG@DOR1013 ($3.85 in chips)
Seat 2: LLregs ($4.87 in chips)
Seat 3: kakani78 ($2.34 in chips)
Seat 4: ONIPIKA ($3.74 in chips)
Seat 5: chianca98 ($2.27 in chips)
Seat 6: GarotoMaroto#1 ($0.98 in chips)
LLregs: posts small blind $0.01
kakani78: posts big blind $0.02
*** HOLE CARDS ***
Dealt to LLregs [9d 2c]
ONIPIKA: folds
chianca98: folds
GarotoMaroto#1: raises $0.02 to $0.04
JOG@DOR1013: folds
LLregs: folds
kakani78: calls $0.02
*** FLOP *** [9s As 5d]
kakani78: bets $0.05
GarotoMaroto#1: folds
Uncalled bet ($0.05) returned to kakani78
kakani78 collected $0.09 from pot
kakani78: doesn't show hand
*** SUMMARY ***
Total pot $0.09 | Rake $0
Board [9s As 5d]
Seat 1: JOG@DOR1013 (button) folded before Flop (didn't bet)
Seat 2: LLregs (small blind) folded before Flop
Seat 3: kakani78 (big blind) collected ($0.09)
Seat 4: ONIPIKA folded before Flop (didn't bet)
Seat 5: chianca98 folded before Flop (didn't bet)
Seat 6: GarotoMaroto#1 folded on the Flop

PokerStars Zoom Hand #247967850155:  Hold'em No Limit ($0.01/$0.02) - 2023/12/30 21:45:36 WET [2023/12/30 16:45:36 ET]
Table 'Halley' 6-max Seat #1 is the button
Seat 1: AkulaPS ($2.16 in chips)
Seat 2: Tha_Saint7 ($3.52 in chips)
Seat 3: LLregs ($4.86 in chips)
Seat 4: dealmekkplease ($2.40 in chips)
Seat 5: Pere Ubu ($1.37 in chips)
Seat 6: ONIPIKA ($3.73 in chips)
Tha_Saint7: posts small blind $0.01
LLregs: posts big blind $0.02
*** HOLE CARDS ***
Dealt to LLregs [Qd 2c]
dealmekkplease: folds
Pere Ubu: folds
ONIPIKA: folds
AkulaPS: folds
Tha_Saint7: folds
Uncalled bet ($0.01) returned to LLregs
LLregs collected $0.02 from pot
LLregs: doesn't show hand
*** SUMMARY ***
Total pot $0.02 | Rake $0
Seat 1: AkulaPS (button) folded before Flop (didn't bet)
Seat 2: Tha_Saint7 (small blind) folded before Flop
Seat 3: LLregs (big blind) collected ($0.02)
Seat 4: dealmekkplease folded before Flop (didn't bet)
Seat 5: Pere Ubu folded before Flop (didn't bet)
Seat 6: ONIPIKA folded before Flop (didn't bet)

PokerStars Zoom Hand #247967853176:  Hold'em No Limit ($0.01/$0.02) - 2023/12/30 21:45:43 WET [2023/12/30 16:45:43 ET]
Table 'Halley' 6-max Seat #1 is the button
Seat 1: emopokera ($1.84 in chips)
Seat 2: cjht1 ($1.67 in chips)
Seat 3: Pierre300873 ($1.93 in chips)
Seat 4: LLregs ($4.87 in chips)
Seat 5: batya1212 ($2 in chips)
Seat 6: TrueForm5 ($2.39 in chips)
cjht1: posts small blind $0.01
Pierre300873: posts big blind $0.02
*** HOLE CARDS ***
Dealt to LLregs [3c 8h]
LLregs: folds
batya1212: folds
TrueForm5: folds
emopokera: folds
cjht1: folds
Uncalled bet ($0.01) returned to Pierre300873
Pierre300873 collected $0.02 from pot
Pierre300873: doesn't show hand
*** SUMMARY ***
Total pot $0.02 | Rake $0
Seat 1: emopokera (button) folded before Flop (didn't bet)
Seat 2: cjht1 (small blind) folded before Flop
Seat 3: Pierre300873 (big blind) collected ($0.02)
Seat 4: LLregs folded before Flop (didn't bet)
Seat 5: batya1212 folded before Flop (didn't bet)
Seat 6: TrueForm5 folded before Flop (didn't bet)

PokerStars Zoom Hand #247967841410:  Hold'em No Limit ($0.01/$0.02) - 2023/12/30 21:45:14 WET [2023/12/30 16:45:14 ET]
Table 'Halley' 6-max Seat #1 is the button
Seat 1: barnisp ($1.51 in chips)
Seat 2: 232489410 ($2.81 in chips)
Seat 3: shavarun ($1.87 in chips)
Seat 4: lottokahe2 ($1.61 in chips)
Seat 5: LLregs ($4.87 in chips)
Seat 6: reidy0102 ($2.69 in chips)
232489410: posts small blind $0.01
shavarun: posts big blind $0.02
*** HOLE CARDS ***
Dealt to LLregs [3d Kd]
lottokahe2: folds
LLregs: folds
reidy0102: calls $0.02
barnisp: calls $0.02
232489410: folds
shavarun: checks
*** FLOP *** [4h 7s 4s]
shavarun: checks
reidy0102: checks
barnisp: checks
*** TURN *** [4h 7s 4s] [Ad]
shavarun: checks
reidy0102: checks
barnisp: checks
*** RIVER *** [4h 7s 4s Ad] [5h]
shavarun: checks
reidy0102: checks
barnisp: bets $0.07
shavarun: folds
reidy0102: folds
Uncalled bet ($0.07) returned to barnisp
barnisp collected $0.07 from pot
barnisp: doesn't show hand
*** SUMMARY ***
Total pot $0.07 | Rake $0
Board [4h 7s 4s Ad 5h]
Seat 1: barnisp (button) collected ($0.07)
Seat 2: 232489410 (small blind) folded before Flop
Seat 3: shavarun (big blind) folded on the River
Seat 4: lottokahe2 folded before Flop (didn't bet)
Seat 5: LLregs folded before Flop (didn't bet)
Seat 6: reidy0102 folded on the River

PokerStars Zoom Hand #247967848572:  Hold'em No Limit ($0.01/$0.02) - 2023/12/30 21:45:32 WET [2023/12/30 16:45:32 ET]
Table 'Halley' 6-max Seat #1 is the button
Seat 1: Pere Ubu ($1.37 in chips)
Seat 2: rizinho380 ($0.73 in chips)
Seat 3: shavarun ($1.88 in chips)
Seat 4: kuelas ($2.05 in chips)
Seat 5: LLregs ($4.86 in chips)
Seat 6: JuanChu070 ($3.72 in chips)
rizinho380: posts small blind $0.01
shavarun: posts big blind $0.02
*** HOLE CARDS ***
Dealt to LLregs [Kd 4c]
kuelas: folds
LLregs: folds
JuanChu070: folds
Pere Ubu: folds
rizinho380: calls $0.01
shavarun: checks
*** FLOP *** [8d 5h 2c]
rizinho380: bets $0.04
shavarun: folds
Uncalled bet ($0.04) returned to rizinho380
rizinho380 collected $0.04 from pot
rizinho380: doesn't show hand
*** SUMMARY ***
Total pot $0.04 | Rake $0
Board [8d 5h 2c]
Seat 1: Pere Ubu (button) folded before Flop (didn't bet)
Seat 2: rizinho380 (small blind) collected ($0.04)
Seat 3: shavarun (big blind) folded on the Flop
Seat 4: kuelas folded before Flop (didn't bet)
Seat 5: LLregs folded before Flop (didn't bet)
Seat 6: JuanChu070 folded before Flop (didn't bet)

PokerStars Zoom Hand #247967857407:  Hold'em No Limit ($0.01/$0.02) - 2023/12/30 21:45:54 WET [2023/12/30 16:45:54 ET]
Table 'Halley' 6-max Seat #1 is the button
Seat 1: LLregs ($4.87 in chips)
Seat 2: GarotoMaroto#1 ($0.92 in chips)
Seat 3: batya1212 ($2 in chips)
Seat 4: Gibsondelux ($1.37 in chips)
Seat 5: GrmBl3 ($3.89 in chips)
Seat 6: gismouck ($2.03 in chips)
GarotoMaroto#1: posts small blind $0.01
batya1212: posts big blind $0.02
*** HOLE CARDS ***
Dealt to LLregs [5h 6d]
Gibsondelux: folds
GrmBl3: raises $0.02 to $0.04
gismouck: folds
LLregs: folds
GarotoMaroto#1: folds
batya1212: calls $0.02
*** FLOP *** [Qd 2s 3d]
batya1212: checks
GrmBl3: bets $0.05
batya1212: folds
Uncalled bet ($0.05) returned to GrmBl3
GrmBl3 collected $0.09 from pot
GrmBl3: doesn't show hand
*** SUMMARY ***
Total pot $0.09 | Rake $0
Board [Qd 2s 3d]
Seat 1: LLregs (button) folded before Flop (didn't bet)
Seat 2: GarotoMaroto#1 (small blind) folded before Flop
Seat 3: batya1212 (big blind) folded on the Flop
Seat 4: Gibsondelux folded before Flop (didn't bet)
Seat 5: GrmBl3 collected ($0.09)
Seat 6: gismouck folded before Flop (didn't bet)

PokerStars Zoom Hand #247967862649:  Hold'em No Limit ($0.01/$0.02) - 2023/12/30 21:46:07 WET [2023/12/30 16:46:07 ET]
Table 'Halley' 6-max Seat #1 is the button
Seat 1: Kevin99991 ($2.46 in chips)
Seat 2: LLregs ($4.87 in chips)
Seat 3: crowfish.cz ($1.53 in chips)
Seat 4: shovetoi ($2.57 in chips)
Seat 5: TrueForm5 ($2.38 in chips)
Seat 6: whit&sh@rk ($2.76 in chips)
LLregs: posts small blind $0.01
crowfish.cz: posts big blind $0.02
*** HOLE CARDS ***
Dealt to LLregs [8d Qd]
shovetoi: folds
TrueForm5: raises $0.03 to $0.05
whit&sh@rk: folds
Kevin99991: folds
LLregs: calls $0.04
crowfish.cz: folds
*** FLOP *** [Jd 2s 7s]
LLregs: checks
TrueForm5: bets $0.04
LLregs: calls $0.04
*** TURN *** [Jd 2s 7s] [8h]
LLregs: bets $0.04
TrueForm5: calls $0.04
*** RIVER *** [Jd 2s 7s 8h] [7d]
LLregs: bets $0.09
TrueForm5: folds
Uncalled bet ($0.09) returned to LLregs
LLregs collected $0.27 from pot
LLregs: doesn't show hand
*** SUMMARY ***
Total pot $0.28 | Rake $0.01
Board [Jd 2s 7s 8h 7d]
Seat 1: Kevin99991 (button) folded before Flop (didn't bet)
Seat 2: LLregs (small blind) collected ($0.27)
Seat 3: crowfish.cz (big blind) folded before Flop
Seat 4: shovetoi folded before Flop (didn't bet)
Seat 5: TrueForm5 folded on the River
Seat 6: whit&sh@rk folded before Flop (didn't bet)

PokerStars Zoom Hand #247967878806:  Hold'em No Limit ($0.01/$0.02) - 2023/12/30 21:46:47 WET [2023/12/30 16:46:47 ET]
Table 'Halley' 6-max Seat #1 is the button
Seat 1: AdvokatEV ($0.45 in chips)
Seat 2: bryanaddict ($1.75 in chips)
Seat 3: ABT2017 ($0.80 in chips)
Seat 4: mikasafin ($3.10 in chips)
Seat 5: malo929292 ($2.50 in chips)
Seat 6: LLregs ($5.01 in chips)
bryanaddict: posts small blind $0.01
ABT2017: posts big blind $0.02
*** HOLE CARDS ***
Dealt to LLregs [6s 2c]
mikasafin: folds
malo929292: raises $0.07 to $0.09
LLregs: folds
AdvokatEV: folds
bryanaddict: folds
ABT2017: folds
Uncalled bet ($0.07) returned to malo929292
malo929292 collected $0.05 from pot
malo929292: doesn't show hand
*** SUMMARY ***
Total pot $0.05 | Rake $0
Seat 1: AdvokatEV (button) folded before Flop (didn't bet)
Seat 2: bryanaddict (small blind) folded before Flop
Seat 3: ABT2017 (big blind) folded before Flop
Seat 4: mikasafin folded before Flop (didn't bet)
Seat 5: malo929292 collected ($0.05)
Seat 6: LLregs folded before Flop (didn't bet)

PokerStars Zoom Hand #247967880220:  Hold'em No Limit ($0.01/$0.02) - 2023/12/30 21:46:51 WET [2023/12/30 16:46:51 ET]
Table 'Halley' 6-max Seat #1 is the button
Seat 1: vitalikto ($2.83 in chips)
Seat 2: jbarrios007 ($1.55 in chips)
Seat 3: whit&sh@rk ($5.72 in chips)
Seat 4: LLregs ($5.01 in chips)
Seat 5: ONIPIKA ($3.62 in chips)
Seat 6: mixi08 ($3.60 in chips)
jbarrios007: posts small blind $0.01
whit&sh@rk: posts big blind $0.02
*** HOLE CARDS ***
Dealt to LLregs [Jc Qh]
LLregs: raises $0.04 to $0.06
ONIPIKA: folds
mixi08: folds
vitalikto: folds
jbarrios007: folds
whit&sh@rk: calls $0.04
*** FLOP *** [9h 7h 7d]
whit&sh@rk: checks
LLregs: checks
*** TURN *** [9h 7h 7d] [Jh]
whit&sh@rk: bets $0.06
LLregs: calls $0.06
*** RIVER *** [9h 7h 7d Jh] [4c]
whit&sh@rk: bets $0.12
LLregs: calls $0.12
*** SHOW DOWN ***
whit&sh@rk: shows [Qd Js] (two pair, Jacks and Sevens)
LLregs: shows [Jc Qh] (two pair, Jacks and Sevens)
whit&sh@rk collected $0.24 from pot
LLregs collected $0.23 from pot
*** SUMMARY ***
Total pot $0.49 | Rake $0.02
Board [9h 7h 7d Jh 4c]
Seat 1: vitalikto (button) folded before Flop (didn't bet)
Seat 2: jbarrios007 (small blind) folded before Flop
Seat 3: whit&sh@rk (big blind) showed [Qd Js] and won ($0.24) with two pair, Jacks and Sevens
Seat 4: LLregs showed [Jc Qh] and won ($0.23) with two pair, Jacks and Sevens
Seat 5: ONIPIKA folded before Flop (didn't bet)
Seat 6: mixi08 folded before Flop (didn't bet)

PokerStars Zoom Hand #247967897455:  Hold'em No Limit ($0.01/$0.02) - 2023/12/30 21:47:33 WET [2023/12/30 16:47:33 ET]
Table 'Halley' 6-max Seat #1 is the button
Seat 1: IBRODIAN-ACER ($1.98 in chips)
Seat 2: habbadadda2 ($3.47 in chips)
Seat 3: LLregs ($5 in chips)
Seat 4: bmrao ($2.21 in chips)
Seat 5: my sapphire ($5.12 in chips)
Seat 6: dmitriy2426 ($2.26 in chips)
habbadadda2: posts small blind $0.01
LLregs: posts big blind $0.02
*** HOLE CARDS ***
Dealt to LLregs [7d 8c]
bmrao: folds
my sapphire: folds
dmitriy2426: folds
IBRODIAN-ACER: folds
habbadadda2: raises $0.06 to $0.08
LLregs: folds
Uncalled bet ($0.06) returned to habbadadda2
habbadadda2 collected $0.04 from pot
habbadadda2: doesn't show hand
*** SUMMARY ***
Total pot $0.04 | Rake $0
Seat 1: IBRODIAN-ACER (button) folded before Flop (didn't bet)
Seat 2: habbadadda2 (small blind) collected ($0.04)
Seat 3: LLregs (big blind) folded before Flop
Seat 4: bmrao folded before Flop (didn't bet)
Seat 5: my sapphire folded before Flop (didn't bet)
Seat 6: dmitriy2426 folded before Flop (didn't bet)

PokerStars Zoom Hand #247967905679:  Hold'em No Limit ($0.01/$0.02) - 2023/12/30 21:47:54 WET [2023/12/30 16:47:54 ET]
Table 'Halley' 6-max Seat #1 is the button
Seat 1: LLregs ($4.98 in chips)
Seat 2: freefrolloff ($1.92 in chips)
Seat 3: my sapphire ($0.83 in chips)
Seat 4: conspy84 ($2.23 in chips)
Seat 5: rakywok ($2.14 in chips)
Seat 6: Dimoni797979 ($1.06 in chips)
freefrolloff: posts small blind $0.01
my sapphire: posts big blind $0.02
*** HOLE CARDS ***
Dealt to LLregs [Jh As]
conspy84: folds
rakywok: folds
Dimoni797979: folds
LLregs: raises $0.04 to $0.06
freefrolloff: folds
my sapphire: folds
Uncalled bet ($0.04) returned to LLregs
LLregs collected $0.05 from pot
LLregs: doesn't show hand
*** SUMMARY ***
Total pot $0.05 | Rake $0
Seat 1: LLregs (button) collected ($0.05)
Seat 2: freefrolloff (small blind) folded before Flop
Seat 3: my sapphire (big blind) folded before Flop
Seat 4: conspy84 folded before Flop (didn't bet)
Seat 5: rakywok folded before Flop (didn't bet)
Seat 6: Dimoni797979 folded before Flop (didn't bet)

PokerStars Zoom Hand #247967911918:  Hold'em No Limit ($0.01/$0.02) - 2023/12/30 21:48:10 WET [2023/12/30 16:48:10 ET]
Table 'Halley' 6-max Seat #1 is the button
Seat 1: Mrga02 ($2 in chips)
Seat 2: LLregs ($5.01 in chips)
Seat 3: Monk92941618 ($2.80 in chips)
Seat 4: Raymond322 ($9.89 in chips)
Seat 5: ComePancito ($0.84 in chips)
Seat 6: Gaigel ($2 in chips)
LLregs: posts small blind $0.01
Monk92941618: posts big blind $0.02
*** HOLE CARDS ***
Dealt to LLregs [Qh Tc]
Raymond322: raises $0.04 to $0.06
ComePancito: folds
Gaigel: folds
Mrga02: folds
LLregs: raises $0.12 to $0.18
Monk92941618: calls $0.16
Raymond322: calls $0.12
*** FLOP *** [Jd Js 9c]
LLregs: checks
Monk92941618: bets $0.52
Raymond322: calls $0.52
LLregs: calls $0.52
*** TURN *** [Jd Js 9c] [Qs]
LLregs: checks
Monk92941618: checks
Raymond322: bets $1.02
LLregs: calls $1.02
Monk92941618: folds
*** RIVER *** [Jd Js 9c Qs] [8s]
LLregs: bets $3.29 and is all-in
Raymond322: calls $3.29
*** SHOW DOWN ***
LLregs: shows [Qh Tc] (a straight, Eight to Queen)
Raymond322: shows [Jh Ks] (three of a kind, Jacks)
LLregs collected $10.42 from pot
*** SUMMARY ***
Total pot $10.72 | Rake $0.30
Board [Jd Js 9c Qs 8s]
Seat 1: Mrga02 (button) folded before Flop (didn't bet)
Seat 2: LLregs (small blind) showed [Qh Tc] and won ($10.42) with a straight, Eight to Queen
Seat 3: Monk92941618 (big blind) folded on the Turn
Seat 4: Raymond322 showed [Jh Ks] and lost with three of a kind, Jacks
Seat 5: ComePancito folded before Flop (didn't bet)
Seat 6: Gaigel folded before Flop (didn't bet)

PokerStars Zoom Hand #247967979920:  Hold'em No Limit ($0.01/$0.02) - 2023/12/30 21:51:02 WET [2023/12/30 16:51:02 ET]
Table 'Halley' 6-max Seat #1 is the button
Seat 1: IBRODIAN-ACER ($2.07 in chips)
Seat 2: ichithekill ($2.23 in chips)
Seat 3: Babettka ($1.93 in chips)
Seat 4: MichalG1 ($2.02 in chips)
Seat 5: PJWALL ($1.80 in chips)
Seat 6: LLregs ($10.42 in chips)
ichithekill: posts small blind $0.01
Babettka: posts big blind $0.02
*** HOLE CARDS ***
Dealt to LLregs [4s 9s]
MichalG1: folds
PJWALL: folds
LLregs: folds
IBRODIAN-ACER: raises $0.04 to $0.06
ichithekill: folds
Babettka: folds
Uncalled bet ($0.04) returned to IBRODIAN-ACER
IBRODIAN-ACER collected $0.05 from pot
IBRODIAN-ACER: doesn't show hand
*** SUMMARY ***
Total pot $0.05 | Rake $0
Seat 1: IBRODIAN-ACER (button) collected ($0.05)
Seat 2: ichithekill (small blind) folded before Flop
Seat 3: Babettka (big blind) folded before Flop
Seat 4: MichalG1 folded before Flop (didn't bet)
Seat 5: PJWALL folded before Flop (didn't bet)
Seat 6: LLregs folded before Flop (didn't bet)

PokerStars Zoom Hand #247967983329:  Hold'em No Limit ($0.01/$0.02) - 2023/12/30 21:51:10 WET [2023/12/30 16:51:10 ET]
Table 'Halley' 6-max Seat #1 is the button
Seat 1: RTedeschi19 ($1.49 in chips)
Seat 2: Blue_wh4le ($1.49 in chips)
Seat 3: myk 6334797 ($1.38 in chips)
Seat 4: IBRODIAN-ACER ($5.85 in chips)
Seat 5: LLregs ($10.42 in chips)
Seat 6: High Fumph ($3.64 in chips)
Blue_wh4le: posts small blind $0.01
myk 6334797: posts big blind $0.02
*** HOLE CARDS ***
Dealt to LLregs [3s 6d]
IBRODIAN-ACER: folds
LLregs: folds
High Fumph: raises $0.02 to $0.04
RTedeschi19: raises $0.16 to $0.20
Blue_wh4le: folds
myk 6334797: folds
High Fumph: folds
Uncalled bet ($0.16) returned to RTedeschi19
RTedeschi19 collected $0.11 from pot
RTedeschi19: doesn't show hand
*** SUMMARY ***
Total pot $0.11 | Rake $0
Seat 1: RTedeschi19 (button) collected ($0.11)
Seat 2: Blue_wh4le (small blind) folded before Flop
Seat 3: myk 6334797 (big blind) folded before Flop
Seat 4: IBRODIAN-ACER folded before Flop (didn't bet)
Seat 5: LLregs folded before Flop (didn't bet)
Seat 6: High Fumph folded before Flop

PokerStars Zoom Hand #247967987302:  Hold'em No Limit ($0.01/$0.02) - 2023/12/30 21:51:20 WET [2023/12/30 16:51:20 ET]
Table 'Halley' 6-max Seat #1 is the button
Seat 1: LLregs ($10.42 in chips)
Seat 2: ONIPIKA ($2.73 in chips)
Seat 3: Beduin250 ($2.24 in chips)
Seat 4: MetalStorm07 ($1.27 in chips)
Seat 5: DanRussel ($1.53 in chips)
Seat 6: Odysseia ($6.84 in chips)
ONIPIKA: posts small blind $0.01
Beduin250: posts big blind $0.02
*** HOLE CARDS ***
Dealt to LLregs [Jc Ts]
MetalStorm07: folds
DanRussel: folds
Odysseia: folds
LLregs: raises $0.04 to $0.06
ONIPIKA: folds
Beduin250: calls $0.04
*** FLOP *** [Ah 7s 5d]
Beduin250: checks
LLregs: checks
*** TURN *** [Ah 7s 5d] [Kc]
Beduin250: checks
LLregs: bets $0.03
Beduin250: folds
Uncalled bet ($0.03) returned to LLregs
LLregs collected $0.13 from pot
LLregs: doesn't show hand
*** SUMMARY ***
Total pot $0.13 | Rake $0
Board [Ah 7s 5d Kc]
Seat 1: LLregs (button) collected ($0.13)
Seat 2: ONIPIKA (small blind) folded before Flop
Seat 3: Beduin250 (big blind) folded on the Turn
Seat 4: MetalStorm07 folded before Flop (didn't bet)
Seat 5: DanRussel folded before Flop (didn't bet)
Seat 6: Odysseia folded before Flop (didn't bet)

PokerStars Zoom Hand #247968006249:  Hold'em No Limit ($0.01/$0.02) - 2023/12/30 21:52:08 WET [2023/12/30 16:52:08 ET]
Table 'Halley' 6-max Seat #1 is the button
Seat 1: TamiSieche ($2.92 in chips)
Seat 2: aricast19 ($4.47 in chips)
Seat 3: LLregs ($10.49 in chips)
Seat 4: ds_pearce2 ($5.33 in chips)
Seat 5: jayandevie ($2.53 in chips)
Seat 6: monkmeleon ($1.91 in chips)
aricast19: posts small blind $0.01
LLregs: posts big blind $0.02
*** HOLE CARDS ***
Dealt to LLregs [8d 4h]
ds_pearce2: folds
jayandevie: folds
monkmeleon: folds
TamiSieche: raises $0.05 to $0.07
aricast19: raises $0.15 to $0.22
LLregs: folds
TamiSieche: folds
Uncalled bet ($0.15) returned to aricast19
aricast19 collected $0.16 from pot
aricast19: doesn't show hand
*** SUMMARY ***
Total pot $0.16 | Rake $0
Seat 1: TamiSieche (button) folded before Flop
Seat 2: aricast19 (small blind) collected ($0.16)
Seat 3: LLregs (big blind) folded before Flop
Seat 4: ds_pearce2 folded before Flop (didn't bet)
Seat 5: jayandevie folded before Flop (didn't bet)
Seat 6: monkmeleon folded before Flop (didn't bet)

PokerStars Zoom Hand #247968020581:  Hold'em No Limit ($0.01/$0.02) - 2023/12/30 21:52:44 WET [2023/12/30 16:52:44 ET]
Table 'Halley' 6-max Seat #1 is the button
Seat 1: FlyingAm1sh ($4.71 in chips)
Seat 2: somidwey ($2.11 in chips)
Seat 3: artificialchaos ($3.88 in chips)
Seat 4: LLregs ($10.47 in chips)
Seat 5: Vanti13 ($0.94 in chips)
Seat 6: null11 ($1.19 in chips)
somidwey: posts small blind $0.01
artificialchaos: posts big blind $0.02
*** HOLE CARDS ***
Dealt to LLregs [Th Tc]
LLregs: raises $0.04 to $0.06
Vanti13: folds
null11: folds
FlyingAm1sh: folds
somidwey: folds
artificialchaos: folds
Uncalled bet ($0.04) returned to LLregs
LLregs collected $0.05 from pot
LLregs: doesn't show hand
*** SUMMARY ***
Total pot $0.05 | Rake $0
Seat 1: FlyingAm1sh (button) folded before Flop (didn't bet)
Seat 2: somidwey (small blind) folded before Flop
Seat 3: artificialchaos (big blind) folded before Flop
Seat 4: LLregs collected ($0.05)
Seat 5: Vanti13 folded before Flop (didn't bet)
Seat 6: null11 folded before Flop (didn't bet)

PokerStars Zoom Hand #247968026079:  Hold'em No Limit ($0.01/$0.02) - 2023/12/30 21:52:58 WET [2023/12/30 16:52:58 ET]
Table 'Halley' 6-max Seat #1 is the button
Seat 1: Loucomeloo ($2 in chips)
Seat 2: LLregs ($10.50 in chips)
Seat 3: robbert12112 ($2.10 in chips)
Seat 4: ds_pearce2 ($5.28 in chips)
Seat 5: dragonJ250 ($7.13 in chips)
Seat 6: youraced ($1.63 in chips)
LLregs: posts small blind $0.01
robbert12112: posts big blind $0.02
*** HOLE CARDS ***
Dealt to LLregs [5d Td]
ds_pearce2: folds
dragonJ250: folds
youraced: folds
Loucomeloo: raises $0.03 to $0.05
LLregs: folds
robbert12112: folds
Uncalled bet ($0.03) returned to Loucomeloo
Loucomeloo collected $0.05 from pot
Loucomeloo: doesn't show hand
*** SUMMARY ***
Total pot $0.05 | Rake $0
Seat 1: Loucomeloo (button) collected ($0.05)
Seat 2: LLregs (small blind) folded before Flop
Seat 3: robbert12112 (big blind) folded before Flop
Seat 4: ds_pearce2 folded before Flop (didn't bet)
Seat 5: dragonJ250 folded before Flop (didn't bet)
Seat 6: youraced folded before Flop (didn't bet)

PokerStars Zoom Hand #247968034137:  Hold'em No Limit ($0.01/$0.02) - 2023/12/30 21:53:19 WET [2023/12/30 16:53:19 ET]
Table 'Halley' 6-max Seat #1 is the button
Seat 1: micmicmic ($1.88 in chips)
Seat 2: somidwey ($2.14 in chips)
Seat 3: emopokera ($3.01 in chips)
Seat 4: IBRODIAN-ACER ($2.11 in chips)
Seat 5: LLregs ($10.49 in chips)
Seat 6: artificialchaos ($2.17 in chips)
somidwey: posts small blind $0.01
emopokera: posts big blind $0.02
*** HOLE CARDS ***
Dealt to LLregs [3s 2d]
IBRODIAN-ACER: folds
LLregs: folds
artificialchaos: folds
micmicmic: folds
somidwey: raises $0.04 to $0.06
emopokera: folds
Uncalled bet ($0.04) returned to somidwey
somidwey collected $0.04 from pot
somidwey: doesn't show hand
*** SUMMARY ***
Total pot $0.04 | Rake $0
Seat 1: micmicmic (button) folded before Flop (didn't bet)
Seat 2: somidwey (small blind) collected ($0.04)
Seat 3: emopokera (big blind) folded before Flop
Seat 4: IBRODIAN-ACER folded before Flop (didn't bet)
Seat 5: LLregs folded before Flop (didn't bet)
Seat 6: artificialchaos folded before Flop (didn't bet)

PokerStars Zoom Hand #247968016149:  Hold'em No Limit ($0.01/$0.02) - 2023/12/30 21:52:33 WET [2023/12/30 16:52:33 ET]
Table 'Halley' 6-max Seat #1 is the button
Seat 1: shavarun ($1.76 in chips)
Seat 2: e.r.i.c03030 ($0.78 in chips)
Seat 3: whit&sh@rk ($5.09 in chips)
Seat 4: DanRussel ($1.37 in chips)
Seat 5: LLregs ($10.47 in chips)
Seat 6: CMARIUS02 ($1.43 in chips)
e.r.i.c03030: posts small blind $0.01
whit&sh@rk: posts big blind $0.02
*** HOLE CARDS ***
Dealt to LLregs [4h Kh]
DanRussel: raises $0.06 to $0.08
LLregs: folds
CMARIUS02: folds
shavarun: calls $0.08
e.r.i.c03030: calls $0.07
whit&sh@rk: raises $0.24 to $0.32
DanRussel: folds
shavarun: calls $0.24
e.r.i.c03030: calls $0.24
*** FLOP *** [6c 7h Ad]
e.r.i.c03030: checks
whit&sh@rk: checks
shavarun: checks
*** TURN *** [6c 7h Ad] [Js]
e.r.i.c03030: checks
whit&sh@rk: checks
shavarun: checks
*** RIVER *** [6c 7h Ad Js] [5c]
e.r.i.c03030: checks
whit&sh@rk: bets $0.30
shavarun: folds
e.r.i.c03030: folds
Uncalled bet ($0.30) returned to whit&sh@rk
whit&sh@rk collected $1 from pot
whit&sh@rk: doesn't show hand
*** SUMMARY ***
Total pot $1.04 | Rake $0.04
Board [6c 7h Ad Js 5c]
Seat 1: shavarun (button) folded on the River
Seat 2: e.r.i.c03030 (small blind) folded on the River
Seat 3: whit&sh@rk (big blind) collected ($1)
Seat 4: DanRussel folded before Flop
Seat 5: LLregs folded before Flop (didn't bet)
Seat 6: CMARIUS02 folded before Flop (didn't bet)

PokerStars Zoom Hand #247968039483:  Hold'em No Limit ($0.01/$0.02) - 2023/12/30 21:53:32 WET [2023/12/30 16:53:32 ET]
Table 'Halley' 6-max Seat #1 is the button
Seat 1: LLregs ($10.49 in chips)
Seat 2: sTIKs21 ($2 in chips)
Seat 3: youraced ($2.49 in chips)
Seat 4: SchmittNieto ($2.08 in chips)
Seat 5: freefrolloff ($1.86 in chips)
Seat 6: 888lifeIS ($2.36 in chips)
sTIKs21: posts small blind $0.01
youraced: posts big blind $0.02
*** HOLE CARDS ***
Dealt to LLregs [2d Tc]
SchmittNieto: folds
freefrolloff: calls $0.02
888lifeIS: folds
LLregs: folds
sTIKs21: raises $0.06 to $0.08
youraced: folds
freefrolloff: calls $0.06
*** FLOP *** [4h 9s 3h]
sTIKs21: bets $0.08
freefrolloff: folds
Uncalled bet ($0.08) returned to sTIKs21
sTIKs21 collected $0.17 from pot
sTIKs21: doesn't show hand
*** SUMMARY ***
Total pot $0.18 | Rake $0.01
Board [4h 9s 3h]
Seat 1: LLregs (button) folded before Flop (didn't bet)
Seat 2: sTIKs21 (small blind) collected ($0.17)
Seat 3: youraced (big blind) folded before Flop
Seat 4: SchmittNieto folded before Flop (didn't bet)
Seat 5: freefrolloff folded on the Flop
Seat 6: 888lifeIS folded before Flop (didn't bet)

PokerStars Zoom Hand #247968045125:  Hold'em No Limit ($0.01/$0.02) - 2023/12/30 21:53:47 WET [2023/12/30 16:53:47 ET]
Table 'Halley' 6-max Seat #1 is the button
Seat 1: Clark_Kent_1991 ($0.90 in chips)
Seat 2: ComePancito ($0.93 in chips)
Seat 3: LLregs ($10.49 in chips)
Seat 4: AdvokatEV ($0.28 in chips)
Seat 5: Bigirii ($2.63 in chips)
Seat 6: jbarrios007 ($1.47 in chips)
ComePancito: posts small blind $0.01
LLregs: posts big blind $0.02
*** HOLE CARDS ***
Dealt to LLregs [6c Ts]
AdvokatEV: raises $0.26 to $0.28 and is all-in
Bigirii: folds
jbarrios007: folds
Clark_Kent_1991: raises $0.62 to $0.90 and is all-in
ComePancito: folds
LLregs: folds
Uncalled bet ($0.62) returned to Clark_Kent_1991
*** FLOP *** [Kc Kh 9c]
*** TURN *** [Kc Kh 9c] [9s]
*** RIVER *** [Kc Kh 9c 9s] [6d]
*** SHOW DOWN ***
AdvokatEV: shows [Ad 7s] (two pair, Kings and Nines)
Clark_Kent_1991: shows [9h Th] (a full house, Nines full of Kings)
Clark_Kent_1991 collected $0.57 from pot
AdvokatEV cashed out the hand for $0.29 | Cash Out Fee $0.01
*** SUMMARY ***
Total pot $0.59 | Rake $0.02
Board [Kc Kh 9c 9s 6d]
Seat 1: Clark_Kent_1991 (button) showed [9h Th] and won ($0.57) with a full house, Nines full of Kings
Seat 2: ComePancito (small blind) folded before Flop
Seat 3: LLregs (big blind) folded before Flop
Seat 4: AdvokatEV showed [Ad 7s] and lost with two pair, Kings and Nines (cashed out).
Seat 5: Bigirii folded before Flop (didn't bet)
Seat 6: jbarrios007 folded before Flop (didn't bet)

PokerStars Zoom Hand #247968171468:  Hold'em No Limit ($0.01/$0.02) - 2023/12/30 22:00:43 WET [2023/12/30 17:00:43 ET]
Table 'Halley' 6-max Seat #1 is the button
Seat 1: Giocrik ($2.51 in chips)
Seat 2: LLregs ($10.47 in chips)
Seat 3: hybridi ($4.06 in chips)
Seat 4: mjeenetto ($1.53 in chips)
Seat 5: Gaigel ($4.91 in chips)
Seat 6: HooliganBasher ($2.35 in chips)
LLregs: posts small blind $0.01
hybridi: posts big blind $0.02
*** HOLE CARDS ***
Dealt to LLregs [3s 4d]
mjeenetto: folds
Gaigel: folds
HooliganBasher: folds
Giocrik: folds
LLregs: folds
Uncalled bet ($0.01) returned to hybridi
hybridi collected $0.02 from pot
hybridi: doesn't show hand
*** SUMMARY ***
Total pot $0.02 | Rake $0
Seat 1: Giocrik (button) folded before Flop (didn't bet)
Seat 2: LLregs (small blind) folded before Flop
Seat 3: hybridi (big blind) collected ($0.02)
Seat 4: mjeenetto folded before Flop (didn't bet)
Seat 5: Gaigel folded before Flop (didn't bet)
Seat 6: HooliganBasher folded before Flop (didn't bet)

PokerStars Zoom Hand #247968174257:  Hold'em No Limit ($0.01/$0.02) - 2023/12/30 22:00:53 WET [2023/12/30 17:00:53 ET]
Table 'Halley' 6-max Seat #1 is the button
Seat 1: Arizona78939 ($2 in chips)
Seat 2: NineHi72 ($8.72 in chips)
Seat 3: andre8276 ($1.96 in chips)
Seat 4: LLregs ($10.46 in chips)
Seat 5: mc8900 ($2.25 in chips)
Seat 6: Loosax ($2.92 in chips)
NineHi72: posts small blind $0.01
andre8276: posts big blind $0.02
*** HOLE CARDS ***
Dealt to LLregs [4c Kd]
LLregs: folds
mc8900: folds
Loosax: folds
Arizona78939: folds
NineHi72: folds
Uncalled bet ($0.01) returned to andre8276
andre8276 collected $0.02 from pot
andre8276: doesn't show hand
*** SUMMARY ***
Total pot $0.02 | Rake $0
Seat 1: Arizona78939 (button) folded before Flop (didn't bet)
Seat 2: NineHi72 (small blind) folded before Flop
Seat 3: andre8276 (big blind) collected ($0.02)
Seat 4: LLregs folded before Flop (didn't bet)
Seat 5: mc8900 folded before Flop (didn't bet)
Seat 6: Loosax folded before Flop (didn't bet)

PokerStars Zoom Hand #247968169113:  Hold'em No Limit ($0.01/$0.02) - 2023/12/30 22:00:36 WET [2023/12/30 17:00:36 ET]
Table 'Halley' 6-max Seat #1 is the button
Seat 1: Shaka667 ($1.99 in chips)
Seat 2: IngeniEbr10 ($2.08 in chips)
Seat 3: elcuchu168 ($1.92 in chips)
Seat 4: whit&sh@rk ($2.67 in chips)
Seat 5: portilho69 ($2.30 in chips)
Seat 6: LLregs ($10.47 in chips)
IngeniEbr10: posts small blind $0.01
elcuchu168: posts big blind $0.02
*** HOLE CARDS ***
Dealt to LLregs [Kc 2s]
whit&sh@rk: folds
portilho69: raises $0.02 to $0.04
LLregs: folds
Shaka667: folds
IngeniEbr10: folds
elcuchu168: calls $0.02
*** FLOP *** [9d Tc 8c]
elcuchu168: checks
portilho69: checks
*** TURN *** [9d Tc 8c] [As]
elcuchu168: checks
portilho69: checks
*** RIVER *** [9d Tc 8c As] [4d]
elcuchu168: checks
portilho69: bets $0.05
elcuchu168: folds
Uncalled bet ($0.05) returned to portilho69
portilho69 collected $0.09 from pot
portilho69: doesn't show hand
*** SUMMARY ***
Total pot $0.09 | Rake $0
Board [9d Tc 8c As 4d]
Seat 1: Shaka667 (button) folded before Flop (didn't bet)
Seat 2: IngeniEbr10 (small blind) folded before Flop
Seat 3: elcuchu168 (big blind) folded on the River
Seat 4: whit&sh@rk folded before Flop (didn't bet)
Seat 5: portilho69 collected ($0.09)
Seat 6: LLregs folded before Flop (didn't bet)

PokerStars Zoom Hand #247968175348:  Hold'em No Limit ($0.01/$0.02) - 2023/12/30 22:00:56 WET [2023/12/30 17:00:56 ET]
Table 'Halley' 6-max Seat #1 is the button
Seat 1: LLregs ($10.46 in chips)
Seat 2: sTIKs21 ($2 in chips)
Seat 3: mag111115 ($1.14 in chips)
Seat 4: XRTC24 ($1.77 in chips)
Seat 5: Weily8 ($2.85 in chips)
Seat 6: igrok$148 ($1.08 in chips)
sTIKs21: posts small blind $0.01
mag111115: posts big blind $0.02
*** HOLE CARDS ***
Dealt to LLregs [Ts 3s]
XRTC24: folds
Weily8: folds
igrok$148: folds
LLregs: raises $0.04 to $0.06
sTIKs21: folds
mag111115: folds
Uncalled bet ($0.04) returned to LLregs
LLregs collected $0.05 from pot
LLregs: doesn't show hand
*** SUMMARY ***
Total pot $0.05 | Rake $0
Seat 1: LLregs (button) collected ($0.05)
Seat 2: sTIKs21 (small blind) folded before Flop
Seat 3: mag111115 (big blind) folded before Flop
Seat 4: XRTC24 folded before Flop (didn't bet)
Seat 5: Weily8 folded before Flop (didn't bet)
Seat 6: igrok$148 folded before Flop (didn't bet)

PokerStars Zoom Hand #247968173074:  Hold'em No Limit ($0.01/$0.02) - 2023/12/30 22:00:49 WET [2023/12/30 17:00:49 ET]
Table 'Halley' 6-max Seat #1 is the button
Seat 1: mc8900 ($2.25 in chips)
Seat 2: dogor73 ($2.07 in chips)
Seat 3: HooliganBasher ($2.35 in chips)
Seat 4: 42Oedipius ($2 in chips)
Seat 5: kasse112 ($4.25 in chips)
Seat 6: LLregs ($10.46 in chips)
dogor73: posts small blind $0.01
HooliganBasher: posts big blind $0.02
*** HOLE CARDS ***
Dealt to LLregs [5c 4h]
42Oedipius: folds
kasse112: raises $0.04 to $0.06
LLregs: folds
mc8900: folds
dogor73: folds
HooliganBasher: calls $0.04
*** FLOP *** [9h Jd 2c]
HooliganBasher: checks
kasse112: bets $0.07
HooliganBasher: raises $0.27 to $0.34
kasse112: folds
Uncalled bet ($0.27) returned to HooliganBasher
HooliganBasher collected $0.26 from pot
HooliganBasher: doesn't show hand
*** SUMMARY ***
Total pot $0.27 | Rake $0.01
Board [9h Jd 2c]
Seat 1: mc8900 (button) folded before Flop (didn't bet)
Seat 2: dogor73 (small blind) folded before Flop
Seat 3: HooliganBasher (big blind) collected ($0.26)
Seat 4: 42Oedipius folded before Flop (didn't bet)
Seat 5: kasse112 folded on the Flop
Seat 6: LLregs folded before Flop (didn't bet)

PokerStars Zoom Hand #247968179391:  Hold'em No Limit ($0.01/$0.02) - 2023/12/30 22:01:08 WET [2023/12/30 17:01:08 ET]
Table 'Halley' 6-max Seat #1 is the button
Seat 1: gismouck ($2.03 in chips)
Seat 2: my sapphire ($4.43 in chips)
Seat 3: LLregs ($10.49 in chips)
Seat 4: bandini111 ($4.72 in chips)
Seat 5: Loucomeloo ($2 in chips)
Seat 6: Tinchocabj35 ($4.75 in chips)
my sapphire: posts small blind $0.01
LLregs: posts big blind $0.02
*** HOLE CARDS ***
Dealt to LLregs [3d Qs]
bandini111: raises $0.04 to $0.06
Loucomeloo: folds
Tinchocabj35: folds
gismouck: folds
my sapphire: folds
LLregs: folds
Uncalled bet ($0.04) returned to bandini111
bandini111 collected $0.05 from pot
bandini111: doesn't show hand
*** SUMMARY ***
Total pot $0.05 | Rake $0
Seat 1: gismouck (button) folded before Flop (didn't bet)
Seat 2: my sapphire (small blind) folded before Flop
Seat 3: LLregs (big blind) folded before Flop
Seat 4: bandini111 collected ($0.05)
Seat 5: Loucomeloo folded before Flop (didn't bet)
Seat 6: Tinchocabj35 folded before Flop (didn't bet)

PokerStars Zoom Hand #247968191126:  Hold'em No Limit ($0.01/$0.02) - 2023/12/30 22:01:41 WET [2023/12/30 17:01:41 ET]
Table 'Halley' 6-max Seat #1 is the button
Seat 1: rrluis1930 ($2.04 in chips)
Seat 2: VIDOPRO23 ($1.93 in chips)
Seat 3: aricast19 ($4.32 in chips)
Seat 4: LLregs ($10.46 in chips)
Seat 5: hybridi ($2.55 in chips)
Seat 6: BETH257 ($1.83 in chips)
VIDOPRO23: posts small blind $0.01
aricast19: posts big blind $0.02
*** HOLE CARDS ***
Dealt to LLregs [Qc Jd]
LLregs: raises $0.04 to $0.06
hybridi: folds
BETH257: folds
rrluis1930: folds
VIDOPRO23: folds
aricast19: folds
Uncalled bet ($0.04) returned to LLregs
LLregs collected $0.05 from pot
LLregs: doesn't show hand
*** SUMMARY ***
Total pot $0.05 | Rake $0
Seat 1: rrluis1930 (button) folded before Flop (didn't bet)
Seat 2: VIDOPRO23 (small blind) folded before Flop
Seat 3: aricast19 (big blind) folded before Flop
Seat 4: LLregs collected ($0.05)
Seat 5: hybridi folded before Flop (didn't bet)
Seat 6: BETH257 folded before Flop (didn't bet)

PokerStars Zoom Hand #247968187227:  Hold'em No Limit ($0.01/$0.02) - 2023/12/30 22:01:31 WET [2023/12/30 17:01:31 ET]
Table 'Halley' 6-max Seat #1 is the button
Seat 1: my sapphire ($2.56 in chips)
Seat 2: LLregs ($10.47 in chips)
Seat 3: jamam333 ($6.22 in chips)
Seat 4: aricast19 ($4.32 in chips)
Seat 5: Giocrik ($6.23 in chips)
Seat 6: zepatta ($2.46 in chips)
LLregs: posts small blind $0.01
jamam333: posts big blind $0.02
*** HOLE CARDS ***
Dealt to LLregs [Ah 7s]
aricast19: folds
Giocrik: folds
zepatta: folds
my sapphire: raises $0.03 to $0.05
LLregs: folds
jamam333: calls $0.03
*** FLOP *** [9c 3s 7c]
jamam333: bets $0.06
my sapphire: calls $0.06
*** TURN *** [9c 3s 7c] [4c]
jamam333: checks
my sapphire: checks
*** RIVER *** [9c 3s 7c 4c] [8c]
jamam333: checks
my sapphire: checks
*** SHOW DOWN ***
jamam333: shows [8h 8d] (three of a kind, Eights)
my sapphire: mucks hand
jamam333 collected $0.22 from pot
*** SUMMARY ***
Total pot $0.23 | Rake $0.01
Board [9c 3s 7c 4c 8c]
Seat 1: my sapphire (button) mucked [Qh 7h]
Seat 2: LLregs (small blind) folded before Flop
Seat 3: jamam333 (big blind) showed [8h 8d] and won ($0.22) with three of a kind, Eights
Seat 4: aricast19 folded before Flop (didn't bet)
Seat 5: Giocrik folded before Flop (didn't bet)
Seat 6: zepatta folded before Flop (didn't bet)

PokerStars Zoom Hand #247968199449:  Hold'em No Limit ($0.01/$0.02) - 2023/12/30 22:02:01 WET [2023/12/30 17:02:01 ET]
Table 'Halley' 6-max Seat #1 is the button
Seat 1: LLregs ($10.49 in chips)
Seat 2: kasse112 ($3.69 in chips)
Seat 3: jesterka20 ($0.99 in chips)
Seat 4: Sevenfold85 ($2.66 in chips)
Seat 5: dogor73 ($1.54 in chips)
Seat 6: andre8276 ($2.23 in chips)
kasse112: posts small blind $0.01
jesterka20: posts big blind $0.02
*** HOLE CARDS ***
Dealt to LLregs [5d 5c]
Sevenfold85: folds
dogor73: raises $0.06 to $0.08
andre8276: folds
LLregs: calls $0.08
kasse112: folds
jesterka20: folds
*** FLOP *** [Kd 8h Ac]
dogor73: checks
LLregs: checks
*** TURN *** [Kd 8h Ac] [7s]
dogor73: bets $0.09
LLregs: calls $0.09
*** RIVER *** [Kd 8h Ac 7s] [5s]
dogor73: bets $0.18
LLregs: raises $0.36 to $0.54
dogor73: calls $0.36
*** SHOW DOWN ***
LLregs: shows [5d 5c] (three of a kind, Fives)
dogor73: mucks hand
LLregs collected $1.40 from pot
*** SUMMARY ***
Total pot $1.45 | Rake $0.05
Board [Kd 8h Ac 7s 5s]
Seat 1: LLregs (button) showed [5d 5c] and won ($1.40) with three of a kind, Fives
Seat 2: kasse112 (small blind) folded before Flop
Seat 3: jesterka20 (big blind) folded before Flop
Seat 4: Sevenfold85 folded before Flop (didn't bet)
Seat 5: dogor73 mucked [Ad Kc]
Seat 6: andre8276 folded before Flop (didn't bet)

PokerStars Zoom Hand #247968221156:  Hold'em No Limit ($0.01/$0.02) - 2023/12/30 22:02:58 WET [2023/12/30 17:02:58 ET]
Table 'Halley' 6-max Seat #1 is the button
Seat 1: tinopiola~ ($2.02 in chips)
Seat 2: marksupertramp ($0.95 in chips)
Seat 3: TamiSieche ($3.23 in chips)
Seat 4: gismouck ($2.04 in chips)
Seat 5: LLregs ($11.18 in chips)
Seat 6: ichithekill ($2.11 in chips)
marksupertramp: posts small blind $0.01
TamiSieche: posts big blind $0.02
*** HOLE CARDS ***
Dealt to LLregs [Ah 8c]
gismouck: folds
LLregs: folds
ichithekill: folds
tinopiola~: folds
marksupertramp: folds
Uncalled bet ($0.01) returned to TamiSieche
TamiSieche collected $0.02 from pot
TamiSieche: doesn't show hand
*** SUMMARY ***
Total pot $0.02 | Rake $0
Seat 1: tinopiola~ (button) folded before Flop (didn't bet)
Seat 2: marksupertramp (small blind) folded before Flop
Seat 3: TamiSieche (big blind) collected ($0.02)
Seat 4: gismouck folded before Flop (didn't bet)
Seat 5: LLregs folded before Flop (didn't bet)
Seat 6: ichithekill folded before Flop (didn't bet)

PokerStars Zoom Hand #247968218839:  Hold'em No Limit ($0.01/$0.02) - 2023/12/30 22:02:52 WET [2023/12/30 17:02:52 ET]
Table 'Halley' 6-max Seat #1 is the button
Seat 1: micdik ($2.13 in chips)
Seat 2: 514dw5000 ($1.99 in chips)
Seat 3: hybridi ($4.02 in chips)
Seat 4: shovetoi ($2.34 in chips)
Seat 5: zeroelegante ($18.54 in chips)
Seat 6: LLregs ($11.18 in chips)
514dw5000: posts small blind $0.01
hybridi: posts big blind $0.02
*** HOLE CARDS ***
Dealt to LLregs [3c Ts]
shovetoi: folds
zeroelegante: raises $0.02 to $0.04
LLregs: folds
micdik: raises $0.07 to $0.11
514dw5000: folds
hybridi: folds
zeroelegante: calls $0.07
*** FLOP *** [9c Qh 2c]
zeroelegante: checks
micdik: checks
*** TURN *** [9c Qh 2c] [Qs]
zeroelegante: checks
micdik: checks
*** RIVER *** [9c Qh 2c Qs] [Qd]
zeroelegante: checks
micdik: checks
*** SHOW DOWN ***
zeroelegante: shows [Th Kh] (three of a kind, Queens)
micdik: mucks hand
zeroelegante collected $0.24 from pot
*** SUMMARY ***
Total pot $0.25 | Rake $0.01
Board [9c Qh 2c Qs Qd]
Seat 1: micdik (button) mucked [Kc 4c]
Seat 2: 514dw5000 (small blind) folded before Flop
Seat 3: hybridi (big blind) folded before Flop
Seat 4: shovetoi folded before Flop (didn't bet)
Seat 5: zeroelegante showed [Th Kh] and won ($0.24) with three of a kind, Queens
Seat 6: LLregs folded before Flop (didn't bet)

PokerStars Zoom Hand #247968232666:  Hold'em No Limit ($0.01/$0.02) - 2023/12/30 22:03:27 WET [2023/12/30 17:03:27 ET]
Table 'Halley' 6-max Seat #1 is the button
Seat 1: mixi08 ($2.14 in chips)
Seat 2: IngeniEbr10 ($2 in chips)
Seat 3: emopokera ($1.04 in chips)
Seat 4: n3olin3 ($1.24 in chips)
Seat 5: LLregs ($11.16 in chips)
Seat 6: brunotga ($0.87 in chips)
IngeniEbr10: posts small blind $0.01
emopokera: posts big blind $0.02
*** HOLE CARDS ***
Dealt to LLregs [Qs 2d]
n3olin3: folds
LLregs: folds
brunotga: folds
mixi08: folds
IngeniEbr10: folds
Uncalled bet ($0.01) returned to emopokera
emopokera collected $0.02 from pot
emopokera: doesn't show hand
*** SUMMARY ***
Total pot $0.02 | Rake $0
Seat 1: mixi08 (button) folded before Flop (didn't bet)
Seat 2: IngeniEbr10 (small blind) folded before Flop
Seat 3: emopokera (big blind) collected ($0.02)
Seat 4: n3olin3 folded before Flop (didn't bet)
Seat 5: LLregs folded before Flop (didn't bet)
Seat 6: brunotga folded before Flop (didn't bet)

PokerStars Zoom Hand #247968226036:  Hold'em No Limit ($0.01/$0.02) - 2023/12/30 22:03:10 WET [2023/12/30 17:03:10 ET]
Table 'Halley' 6-max Seat #1 is the button
Seat 1: Harold_Seven ($0.86 in chips)
Seat 2: dedlove ($2.13 in chips)
Seat 3: LLregs ($11.18 in chips)
Seat 4: 514dw5000 ($1.98 in chips)
Seat 5: 232489410 ($3.61 in chips)
Seat 6: Giocrik ($2.47 in chips)
dedlove: posts small blind $0.01
LLregs: posts big blind $0.02
*** HOLE CARDS ***
Dealt to LLregs [3s Jc]
514dw5000: folds
232489410: folds
Giocrik: folds
Harold_Seven: raises $0.02 to $0.04
dedlove: calls $0.03
LLregs: folds
*** FLOP *** [4s Kd Qh]
dedlove: checks
Harold_Seven: bets $0.08
dedlove: calls $0.08
*** TURN *** [4s Kd Qh] [6d]
dedlove: checks
Harold_Seven: bets $0.20
dedlove: calls $0.20
*** RIVER *** [4s Kd Qh 6d] [Js]
dedlove: checks
Harold_Seven: checks
*** SHOW DOWN ***
dedlove: shows [Kc Jd] (two pair, Kings and Jacks)
Harold_Seven: mucks hand
dedlove collected $0.64 from pot
*** SUMMARY ***
Total pot $0.66 | Rake $0.02
Board [4s Kd Qh 6d Js]
Seat 1: Harold_Seven (button) mucked [Th Qc]
Seat 2: dedlove (small blind) showed [Kc Jd] and won ($0.64) with two pair, Kings and Jacks
Seat 3: LLregs (big blind) folded before Flop
Seat 4: 514dw5000 folded before Flop (didn't bet)
Seat 5: 232489410 folded before Flop (didn't bet)
Seat 6: Giocrik folded before Flop (didn't bet)

PokerStars Zoom Hand #247968234616:  Hold'em No Limit ($0.01/$0.02) - 2023/12/30 22:03:32 WET [2023/12/30 17:03:32 ET]
Table 'Halley' 6-max Seat #1 is the button
Seat 1: Cid s2 ($2.30 in chips)
Seat 2: tinopiola~ ($2.03 in chips)
Seat 3: kakani78 ($2.10 in chips)
Seat 4: LLregs ($11.16 in chips)
Seat 5: mixi08 ($2.14 in chips)
Seat 6: joshs18 ($1.97 in chips)
tinopiola~: posts small blind $0.01
kakani78: posts big blind $0.02
*** HOLE CARDS ***
Dealt to LLregs [7h Qh]
LLregs: folds
mixi08: folds
joshs18: folds
Cid s2: raises $0.02 to $0.04
tinopiola~: folds
kakani78: raises $0.09 to $0.13
Cid s2: calls $0.09
*** FLOP *** [Kd 2c 9s]
kakani78: bets $0.20
Cid s2: calls $0.20
*** TURN *** [Kd 2c 9s] [Js]
kakani78: bets $0.41
Cid s2: calls $0.41
*** RIVER *** [Kd 2c 9s Js] [4h]
kakani78: bets $0.54
Cid s2: calls $0.54
*** SHOW DOWN ***
kakani78: shows [Kh 8h] (a pair of Kings)
Cid s2: mucks hand
kakani78 collected $2.48 from pot
*** SUMMARY ***
Total pot $2.57 | Rake $0.09
Board [Kd 2c 9s Js 4h]
Seat 1: Cid s2 (button) mucked [Kc 5h]
Seat 2: tinopiola~ (small blind) folded before Flop
Seat 3: kakani78 (big blind) showed [Kh 8h] and won ($2.48) with a pair of Kings
Seat 4: LLregs folded before Flop (didn't bet)
Seat 5: mixi08 folded before Flop (didn't bet)
Seat 6: joshs18 folded before Flop (didn't bet)

PokerStars Zoom Hand #247968237541:  Hold'em No Limit ($0.01/$0.02) - 2023/12/30 22:03:39 WET [2023/12/30 17:03:39 ET]
Table 'Halley' 6-max Seat #1 is the button
Seat 1: TMLS7 ($2 in chips)
Seat 2: 232489410 ($2 in chips)
Seat 3: samuelnash ($2.20 in chips)
Seat 4: Weily8 ($1.52 in chips)
Seat 5: Deny0403 ($5.63 in chips)
Seat 6: LLregs ($11.16 in chips)
232489410: posts small blind $0.01
samuelnash: posts big blind $0.02
*** HOLE CARDS ***
Dealt to LLregs [Tc Kd]
Weily8: folds
Deny0403: raises $0.04 to $0.06
LLregs: calls $0.06
TMLS7: folds
232489410: calls $0.05
samuelnash: folds
*** FLOP *** [2h 3h Ac]
232489410: checks
Deny0403: checks
LLregs: checks
*** TURN *** [2h 3h Ac] [9d]
232489410: checks
Deny0403: checks
LLregs: checks
*** RIVER *** [2h 3h Ac 9d] [7d]
232489410: checks
Deny0403: checks
LLregs: checks
*** SHOW DOWN ***
232489410: shows [4d 2d] (a pair of Deuces)
Deny0403: mucks hand
LLregs: mucks hand
232489410 collected $0.19 from pot
*** SUMMARY ***
Total pot $0.20 | Rake $0.01
Board [2h 3h Ac 9d 7d]
Seat 1: TMLS7 (button) folded before Flop (didn't bet)
Seat 2: 232489410 (small blind) showed [4d 2d] and won ($0.19) with a pair of Deuces
Seat 3: samuelnash (big blind) folded before Flop
Seat 4: Weily8 folded before Flop (didn't bet)
Seat 5: Deny0403 mucked [Jh 8h]
Seat 6: LLregs mucked [Tc Kd]

PokerStars Zoom Hand #247968262365:  Hold'em No Limit ($0.01/$0.02) - 2023/12/30 22:04:42 WET [2023/12/30 17:04:42 ET]
Table 'Halley' 6-max Seat #1 is the button
Seat 1: igrok$148 ($0.71 in chips)
Seat 2: LLregs ($11.10 in chips)
Seat 3: Deny0403 ($2.55 in chips)
Seat 4: Cleverson1001 ($2.19 in chips)
Seat 5: Urban2506 ($2.62 in chips)
Seat 6: jbarrios007 ($3.96 in chips)
LLregs: posts small blind $0.01
Deny0403: posts big blind $0.02
*** HOLE CARDS ***
Dealt to LLregs [7h 7c]
Cleverson1001: calls $0.02
Urban2506: folds
jbarrios007: folds
igrok$148: raises $0.06 to $0.08
LLregs: raises $0.12 to $0.20
Deny0403: folds
Cleverson1001: calls $0.18
igrok$148: calls $0.12
*** FLOP *** [6c 3h 6h]
LLregs: checks
Cleverson1001: checks
igrok$148: bets $0.20
LLregs: calls $0.20
Cleverson1001: folds
*** TURN *** [6c 3h 6h] [Qh]
LLregs: checks
igrok$148: bets $0.31 and is all-in
LLregs: calls $0.31
*** RIVER *** [6c 3h 6h Qh] [2s]
*** SHOW DOWN ***
LLregs: shows [7h 7c] (two pair, Sevens and Sixes)
igrok$148: shows [Jh Ac] (a pair of Sixes)
LLregs collected $1.58 from pot
*** SUMMARY ***
Total pot $1.64 | Rake $0.06
Board [6c 3h 6h Qh 2s]
Seat 1: igrok$148 (button) showed [Jh Ac] and lost with a pair of Sixes
Seat 2: LLregs (small blind) showed [7h 7c] and won ($1.58) with two pair, Sevens and Sixes
Seat 3: Deny0403 (big blind) folded before Flop
Seat 4: Cleverson1001 folded on the Flop
Seat 5: Urban2506 folded before Flop (didn't bet)
Seat 6: jbarrios007 folded before Flop (didn't bet)

PokerStars Zoom Hand #247968283639:  Hold'em No Limit ($0.01/$0.02) - 2023/12/30 22:05:36 WET [2023/12/30 17:05:36 ET]
Table 'Halley' 6-max Seat #1 is the button
Seat 1: sTIKs21 ($2.01 in chips)
Seat 2: degelcamus ($2 in chips)
Seat 3: Gaigel ($4.99 in chips)
Seat 4: LLregs ($11.97 in chips)
Seat 5: IngeniEbr10 ($2 in chips)
Seat 6: CMARIUS02 ($1.57 in chips)
degelcamus: posts small blind $0.01
Gaigel: posts big blind $0.02
*** HOLE CARDS ***
Dealt to LLregs [9h 3c]
LLregs: folds
IngeniEbr10: folds
CMARIUS02: folds
sTIKs21: raises $0.03 to $0.05
degelcamus: folds
Gaigel: folds
Uncalled bet ($0.03) returned to sTIKs21
sTIKs21 collected $0.05 from pot
sTIKs21: doesn't show hand
*** SUMMARY ***
Total pot $0.05 | Rake $0
Seat 1: sTIKs21 (button) collected ($0.05)
Seat 2: degelcamus (small blind) folded before Flop
Seat 3: Gaigel (big blind) folded before Flop
Seat 4: LLregs folded before Flop (didn't bet)
Seat 5: IngeniEbr10 folded before Flop (didn't bet)
Seat 6: CMARIUS02 folded before Flop (didn't bet)

PokerStars Zoom Hand #247968293009:  Hold'em No Limit ($0.01/$0.02) - 2023/12/30 22:06:00 WET [2023/12/30 17:06:00 ET]
Table 'Halley' 6-max Seat #1 is the button
Seat 1: LLregs ($11.95 in chips)
Seat 2: 3ener ($4.89 in chips)
Seat 3: NoDenyPanda ($3.52 in chips)
Seat 4: ichithekill ($2.05 in chips)
Seat 5: IngeniEbr10 ($2 in chips)
Seat 6: my sapphire ($3.60 in chips)
3ener: posts small blind $0.01
NoDenyPanda: posts big blind $0.02
*** HOLE CARDS ***
Dealt to LLregs [Ad Qh]
ichithekill: folds
IngeniEbr10: folds
my sapphire: folds
LLregs: raises $0.04 to $0.06
3ener: folds
NoDenyPanda: folds
Uncalled bet ($0.04) returned to LLregs
LLregs collected $0.05 from pot
LLregs: doesn't show hand
*** SUMMARY ***
Total pot $0.05 | Rake $0
Seat 1: LLregs (button) collected ($0.05)
Seat 2: 3ener (small blind) folded before Flop
Seat 3: NoDenyPanda (big blind) folded before Flop
Seat 4: ichithekill folded before Flop (didn't bet)
Seat 5: IngeniEbr10 folded before Flop (didn't bet)
Seat 6: my sapphire folded before Flop (didn't bet)

PokerStars Zoom Hand #247968285573:  Hold'em No Limit ($0.01/$0.02) - 2023/12/30 22:05:41 WET [2023/12/30 17:05:41 ET]
Table 'Halley' 6-max Seat #1 is the button
Seat 1: rrluis1930 ($2 in chips)
Seat 2: yukon Ronald ($2.09 in chips)
Seat 3: LLregs ($11.97 in chips)
Seat 4: Vanti13 ($0.46 in chips)
Seat 5: 3ener ($8.03 in chips)
Seat 6: soulachicon ($3.29 in chips)
yukon Ronald: posts small blind $0.01
LLregs: posts big blind $0.02
*** HOLE CARDS ***
Dealt to LLregs [9h 5h]
Vanti13: folds
3ener: raises $0.02 to $0.04
soulachicon: calls $0.04
rrluis1930: folds
yukon Ronald: folds
LLregs: folds
*** FLOP *** [2c 4c 6c]
3ener: bets $0.04
soulachicon: calls $0.04
*** TURN *** [2c 4c 6c] [Tc]
3ener: checks
soulachicon: bets $0.02
3ener: calls $0.02
*** RIVER *** [2c 4c 6c Tc] [7h]
3ener: checks
soulachicon: checks
*** SHOW DOWN ***
3ener: shows [Kc Th] (a flush, King high)
soulachicon: mucks hand
3ener collected $0.22 from pot
*** SUMMARY ***
Total pot $0.23 | Rake $0.01
Board [2c 4c 6c Tc 7h]
Seat 1: rrluis1930 (button) folded before Flop (didn't bet)
Seat 2: yukon Ronald (small blind) folded before Flop
Seat 3: LLregs (big blind) folded before Flop
Seat 4: Vanti13 folded before Flop (didn't bet)
Seat 5: 3ener showed [Kc Th] and won ($0.22) with a flush, King high
Seat 6: soulachicon mucked [Jh Qc]

PokerStars Zoom Hand #247968302554:  Hold'em No Limit ($0.01/$0.02) - 2023/12/30 22:06:24 WET [2023/12/30 17:06:24 ET]
Table 'Halley' 6-max Seat #1 is the button
Seat 1: conspy84 ($1.77 in chips)
Seat 2: NDX92 ($2.71 in chips)
Seat 3: Bigirii ($1.49 in chips)
Seat 4: AdriPato ($2.34 in chips)
Seat 5: IBRODIAN-ACER ($2.25 in chips)
Seat 6: LLregs ($11.98 in chips)
NDX92: posts small blind $0.01
Bigirii: posts big blind $0.02
*** HOLE CARDS ***
Dealt to LLregs [4s Jd]
AdriPato: folds
IBRODIAN-ACER: folds
LLregs: folds
conspy84: folds
NDX92: raises $0.02 to $0.04
Bigirii: folds
Uncalled bet ($0.02) returned to NDX92
NDX92 collected $0.04 from pot
NDX92: doesn't show hand
*** SUMMARY ***
Total pot $0.04 | Rake $0
Seat 1: conspy84 (button) folded before Flop (didn't bet)
Seat 2: NDX92 (small blind) collected ($0.04)
Seat 3: Bigirii (big blind) folded before Flop
Seat 4: AdriPato folded before Flop (didn't bet)
Seat 5: IBRODIAN-ACER folded before Flop (didn't bet)
Seat 6: LLregs folded before Flop (didn't bet)

PokerStars Zoom Hand #247968304533:  Hold'em No Limit ($0.01/$0.02) - 2023/12/30 22:06:29 WET [2023/12/30 17:06:29 ET]
Table 'Halley' 6-max Seat #1 is the button
Seat 1: LLregs ($11.98 in chips)
Seat 2: shermheadryder ($2.47 in chips)
Seat 3: ImpEdGard ($3.21 in chips)
Seat 4: batya1212 ($2.15 in chips)
Seat 5: kasse112 ($3.91 in chips)
Seat 6: marcos15vargass ($1.86 in chips)
shermheadryder: posts small blind $0.01
ImpEdGard: posts big blind $0.02
*** HOLE CARDS ***
Dealt to LLregs [Kh Qh]
batya1212: folds
kasse112: folds
marcos15vargass: raises $0.04 to $0.06
LLregs: calls $0.06
shermheadryder: folds
ImpEdGard: folds
*** FLOP *** [Jd 8c 2s]
marcos15vargass: bets $0.05
LLregs: calls $0.05
*** TURN *** [Jd 8c 2s] [2d]
marcos15vargass: bets $0.16
LLregs: calls $0.16
*** RIVER *** [Jd 8c 2s 2d] [Kc]
marcos15vargass: checks
LLregs: bets $0.26
marcos15vargass: calls $0.26
*** SHOW DOWN ***
LLregs: shows [Kh Qh] (two pair, Kings and Deuces)
marcos15vargass: shows [Ks Qs] (two pair, Kings and Deuces)
marcos15vargass collected $0.53 from pot
LLregs collected $0.52 from pot
*** SUMMARY ***
Total pot $1.09 | Rake $0.04
Board [Jd 8c 2s 2d Kc]
Seat 1: LLregs (button) showed [Kh Qh] and won ($0.52) with two pair, Kings and Deuces
Seat 2: shermheadryder (small blind) folded before Flop
Seat 3: ImpEdGard (big blind) folded before Flop
Seat 4: batya1212 folded before Flop (didn't bet)
Seat 5: kasse112 folded before Flop (didn't bet)
Seat 6: marcos15vargass showed [Ks Qs] and won ($0.53) with two pair, Kings and Deuces

PokerStars Zoom Hand #247968324597:  Hold'em No Limit ($0.01/$0.02) - 2023/12/30 22:07:20 WET [2023/12/30 17:07:20 ET]
Table 'Halley' 6-max Seat #1 is the button
Seat 1: NoDenyPanda ($3.49 in chips)
Seat 2: LLregs ($11.97 in chips)
Seat 3: PJWALL ($2.30 in chips)
Seat 4: 3Mgasf ($1.87 in chips)
Seat 5: andre8276 ($2 in chips)
Seat 6: carbonero59 ($2.25 in chips)
LLregs: posts small blind $0.01
PJWALL: posts big blind $0.02
*** HOLE CARDS ***
Dealt to LLregs [Ac Ts]
3Mgasf: raises $0.06 to $0.08
andre8276: folds
carbonero59: folds
NoDenyPanda: folds
LLregs: calls $0.07
PJWALL: folds
*** FLOP *** [7h 6s Js]
LLregs: checks
3Mgasf: bets $0.20
LLregs: folds
Uncalled bet ($0.20) returned to 3Mgasf
3Mgasf collected $0.17 from pot
3Mgasf: doesn't show hand
*** SUMMARY ***
Total pot $0.18 | Rake $0.01
Board [7h 6s Js]
Seat 1: NoDenyPanda (button) folded before Flop (didn't bet)
Seat 2: LLregs (small blind) folded on the Flop
Seat 3: PJWALL (big blind) folded before Flop
Seat 4: 3Mgasf collected ($0.17)
Seat 5: andre8276 folded before Flop (didn't bet)
Seat 6: carbonero59 folded before Flop (didn't bet)

PokerStars Zoom Hand #247968336601:  Hold'em No Limit ($0.01/$0.02) - 2023/12/30 22:07:50 WET [2023/12/30 17:07:50 ET]
Table 'Halley' 6-max Seat #1 is the button
Seat 1: jbarrios007 ($1.69 in chips)
Seat 2: elcuchu168 ($1.76 in chips)
Seat 3: IngeniEbr10 ($2.08 in chips)
Seat 4: AdriPato ($2.44 in chips)
Seat 5: LLregs ($11.89 in chips)
Seat 6: Josiel Dahmer ($1.55 in chips)
elcuchu168: posts small blind $0.01
IngeniEbr10: posts big blind $0.02
*** HOLE CARDS ***
Dealt to LLregs [Th Js]
AdriPato: folds
LLregs: raises $0.04 to $0.06
Josiel Dahmer: folds
jbarrios007: calls $0.06
elcuchu168: folds
IngeniEbr10: folds
*** FLOP *** [9h Ts Kd]
LLregs: bets $0.03
jbarrios007: calls $0.03
*** TURN *** [9h Ts Kd] [Jd]
LLregs: bets $0.04
jbarrios007: folds
Uncalled bet ($0.04) returned to LLregs
LLregs collected $0.20 from pot
LLregs: doesn't show hand
*** SUMMARY ***
Total pot $0.21 | Rake $0.01
Board [9h Ts Kd Jd]
Seat 1: jbarrios007 (button) folded on the Turn
Seat 2: elcuchu168 (small blind) folded before Flop
Seat 3: IngeniEbr10 (big blind) folded before Flop
Seat 4: AdriPato folded before Flop (didn't bet)
Seat 5: LLregs collected ($0.20)
Seat 6: Josiel Dahmer folded before Flop (didn't bet)

PokerStars Zoom Hand #247968355111:  Hold'em No Limit ($0.01/$0.02) - 2023/12/30 22:08:37 WET [2023/12/30 17:08:37 ET]
Table 'Halley' 6-max Seat #1 is the button
Seat 1: The hack ($3.07 in chips)
Seat 2: klio6tavia ($2.61 in chips)
Seat 3: J.V.B.2327 ($1.29 in chips)
Seat 4: maritokpo ($2.57 in chips)
Seat 5: LLregs ($12 in chips)
Seat 6: sTIKs21 ($2.16 in chips)
klio6tavia: posts small blind $0.01
J.V.B.2327: posts big blind $0.02
*** HOLE CARDS ***
Dealt to LLregs [5d Td]
maritokpo: folds
LLregs: folds
sTIKs21: folds
The hack: raises $0.04 to $0.06
klio6tavia: calls $0.05
J.V.B.2327: folds
*** FLOP *** [8s 7h 5c]
klio6tavia: checks
The hack: bets $0.06
klio6tavia: calls $0.06
*** TURN *** [8s 7h 5c] [Ks]
klio6tavia: checks
The hack: checks
*** RIVER *** [8s 7h 5c Ks] [Ts]
klio6tavia: checks
The hack: checks
*** SHOW DOWN ***
klio6tavia: shows [Ad 9d] (high card Ace)
The hack: shows [2d Kd] (a pair of Kings)
The hack collected $0.25 from pot
*** SUMMARY ***
Total pot $0.26 | Rake $0.01
Board [8s 7h 5c Ks Ts]
Seat 1: The hack (button) showed [2d Kd] and won ($0.25) with a pair of Kings
Seat 2: klio6tavia (small blind) showed [Ad 9d] and lost with high card Ace
Seat 3: J.V.B.2327 (big blind) folded before Flop
Seat 4: maritokpo folded before Flop (didn't bet)
Seat 5: LLregs folded before Flop (didn't bet)
Seat 6: sTIKs21 folded before Flop (didn't bet)

PokerStars Zoom Hand #247968356644:  Hold'em No Limit ($0.01/$0.02) - 2023/12/30 22:08:41 WET [2023/12/30 17:08:41 ET]
Table 'Halley' 6-max Seat #1 is the button
Seat 1: IngeniEbr10 ($2.05 in chips)
Seat 2: Ilikefossil ($3.96 in chips)
Seat 3: LLregs ($12 in chips)
Seat 4: ZappingZebras ($2.26 in chips)
Seat 5: red_81_2009 ($0.80 in chips)
Seat 6: LineScald ($1.06 in chips)
Ilikefossil: posts small blind $0.01
LLregs: posts big blind $0.02
*** HOLE CARDS ***
Dealt to LLregs [Qd 4s]
ZappingZebras: folds
red_81_2009: folds
LineScald: folds
IngeniEbr10: raises $0.03 to $0.05
Ilikefossil: folds
LLregs: calls $0.03
*** FLOP *** [Ts Jh Jd]
LLregs: checks
IngeniEbr10: bets $0.05
LLregs: calls $0.05
*** TURN *** [Ts Jh Jd] [Js]
LLregs: checks
IngeniEbr10: checks
*** RIVER *** [Ts Jh Jd Js] [Td]
LLregs: checks
IngeniEbr10: checks
*** SHOW DOWN ***
LLregs: shows [Qd 4s] (a full house, Jacks full of Tens)
IngeniEbr10: shows [3c Qc] (a full house, Jacks full of Tens)
LLregs collected $0.10 from pot
IngeniEbr10 collected $0.10 from pot
*** SUMMARY ***
Total pot $0.21 | Rake $0.01
Board [Ts Jh Jd Js Td]
Seat 1: IngeniEbr10 (button) showed [3c Qc] and won ($0.10) with a full house, Jacks full of Tens
Seat 2: Ilikefossil (small blind) folded before Flop
Seat 3: LLregs (big blind) showed [Qd 4s] and won ($0.10) with a full house, Jacks full of Tens
Seat 4: ZappingZebras folded before Flop (didn't bet)
Seat 5: red_81_2009 folded before Flop (didn't bet)
Seat 6: LineScald folded before Flop (didn't bet)

PokerStars Zoom Hand #247968372344:  Hold'em No Limit ($0.01/$0.02) - 2023/12/30 22:09:21 WET [2023/12/30 17:09:21 ET]
Table 'Halley' 6-max Seat #1 is the button
Seat 1: my sapphire ($3.11 in chips)
Seat 2: LLregs ($12 in chips)
Seat 3: TamiSieche ($3.35 in chips)
Seat 4: diokyn ($2.02 in chips)
Seat 5: YHell-XL ($5.31 in chips)
Seat 6: greyman34940 ($1.99 in chips)
LLregs: posts small blind $0.01
TamiSieche: posts big blind $0.02
*** HOLE CARDS ***
Dealt to LLregs [8h 6h]
diokyn: folds
YHell-XL: folds
greyman34940: folds
my sapphire: folds
LLregs: raises $0.04 to $0.06
TamiSieche: folds
Uncalled bet ($0.04) returned to LLregs
LLregs collected $0.04 from pot
LLregs: doesn't show hand
*** SUMMARY ***
Total pot $0.04 | Rake $0
Seat 1: my sapphire (button) folded before Flop (didn't bet)
Seat 2: LLregs (small blind) collected ($0.04)
Seat 3: TamiSieche (big blind) folded before Flop
Seat 4: diokyn folded before Flop (didn't bet)
Seat 5: YHell-XL folded before Flop (didn't bet)
Seat 6: greyman34940 folded before Flop (didn't bet)

PokerStars Zoom Hand #247968383830:  Hold'em No Limit ($0.01/$0.02) - 2023/12/30 22:09:50 WET [2023/12/30 17:09:50 ET]
Table 'Halley' 6-max Seat #1 is the button
Seat 1: NoDenyPanda ($2.01 in chips)
Seat 2: andre8276 ($3 in chips)
Seat 3: shermheadryder ($2.33 in chips)
Seat 4: null11 ($1.42 in chips)
Seat 5: LLregs ($12.02 in chips)
Seat 6: ZiggyBoy90 ($3.92 in chips)
andre8276: posts small blind $0.01
shermheadryder: posts big blind $0.02
*** HOLE CARDS ***
Dealt to LLregs [3h 9h]
null11: folds
LLregs: folds
ZiggyBoy90: folds
NoDenyPanda: folds
andre8276: folds
Uncalled bet ($0.01) returned to shermheadryder
shermheadryder collected $0.02 from pot
shermheadryder: doesn't show hand
*** SUMMARY ***
Total pot $0.02 | Rake $0
Seat 1: NoDenyPanda (button) folded before Flop (didn't bet)
Seat 2: andre8276 (small blind) folded before Flop
Seat 3: shermheadryder (big blind) collected ($0.02)
Seat 4: null11 folded before Flop (didn't bet)
Seat 5: LLregs folded before Flop (didn't bet)
Seat 6: ZiggyBoy90 folded before Flop (didn't bet)

PokerStars Zoom Hand #247968380716:  Hold'em No Limit ($0.01/$0.02) - 2023/12/30 22:09:42 WET [2023/12/30 17:09:42 ET]
Table 'Halley' 6-max Seat #1 is the button
Seat 1: elcuchu168 ($1.69 in chips)
Seat 2: nosiar ($2.12 in chips)
Seat 3: KubaForNever ($0.56 in chips)
Seat 4: BETH257 ($1 in chips)
Seat 5: IBRODIAN-ACER ($2.04 in chips)
Seat 6: LLregs ($12.02 in chips)
nosiar: posts small blind $0.01
KubaForNever: posts big blind $0.02
*** HOLE CARDS ***
Dealt to LLregs [2c 8d]
BETH257: folds
IBRODIAN-ACER: folds
LLregs: folds
elcuchu168: raises $0.04 to $0.06
nosiar: folds
KubaForNever: folds
Uncalled bet ($0.04) returned to elcuchu168
elcuchu168 collected $0.05 from pot
elcuchu168: doesn't show hand
*** SUMMARY ***
Total pot $0.05 | Rake $0
Seat 1: elcuchu168 (button) collected ($0.05)
Seat 2: nosiar (small blind) folded before Flop
Seat 3: KubaForNever (big blind) folded before Flop
Seat 4: BETH257 folded before Flop (didn't bet)
Seat 5: IBRODIAN-ACER folded before Flop (didn't bet)
Seat 6: LLregs folded before Flop (didn't bet)

PokerStars Zoom Hand #247968385436:  Hold'em No Limit ($0.01/$0.02) - 2023/12/30 22:09:54 WET [2023/12/30 17:09:54 ET]
Table 'Halley' 6-max Seat #1 is the button
Seat 1: Harold_Seven ($1.12 in chips)
Seat 2: andre8276 ($1.42 in chips)
Seat 3: ChessMaster2002 ($2.14 in chips)
Seat 4: LLregs ($12.02 in chips)
Seat 5: IngeniEbr10 ($2 in chips)
Seat 6: arkins00 ($2.48 in chips)
andre8276: posts small blind $0.01
ChessMaster2002: posts big blind $0.02
*** HOLE CARDS ***
Dealt to LLregs [9d 4d]
LLregs: folds
IngeniEbr10: folds
arkins00: folds
Harold_Seven: raises $0.02 to $0.04
andre8276: folds
ChessMaster2002: calls $0.02
*** FLOP *** [9s Th Tc]
ChessMaster2002: checks
Harold_Seven: bets $0.04
ChessMaster2002: folds
Uncalled bet ($0.04) returned to Harold_Seven
Harold_Seven collected $0.09 from pot
Harold_Seven: doesn't show hand
*** SUMMARY ***
Total pot $0.09 | Rake $0
Board [9s Th Tc]
Seat 1: Harold_Seven (button) collected ($0.09)
Seat 2: andre8276 (small blind) folded before Flop
Seat 3: ChessMaster2002 (big blind) folded on the Flop
Seat 4: LLregs folded before Flop (didn't bet)
Seat 5: IngeniEbr10 folded before Flop (didn't bet)
Seat 6: arkins00 folded before Flop (didn't bet)

PokerStars Zoom Hand #247968370689:  Hold'em No Limit ($0.01/$0.02) - 2023/12/30 22:09:17 WET [2023/12/30 17:09:17 ET]
Table 'Halley' 6-max Seat #1 is the button
Seat 1: HarryHaller77 ($2 in chips)
Seat 2: BsbFox ($3.74 in chips)
Seat 3: Libin13 ($5.21 in chips)
Seat 4: LLregs ($12 in chips)
Seat 5: NoDenyPanda ($2.02 in chips)
Seat 6: Harold_Seven ($0.84 in chips)
BsbFox: posts small blind $0.01
Libin13: posts big blind $0.02
*** HOLE CARDS ***
Dealt to LLregs [2d Kd]
LLregs: folds
NoDenyPanda: folds
Harold_Seven: folds
HarryHaller77: raises $0.03 to $0.05
BsbFox: calls $0.04
Libin13: folds
*** FLOP *** [6s Tc 8d]
BsbFox: checks
HarryHaller77: bets $0.06
BsbFox: calls $0.06
*** TURN *** [6s Tc 8d] [Jh]
BsbFox: checks
HarryHaller77: bets $0.17
BsbFox: calls $0.17
*** RIVER *** [6s Tc 8d Jh] [4c]
BsbFox: checks
HarryHaller77: bets $0.42
BsbFox: calls $0.42
*** SHOW DOWN ***
HarryHaller77: shows [Qd 3d] (high card Queen)
BsbFox: shows [8c 6c] (two pair, Eights and Sixes)
BsbFox collected $1.37 from pot
*** SUMMARY ***
Total pot $1.42 | Rake $0.05
Board [6s Tc 8d Jh 4c]
Seat 1: HarryHaller77 (button) showed [Qd 3d] and lost with high card Queen
Seat 2: BsbFox (small blind) showed [8c 6c] and won ($1.37) with two pair, Eights and Sixes
Seat 3: Libin13 (big blind) folded before Flop
Seat 4: LLregs folded before Flop (didn't bet)
Seat 5: NoDenyPanda folded before Flop (didn't bet)
Seat 6: Harold_Seven folded before Flop (didn't bet)

PokerStars Zoom Hand #247968388167:  Hold'em No Limit ($0.01/$0.02) - 2023/12/30 22:10:01 WET [2023/12/30 17:10:01 ET]
Table 'Halley' 6-max Seat #1 is the button
Seat 1: ichithekill ($2 in chips)
Seat 2: my sapphire ($3.06 in chips)
Seat 3: r3v3rs3f3r3t ($2 in chips)
Seat 4: jbarrios007 ($2.58 in chips)
Seat 5: degelcamus ($2.03 in chips)
Seat 6: LLregs ($12.02 in chips)
my sapphire: posts small blind $0.01
r3v3rs3f3r3t: posts big blind $0.02
*** HOLE CARDS ***
Dealt to LLregs [Jc Qd]
jbarrios007: folds
degelcamus: folds
LLregs: raises $0.04 to $0.06
ichithekill: folds
my sapphire: folds
r3v3rs3f3r3t: folds
Uncalled bet ($0.04) returned to LLregs
LLregs collected $0.05 from pot
LLregs: doesn't show hand
*** SUMMARY ***
Total pot $0.05 | Rake $0
Seat 1: ichithekill (button) folded before Flop (didn't bet)
Seat 2: my sapphire (small blind) folded before Flop
Seat 3: r3v3rs3f3r3t (big blind) folded before Flop
Seat 4: jbarrios007 folded before Flop (didn't bet)
Seat 5: degelcamus folded before Flop (didn't bet)
Seat 6: LLregs collected ($0.05)

PokerStars Zoom Hand #247968382303:  Hold'em No Limit ($0.01/$0.02) - 2023/12/30 22:09:46 WET [2023/12/30 17:09:46 ET]
Table 'Halley' 6-max Seat #1 is the button
Seat 1: LLregs ($12.02 in chips)
Seat 2: degelcamus ($2.07 in chips)
Seat 3: marcos15vargass ($2 in chips)
Seat 4: Molineux2002 ($2.38 in chips)
Seat 5: Tha_Saint7 ($3.75 in chips)
Seat 6: IBRODIAN-ACER ($2.04 in chips)
degelcamus: posts small blind $0.01
marcos15vargass: posts big blind $0.02
*** HOLE CARDS ***
Dealt to LLregs [7d 2d]
Molineux2002: raises $0.04 to $0.06
Tha_Saint7: folds
IBRODIAN-ACER: calls $0.06
LLregs: folds
degelcamus: folds
marcos15vargass: folds
*** FLOP *** [5h Qc 2c]
Molineux2002: checks
IBRODIAN-ACER: checks
*** TURN *** [5h Qc 2c] [Tc]
Molineux2002: checks
IBRODIAN-ACER: bets $0.10
Molineux2002: folds
Uncalled bet ($0.10) returned to IBRODIAN-ACER
IBRODIAN-ACER collected $0.14 from pot
IBRODIAN-ACER: doesn't show hand
*** SUMMARY ***
Total pot $0.15 | Rake $0.01
Board [5h Qc 2c Tc]
Seat 1: LLregs (button) folded before Flop (didn't bet)
Seat 2: degelcamus (small blind) folded before Flop
Seat 3: marcos15vargass (big blind) folded before Flop
Seat 4: Molineux2002 folded on the Turn
Seat 5: Tha_Saint7 folded before Flop (didn't bet)
Seat 6: IBRODIAN-ACER collected ($0.14)

PokerStars Zoom Hand #247968398588:  Hold'em No Limit ($0.01/$0.02) - 2023/12/30 22:10:27 WET [2023/12/30 17:10:27 ET]
Table 'Halley' 6-max Seat #1 is the button
Seat 1: Urban2506 ($2.33 in chips)
Seat 2: freefrolloff ($2 in chips)
Seat 3: LLregs ($12.05 in chips)
Seat 4: hybridi ($3.52 in chips)
Seat 5: ichithekill ($2 in chips)
Seat 6: Quantum771 ($2.27 in chips)
freefrolloff: posts small blind $0.01
LLregs: posts big blind $0.02
*** HOLE CARDS ***
Dealt to LLregs [2s 2d]
hybridi: folds
ichithekill: folds
Quantum771: folds
Urban2506: calls $0.02
freefrolloff: folds
LLregs: checks
*** FLOP *** [Qs As 7c]
LLregs: checks
Urban2506: bets $0.05
LLregs: folds
Uncalled bet ($0.05) returned to Urban2506
Urban2506 collected $0.05 from pot
Urban2506: doesn't show hand
*** SUMMARY ***
Total pot $0.05 | Rake $0
Board [Qs As 7c]
Seat 1: Urban2506 (button) collected ($0.05)
Seat 2: freefrolloff (small blind) folded before Flop
Seat 3: LLregs (big blind) folded on the Flop
Seat 4: hybridi folded before Flop (didn't bet)
Seat 5: ichithekill folded before Flop (didn't bet)
Seat 6: Quantum771 folded before Flop (didn't bet)

PokerStars Zoom Hand #247968407246:  Hold'em No Limit ($0.01/$0.02) - 2023/12/30 22:10:49 WET [2023/12/30 17:10:49 ET]
Table 'Halley' 6-max Seat #1 is the button
Seat 1: 5ars33r ($2.72 in chips)
Seat 2: LLregs ($12.03 in chips)
Seat 3: batya1212 ($2.23 in chips)
Seat 4: HarryHaller77 ($2.01 in chips)
Seat 5: robbert12112 ($1.78 in chips)
Seat 6: M1k3B4gUnc1nh4 ($2.03 in chips)
LLregs: posts small blind $0.01
batya1212: posts big blind $0.02
*** HOLE CARDS ***
Dealt to LLregs [Td 6h]
HarryHaller77: raises $0.02 to $0.04
robbert12112: folds
M1k3B4gUnc1nh4: folds
5ars33r: folds
LLregs: folds
batya1212: folds
Uncalled bet ($0.02) returned to HarryHaller77
HarryHaller77 collected $0.05 from pot
HarryHaller77: doesn't show hand
*** SUMMARY ***
Total pot $0.05 | Rake $0
Seat 1: 5ars33r (button) folded before Flop (didn't bet)
Seat 2: LLregs (small blind) folded before Flop
Seat 3: batya1212 (big blind) folded before Flop
Seat 4: HarryHaller77 collected ($0.05)
Seat 5: robbert12112 folded before Flop (didn't bet)
Seat 6: M1k3B4gUnc1nh4 folded before Flop (didn't bet)

PokerStars Zoom Hand #247968409998:  Hold'em No Limit ($0.01/$0.02) - 2023/12/30 22:10:56 WET [2023/12/30 17:10:56 ET]
Table 'Halley' 6-max Seat #1 is the button
Seat 1: LLregs ($12.02 in chips)
Seat 2: conspy84 ($1.77 in chips)
Seat 3: kasse112 ($3.97 in chips)
Seat 4: sTIKs21 ($2.63 in chips)
Seat 5: Quantum771 ($2.28 in chips)
Seat 6: Dimoni797979 ($5.84 in chips)
conspy84: posts small blind $0.01
kasse112: posts big blind $0.02
*** HOLE CARDS ***
Dealt to LLregs [Kc Tc]
sTIKs21: raises $0.04 to $0.06
Quantum771: folds
Dimoni797979: folds
LLregs: raises $0.12 to $0.18
conspy84: folds
kasse112: folds
sTIKs21: folds
Uncalled bet ($0.12) returned to LLregs
LLregs collected $0.15 from pot
LLregs: doesn't show hand
*** SUMMARY ***
Total pot $0.15 | Rake $0
Seat 1: LLregs (button) collected ($0.15)
Seat 2: conspy84 (small blind) folded before Flop
Seat 3: kasse112 (big blind) folded before Flop
Seat 4: sTIKs21 folded before Flop
Seat 5: Quantum771 folded before Flop (didn't bet)
Seat 6: Dimoni797979 folded before Flop (didn't bet)

PokerStars Zoom Hand #247968418692:  Hold'em No Limit ($0.01/$0.02) - 2023/12/30 22:11:18 WET [2023/12/30 17:11:18 ET]
Table 'Halley' 6-max Seat #1 is the button
Seat 1: degelcamus ($2.03 in chips)
Seat 2: ZiggyBoy90 ($2 in chips)
Seat 3: MichalG1 ($1.23 in chips)
Seat 4: 3ener ($4.24 in chips)
Seat 5: DenyLi ($2.09 in chips)
Seat 6: LLregs ($12.11 in chips)
ZiggyBoy90: posts small blind $0.01
MichalG1: posts big blind $0.02
*** HOLE CARDS ***
Dealt to LLregs [Ad 6c]
3ener: raises $0.03 to $0.05
DenyLi: folds
LLregs: folds
degelcamus: folds
ZiggyBoy90: folds
MichalG1: folds
Uncalled bet ($0.03) returned to 3ener
3ener collected $0.05 from pot
3ener: doesn't show hand
*** SUMMARY ***
Total pot $0.05 | Rake $0
Seat 1: degelcamus (button) folded before Flop (didn't bet)
Seat 2: ZiggyBoy90 (small blind) folded before Flop
Seat 3: MichalG1 (big blind) folded before Flop
Seat 4: 3ener collected ($0.05)
Seat 5: DenyLi folded before Flop (didn't bet)
Seat 6: LLregs folded before Flop (didn't bet)

PokerStars Zoom Hand #247968408564:  Hold'em No Limit ($0.01/$0.02) - 2023/12/30 22:10:53 WET [2023/12/30 17:10:53 ET]
Table 'Halley' 6-max Seat #1 is the button
Seat 1: Kamylo20 ($2 in chips)
Seat 2: freefrolloff ($1.97 in chips)
Seat 3: IBRODIAN-ACER ($2.66 in chips)
Seat 4: LLregs ($12.02 in chips)
Seat 5: OMG77777 ($3.61 in chips)
Seat 6: n3olin3 ($0.97 in chips)
freefrolloff: posts small blind $0.01
IBRODIAN-ACER: posts big blind $0.02
*** HOLE CARDS ***
Dealt to LLregs [6s 4s]
LLregs: folds
OMG77777: raises $0.04 to $0.06
n3olin3: folds
Kamylo20: folds
freefrolloff: folds
IBRODIAN-ACER: calls $0.04
*** FLOP *** [6c 8d Kc]
IBRODIAN-ACER: checks
OMG77777: checks
*** TURN *** [6c 8d Kc] [7c]
IBRODIAN-ACER: bets $0.04
OMG77777: calls $0.04
*** RIVER *** [6c 8d Kc 7c] [Ac]
IBRODIAN-ACER: bets $0.07
OMG77777: calls $0.07
*** SHOW DOWN ***
IBRODIAN-ACER: shows [Ts Jc] (a flush, Ace high)
OMG77777: mucks hand
IBRODIAN-ACER collected $0.34 from pot
*** SUMMARY ***
Total pot $0.35 | Rake $0.01
Board [6c 8d Kc 7c Ac]
Seat 1: Kamylo20 (button) folded before Flop (didn't bet)
Seat 2: freefrolloff (small blind) folded before Flop
Seat 3: IBRODIAN-ACER (big blind) showed [Ts Jc] and won ($0.34) with a flush, Ace high
Seat 4: LLregs folded before Flop (didn't bet)
Seat 5: OMG77777 mucked [Tc Js]
Seat 6: n3olin3 folded before Flop (didn't bet)

PokerStars Zoom Hand #247968420174:  Hold'em No Limit ($0.01/$0.02) - 2023/12/30 22:11:22 WET [2023/12/30 17:11:22 ET]
Table 'Halley' 6-max Seat #1 is the button
Seat 1: MrZombieOO ($7.66 in chips)
Seat 2: 5ars33r ($2.72 in chips)
Seat 3: LLregs ($12.11 in chips)
Seat 4: greyman34940 ($1.97 in chips)
Seat 5: degelcamus ($2 in chips)
Seat 6: isaeg ($5.39 in chips)
5ars33r: posts small blind $0.01
LLregs: posts big blind $0.02
*** HOLE CARDS ***
Dealt to LLregs [7s 7d]
greyman34940: raises $0.04 to $0.06
degelcamus: folds
isaeg: folds
MrZombieOO: folds
5ars33r: folds
LLregs: raises $0.14 to $0.20
greyman34940: calls $0.14
*** FLOP *** [Kh 3s 8s]
LLregs: checks
greyman34940: bets $0.20
LLregs: folds
Uncalled bet ($0.20) returned to greyman34940
greyman34940 collected $0.40 from pot
greyman34940: doesn't show hand
*** SUMMARY ***
Total pot $0.41 | Rake $0.01
Board [Kh 3s 8s]
Seat 1: MrZombieOO (button) folded before Flop (didn't bet)
Seat 2: 5ars33r (small blind) folded before Flop
Seat 3: LLregs (big blind) folded on the Flop
Seat 4: greyman34940 collected ($0.40)
Seat 5: degelcamus folded before Flop (didn't bet)
Seat 6: isaeg folded before Flop (didn't bet)

PokerStars Zoom Hand #247968438664:  Hold'em No Limit ($0.01/$0.02) - 2023/12/30 22:12:09 WET [2023/12/30 17:12:09 ET]
Table 'Halley' 6-max Seat #1 is the button
Seat 1: Giocrik ($1.74 in chips)
Seat 2: Str1kerOK ($2.03 in chips)
Seat 3: andre8276 ($1.58 in chips)
Seat 4: bubis_udr ($1.01 in chips)
Seat 5: LLregs ($11.91 in chips)
Seat 6: IngeniEbr10 ($2.03 in chips)
Str1kerOK: posts small blind $0.01
andre8276: posts big blind $0.02
*** HOLE CARDS ***
Dealt to LLregs [Td Jh]
bubis_udr: calls $0.02
LLregs: folds
IngeniEbr10: folds
Giocrik: folds
Str1kerOK: folds
andre8276: checks
*** FLOP *** [3d Kh 3c]
andre8276: checks
bubis_udr: bets $0.02
andre8276: folds
Uncalled bet ($0.02) returned to bubis_udr
bubis_udr collected $0.05 from pot
bubis_udr: doesn't show hand
*** SUMMARY ***
Total pot $0.05 | Rake $0
Board [3d Kh 3c]
Seat 1: Giocrik (button) folded before Flop (didn't bet)
Seat 2: Str1kerOK (small blind) folded before Flop
Seat 3: andre8276 (big blind) folded on the Flop
Seat 4: bubis_udr collected ($0.05)
Seat 5: LLregs folded before Flop (didn't bet)
Seat 6: IngeniEbr10 folded before Flop (didn't bet)

PokerStars Zoom Hand #247968441937:  Hold'em No Limit ($0.01/$0.02) - 2023/12/30 22:12:17 WET [2023/12/30 17:12:17 ET]
Table 'Halley' 6-max Seat #1 is the button
Seat 1: LLregs ($11.91 in chips)
Seat 2: 42Oedipius ($2.12 in chips)
Seat 3: 3ener ($4.16 in chips)
Seat 4: NoDenyPanda ($2.04 in chips)
Seat 5: HarryHaller77 ($2.03 in chips)
Seat 6: Mavis Ann ($1.15 in chips)
42Oedipius: posts small blind $0.01
3ener: posts big blind $0.02
*** HOLE CARDS ***
Dealt to LLregs [9c Jc]
NoDenyPanda: raises $0.04 to $0.06
HarryHaller77: folds
Mavis Ann: folds
LLregs: calls $0.06
42Oedipius: calls $0.05
3ener: folds
*** FLOP *** [7h Th Jd]
42Oedipius: bets $0.06
NoDenyPanda: calls $0.06
LLregs: raises $0.14 to $0.20
42Oedipius: calls $0.14
NoDenyPanda: folds
*** TURN *** [7h Th Jd] [4d]
42Oedipius: bets $0.32
LLregs: calls $0.32
*** RIVER *** [7h Th Jd 4d] [9h]
42Oedipius: checks
LLregs: bets $0.60
42Oedipius: folds
Uncalled bet ($0.60) returned to LLregs
LLregs collected $1.25 from pot
LLregs: doesn't show hand
*** SUMMARY ***
Total pot $1.30 | Rake $0.05
Board [7h Th Jd 4d 9h]
Seat 1: LLregs (button) collected ($1.25)
Seat 2: 42Oedipius (small blind) folded on the River
Seat 3: 3ener (big blind) folded before Flop
Seat 4: NoDenyPanda folded on the Flop
Seat 5: HarryHaller77 folded before Flop (didn't bet)
Seat 6: Mavis Ann folded before Flop (didn't bet)

PokerStars Zoom Hand #247968483892:  Hold'em No Limit ($0.01/$0.02) - 2023/12/30 22:14:04 WET [2023/12/30 17:14:04 ET]
Table 'Halley' 6-max Seat #1 is the button
Seat 1: my sapphire ($2.26 in chips)
Seat 2: Tinchocabj35 ($4.61 in chips)
Seat 3: Deny0403 ($4.29 in chips)
Seat 4: DenyLi ($2.19 in chips)
Seat 5: FlyingAm1sh ($5.01 in chips)
Seat 6: LLregs ($12.58 in chips)
Tinchocabj35: posts small blind $0.01
Deny0403: posts big blind $0.02
*** HOLE CARDS ***
Dealt to LLregs [7d 6c]
DenyLi: folds
FlyingAm1sh: raises $0.03 to $0.05
LLregs: folds
my sapphire: folds
Tinchocabj35: folds
Deny0403: folds
Uncalled bet ($0.03) returned to FlyingAm1sh
FlyingAm1sh collected $0.05 from pot
FlyingAm1sh: doesn't show hand
*** SUMMARY ***
Total pot $0.05 | Rake $0
Seat 1: my sapphire (button) folded before Flop (didn't bet)
Seat 2: Tinchocabj35 (small blind) folded before Flop
Seat 3: Deny0403 (big blind) folded before Flop
Seat 4: DenyLi folded before Flop (didn't bet)
Seat 5: FlyingAm1sh collected ($0.05)
Seat 6: LLregs folded before Flop (didn't bet)

PokerStars Zoom Hand #247968485383:  Hold'em No Limit ($0.01/$0.02) - 2023/12/30 22:14:08 WET [2023/12/30 17:14:08 ET]
Table 'Halley' 6-max Seat #1 is the button
Seat 1: Szklana.poker ($2 in chips)
Seat 2: LLregs ($12.58 in chips)
Seat 3: andre8276 ($1.99 in chips)
Seat 4: 3ener ($5.54 in chips)
Seat 5: Cleverson1001 ($1.27 in chips)
Seat 6: 888lifeIS ($2.91 in chips)
LLregs: posts small blind $0.01
andre8276: posts big blind $0.02
*** HOLE CARDS ***
Dealt to LLregs [As 8d]
3ener: folds
Cleverson1001: folds
888lifeIS: raises $0.02 to $0.04
Szklana.poker: calls $0.04
LLregs: folds
andre8276: folds
*** FLOP *** [Jh Qs Tc]
888lifeIS: bets $0.07
Szklana.poker: calls $0.07
*** TURN *** [Jh Qs Tc] [Ah]
888lifeIS: checks
Szklana.poker: bets $0.12
888lifeIS: folds
Uncalled bet ($0.12) returned to Szklana.poker
Szklana.poker collected $0.24 from pot
Szklana.poker: doesn't show hand
*** SUMMARY ***
Total pot $0.25 | Rake $0.01
Board [Jh Qs Tc Ah]
Seat 1: Szklana.poker (button) collected ($0.24)
Seat 2: LLregs (small blind) folded before Flop
Seat 3: andre8276 (big blind) folded before Flop
Seat 4: 3ener folded before Flop (didn't bet)
Seat 5: Cleverson1001 folded before Flop (didn't bet)
Seat 6: 888lifeIS folded on the Turn

PokerStars Zoom Hand #247968489678:  Hold'em No Limit ($0.01/$0.02) - 2023/12/30 22:14:19 WET [2023/12/30 17:14:19 ET]
Table 'Halley' 6-max Seat #1 is the button
Seat 1: HarryHaller77 ($2 in chips)
Seat 2: jjuul ($4.60 in chips)
Seat 3: LLregs ($12.57 in chips)
Seat 4: Helsbusch ($0.17 in chips)
Seat 5: makabresku ($1.23 in chips)
Seat 6: nosiar ($2.99 in chips)
jjuul: posts small blind $0.01
LLregs: posts big blind $0.02
*** HOLE CARDS ***
Dealt to LLregs [Qs Kh]
Helsbusch: folds
makabresku: raises $0.04 to $0.06
nosiar: folds
HarryHaller77: folds
jjuul: folds
LLregs: calls $0.04
*** FLOP *** [7d 6s 4h]
LLregs: checks
makabresku: bets $0.07
LLregs: folds
Uncalled bet ($0.07) returned to makabresku
makabresku collected $0.13 from pot
makabresku: doesn't show hand
*** SUMMARY ***
Total pot $0.13 | Rake $0
Board [7d 6s 4h]
Seat 1: HarryHaller77 (button) folded before Flop (didn't bet)
Seat 2: jjuul (small blind) folded before Flop
Seat 3: LLregs (big blind) folded on the Flop
Seat 4: Helsbusch folded before Flop (didn't bet)
Seat 5: makabresku collected ($0.13)
Seat 6: nosiar folded before Flop (didn't bet)

PokerStars Zoom Hand #247968503696:  Hold'em No Limit ($0.01/$0.02) - 2023/12/30 22:14:55 WET [2023/12/30 17:14:55 ET]
Table 'Halley' 6-max Seat #1 is the button
Seat 1: karprinic ($0.97 in chips)
Seat 2: danival2 ($7.10 in chips)
Seat 3: batya1212 ($2.35 in chips)
Seat 4: LLregs ($12.51 in chips)
Seat 5: VitorSchuh ($4.57 in chips)
Seat 6: erikpavon ($2.03 in chips)
danival2: posts small blind $0.01
batya1212: posts big blind $0.02
*** HOLE CARDS ***
Dealt to LLregs [Qc Jd]
LLregs: raises $0.04 to $0.06
VitorSchuh: calls $0.06
erikpavon: folds
karprinic: folds
danival2: folds
batya1212: raises $0.19 to $0.25
LLregs: folds
VitorSchuh: calls $0.19
*** FLOP *** [6h Ts 9s]
batya1212: bets $0.32
VitorSchuh: calls $0.32
*** TURN *** [6h Ts 9s] [6s]
batya1212: bets $1.78 and is all-in
VitorSchuh: folds
Uncalled bet ($1.78) returned to batya1212
batya1212 collected $1.17 from pot
batya1212: doesn't show hand
*** SUMMARY ***
Total pot $1.21 | Rake $0.04
Board [6h Ts 9s 6s]
Seat 1: karprinic (button) folded before Flop (didn't bet)
Seat 2: danival2 (small blind) folded before Flop
Seat 3: batya1212 (big blind) collected ($1.17)
Seat 4: LLregs folded before Flop
Seat 5: VitorSchuh folded on the Turn
Seat 6: erikpavon folded before Flop (didn't bet)

PokerStars Zoom Hand #247968518889:  Hold'em No Limit ($0.01/$0.02) - 2023/12/30 22:15:34 WET [2023/12/30 17:15:34 ET]
Table 'Halley' 6-max Seat #1 is the button
Seat 1: hybridi ($3.60 in chips)
Seat 2: papakulikov ($2.16 in chips)
Seat 3: shavarun ($2.82 in chips)
Seat 4: Libin13 ($6.35 in chips)
Seat 5: LLregs ($12.45 in chips)
Seat 6: Quantum771 ($2 in chips)
papakulikov: posts small blind $0.01
shavarun: posts big blind $0.02
*** HOLE CARDS ***
Dealt to LLregs [Jc 9s]
Libin13: raises $0.02 to $0.04
LLregs: folds
Quantum771: raises $0.10 to $0.14
hybridi: folds
papakulikov: folds
shavarun: folds
Libin13: calls $0.10
*** FLOP *** [Kd 8c 9c]
Libin13: checks
Quantum771: checks
*** TURN *** [Kd 8c 9c] [7s]
Libin13: checks
Quantum771: checks
*** RIVER *** [Kd 8c 9c 7s] [4d]
Libin13: bets $0.30
Quantum771: folds
Uncalled bet ($0.30) returned to Libin13
Libin13 collected $0.30 from pot
Libin13: doesn't show hand
*** SUMMARY ***
Total pot $0.31 | Rake $0.01
Board [Kd 8c 9c 7s 4d]
Seat 1: hybridi (button) folded before Flop (didn't bet)
Seat 2: papakulikov (small blind) folded before Flop
Seat 3: shavarun (big blind) folded before Flop
Seat 4: Libin13 collected ($0.30)
Seat 5: LLregs folded before Flop (didn't bet)
Seat 6: Quantum771 folded on the River

PokerStars Zoom Hand #247968520677:  Hold'em No Limit ($0.01/$0.02) - 2023/12/30 22:15:39 WET [2023/12/30 17:15:39 ET]
Table 'Halley' 6-max Seat #1 is the button
Seat 1: sTIKs21 ($2.69 in chips)
Seat 2: LLregs ($12.45 in chips)
Seat 3: soulachicon ($4.79 in chips)
Seat 4: ichithekill ($2.37 in chips)
Seat 5: makabresku ($1.09 in chips)
Seat 6: NoDenyPanda ($2 in chips)
LLregs: posts small blind $0.01
soulachicon: posts big blind $0.02
*** HOLE CARDS ***
Dealt to LLregs [Kh As]
ichithekill: folds
makabresku: raises $0.04 to $0.06
NoDenyPanda: folds
sTIKs21: folds
LLregs: raises $0.12 to $0.18
soulachicon: folds
makabresku: calls $0.12
*** FLOP *** [Ac Ks Js]
LLregs: bets $0.08
makabresku: calls $0.08
*** TURN *** [Ac Ks Js] [Ts]
LLregs: checks
makabresku: bets $0.22
LLregs: calls $0.22
*** RIVER *** [Ac Ks Js Ts] [6h]
LLregs: checks
makabresku: bets $0.48
LLregs: calls $0.48
*** SHOW DOWN ***
makabresku: shows [Qd Qh] (a straight, Ten to Ace)
LLregs: mucks hand
makabresku collected $1.87 from pot
*** SUMMARY ***
Total pot $1.94 | Rake $0.07
Board [Ac Ks Js Ts 6h]
Seat 1: sTIKs21 (button) folded before Flop (didn't bet)
Seat 2: LLregs (small blind) mucked [Kh As]
Seat 3: soulachicon (big blind) folded before Flop
Seat 4: ichithekill folded before Flop (didn't bet)
Seat 5: makabresku showed [Qd Qh] and won ($1.87) with a straight, Ten to Ace
Seat 6: NoDenyPanda folded before Flop (didn't bet)

PokerStars Zoom Hand #247968547393:  Hold'em No Limit ($0.01/$0.02) - 2023/12/30 22:16:47 WET [2023/12/30 17:16:47 ET]
Table 'Halley' 6-max Seat #1 is the button
Seat 1: LLregs ($11.49 in chips)
Seat 2: sTIKs21 ($2.84 in chips)
Seat 3: shavarun ($2.86 in chips)
Seat 4: Baron_teran ($1.68 in chips)
Seat 5: roz534 ($3.16 in chips)
Seat 6: kevindth ($3 in chips)
sTIKs21: posts small blind $0.01
shavarun: posts big blind $0.02
*** HOLE CARDS ***
Dealt to LLregs [6s 4s]
Baron_teran: raises $0.04 to $0.06
roz534: calls $0.06
kevindth: folds
LLregs: folds
sTIKs21: folds
shavarun: folds
*** FLOP *** [Ac 9h 4d]
Baron_teran: checks
roz534: checks
*** TURN *** [Ac 9h 4d] [9c]
Baron_teran: bets $0.12
roz534: folds
Uncalled bet ($0.12) returned to Baron_teran
Baron_teran collected $0.14 from pot
Baron_teran: doesn't show hand
*** SUMMARY ***
Total pot $0.15 | Rake $0.01
Board [Ac 9h 4d 9c]
Seat 1: LLregs (button) folded before Flop (didn't bet)
Seat 2: sTIKs21 (small blind) folded before Flop
Seat 3: shavarun (big blind) folded before Flop
Seat 4: Baron_teran collected ($0.14)
Seat 5: roz534 folded on the Turn
Seat 6: kevindth folded before Flop (didn't bet)

PokerStars Zoom Hand #247968549070:  Hold'em No Limit ($0.01/$0.02) - 2023/12/30 22:16:51 WET [2023/12/30 17:16:51 ET]
Table 'Halley' 6-max Seat #1 is the button
Seat 1: jamessurf1 ($0.98 in chips)
Seat 2: marcos15vargass ($2.84 in chips)
Seat 3: High Fumph ($3.50 in chips)
Seat 4: LLregs ($11.49 in chips)
Seat 5: TamiSieche ($1.31 in chips)
Seat 6: kasse112 ($3.46 in chips)
marcos15vargass: posts small blind $0.01
High Fumph: posts big blind $0.02
*** HOLE CARDS ***
Dealt to LLregs [Jc Ac]
LLregs: raises $0.04 to $0.06
TamiSieche: folds
kasse112: folds
jamessurf1: calls $0.06
marcos15vargass: folds
High Fumph: folds
*** FLOP *** [As 3c 2s]
LLregs: bets $0.03
jamessurf1: raises $0.03 to $0.06
LLregs: calls $0.03
*** TURN *** [As 3c 2s] [9d]
LLregs: checks
jamessurf1: checks
*** RIVER *** [As 3c 2s 9d] [2c]
LLregs: bets $0.06
jamessurf1: raises $0.19 to $0.25
LLregs: calls $0.19
*** SHOW DOWN ***
jamessurf1: shows [7d 7c] (two pair, Sevens and Deuces)
LLregs: shows [Jc Ac] (two pair, Aces and Deuces)
LLregs collected $0.74 from pot
*** SUMMARY ***
Total pot $0.77 | Rake $0.03
Board [As 3c 2s 9d 2c]
Seat 1: jamessurf1 (button) showed [7d 7c] and lost with two pair, Sevens and Deuces
Seat 2: marcos15vargass (small blind) folded before Flop
Seat 3: High Fumph (big blind) folded before Flop
Seat 4: LLregs showed [Jc Ac] and won ($0.74) with two pair, Aces and Deuces
Seat 5: TamiSieche folded before Flop (didn't bet)
Seat 6: kasse112 folded before Flop (didn't bet)

PokerStars Zoom Hand #247968567303:  Hold'em No Limit ($0.01/$0.02) - 2023/12/30 22:17:38 WET [2023/12/30 17:17:38 ET]
Table 'Halley' 6-max Seat #1 is the button
Seat 1: pokerkdan ($2.54 in chips)
Seat 2: 888lifeIS ($2 in chips)
Seat 3: r3v3rs3f3r3t ($2.07 in chips)
Seat 4: shavarun ($2.12 in chips)
Seat 5: LLregs ($11.86 in chips)
Seat 6: Shaka667 ($2.49 in chips)
888lifeIS: posts small blind $0.01
r3v3rs3f3r3t: posts big blind $0.02
*** HOLE CARDS ***
Dealt to LLregs [Ts 7h]
shavarun: raises $0.04 to $0.06
LLregs: folds
Shaka667: folds
pokerkdan: folds
888lifeIS: folds
r3v3rs3f3r3t: folds
Uncalled bet ($0.04) returned to shavarun
shavarun collected $0.05 from pot
shavarun: doesn't show hand
*** SUMMARY ***
Total pot $0.05 | Rake $0
Seat 1: pokerkdan (button) folded before Flop (didn't bet)
Seat 2: 888lifeIS (small blind) folded before Flop
Seat 3: r3v3rs3f3r3t (big blind) folded before Flop
Seat 4: shavarun collected ($0.05)
Seat 5: LLregs folded before Flop (didn't bet)
Seat 6: Shaka667 folded before Flop (didn't bet)

PokerStars Zoom Hand #247968569299:  Hold'em No Limit ($0.01/$0.02) - 2023/12/30 22:17:43 WET [2023/12/30 17:17:43 ET]
Table 'Halley' 6-max Seat #1 is the button
Seat 1: marcos15vargass ($2.96 in chips)
Seat 2: my sapphire ($3.19 in chips)
Seat 3: LLregs ($11.86 in chips)
Seat 4: hybridi ($4.64 in chips)
Seat 5: IngeniEbr10 ($2 in chips)
Seat 6: Charlotte2009 ($5.64 in chips)
my sapphire: posts small blind $0.01
LLregs: posts big blind $0.02
*** HOLE CARDS ***
Dealt to LLregs [6c Qh]
hybridi: folds
IngeniEbr10: folds
Charlotte2009: calls $0.02
marcos15vargass: folds
my sapphire: folds
LLregs: checks
*** FLOP *** [6d 9d 7d]
LLregs: checks
Charlotte2009: bets $0.02
LLregs: calls $0.02
*** TURN *** [6d 9d 7d] [8h]
LLregs: bets $0.02
Charlotte2009: calls $0.02
*** RIVER *** [6d 9d 7d 8h] [6h]
LLregs: bets $0.10
Charlotte2009: calls $0.10
*** SHOW DOWN ***
LLregs: shows [6c Qh] (three of a kind, Sixes)
Charlotte2009: mucks hand
LLregs collected $0.32 from pot
*** SUMMARY ***
Total pot $0.33 | Rake $0.01
Board [6d 9d 7d 8h 6h]
Seat 1: marcos15vargass (button) folded before Flop (didn't bet)
Seat 2: my sapphire (small blind) folded before Flop
Seat 3: LLregs (big blind) showed [6c Qh] and won ($0.32) with three of a kind, Sixes
Seat 4: hybridi folded before Flop (didn't bet)
Seat 5: IngeniEbr10 folded before Flop (didn't bet)
Seat 6: Charlotte2009 mucked [4h 8s]

PokerStars Zoom Hand #247968582349:  Hold'em No Limit ($0.01/$0.02) - 2023/12/30 22:18:17 WET [2023/12/30 17:18:17 ET]
Table 'Halley' 6-max Seat #1 is the button
Seat 1: MrMole235 ($3.36 in chips)
Seat 2: DanRussel ($2.90 in chips)
Seat 3: davor987 ($2.06 in chips)
Seat 4: Shaka667 ($5.35 in chips)
Seat 5: Kamylo20 ($2.64 in chips)
Seat 6: LLregs ($12.02 in chips)
DanRussel: posts small blind $0.01
davor987: posts big blind $0.02
*** HOLE CARDS ***
Dealt to LLregs [6d Ts]
Shaka667: folds
Kamylo20: folds
LLregs: folds
MrMole235: folds
DanRussel: folds
Uncalled bet ($0.01) returned to davor987
davor987 collected $0.02 from pot
davor987: doesn't show hand
*** SUMMARY ***
Total pot $0.02 | Rake $0
Seat 1: MrMole235 (button) folded before Flop (didn't bet)
Seat 2: DanRussel (small blind) folded before Flop
Seat 3: davor987 (big blind) collected ($0.02)
Seat 4: Shaka667 folded before Flop (didn't bet)
Seat 5: Kamylo20 folded before Flop (didn't bet)
Seat 6: LLregs folded before Flop (didn't bet)

PokerStars Zoom Hand #247968584413:  Hold'em No Limit ($0.01/$0.02) - 2023/12/30 22:18:23 WET [2023/12/30 17:18:23 ET]
Table 'Halley' 6-max Seat #1 is the button
Seat 1: ettorek ($2.30 in chips)
Seat 2: shermheadryder ($2.09 in chips)
Seat 3: jbarrios007 ($1.71 in chips)
Seat 4: LLregs ($12.02 in chips)
Seat 5: sTIKs21 ($3.35 in chips)
Seat 6: Deny0403 ($3.13 in chips)
shermheadryder: posts small blind $0.01
jbarrios007: posts big blind $0.02
*** HOLE CARDS ***
Dealt to LLregs [5d 5s]
LLregs: raises $0.04 to $0.06
sTIKs21: calls $0.06
Deny0403: folds
ettorek: folds
shermheadryder: folds
jbarrios007: folds
*** FLOP *** [4d 6h Tc]
LLregs: checks
sTIKs21: checks
*** TURN *** [4d 6h Tc] [Kc]
LLregs: bets $0.03
sTIKs21: folds
Uncalled bet ($0.03) returned to LLregs
LLregs collected $0.14 from pot
LLregs: doesn't show hand
*** SUMMARY ***
Total pot $0.15 | Rake $0.01
Board [4d 6h Tc Kc]
Seat 1: ettorek (button) folded before Flop (didn't bet)
Seat 2: shermheadryder (small blind) folded before Flop
Seat 3: jbarrios007 (big blind) folded before Flop
Seat 4: LLregs collected ($0.14)
Seat 5: sTIKs21 folded on the Turn
Seat 6: Deny0403 folded before Flop (didn't bet)

PokerStars Zoom Hand #247968598816:  Hold'em No Limit ($0.01/$0.02) - 2023/12/30 22:19:00 WET [2023/12/30 17:19:00 ET]
Table 'Halley' 6-max Seat #1 is the button
Seat 1: IngeniEbr10 ($2.57 in chips)
Seat 2: LLregs ($12.10 in chips)
Seat 3: leedsrounder ($2.24 in chips)
Seat 4: Harold_Seven ($0.83 in chips)
Seat 5: Mary_D_1973 ($2.14 in chips)
Seat 6: greyman34940 ($4.07 in chips)
LLregs: posts small blind $0.01
leedsrounder: posts big blind $0.02
*** HOLE CARDS ***
Dealt to LLregs [6h Ks]
Harold_Seven: folds
Mary_D_1973: folds
greyman34940 has timed out
greyman34940: folds
IngeniEbr10: raises $0.03 to $0.05
LLregs: folds
leedsrounder: folds
Uncalled bet ($0.03) returned to IngeniEbr10
IngeniEbr10 collected $0.05 from pot
IngeniEbr10: doesn't show hand
*** SUMMARY ***
Total pot $0.05 | Rake $0
Seat 1: IngeniEbr10 (button) collected ($0.05)
Seat 2: LLregs (small blind) folded before Flop
Seat 3: leedsrounder (big blind) folded before Flop
Seat 4: Harold_Seven folded before Flop (didn't bet)
Seat 5: Mary_D_1973 folded before Flop (didn't bet)
Seat 6: greyman34940 folded before Flop (didn't bet)

PokerStars Zoom Hand #247968606653:  Hold'em No Limit ($0.01/$0.02) - 2023/12/30 22:19:20 WET [2023/12/30 17:19:20 ET]
Table 'Halley' 6-max Seat #1 is the button
Seat 1: LLregs ($12.09 in chips)
Seat 2: marksupertramp ($2.79 in chips)
Seat 3: Tha_Saint7 ($7.93 in chips)
Seat 4: greyman34940 ($2.44 in chips)
Seat 5: H3spanhol ($2 in chips)
Seat 6: dealmekkplease ($2.23 in chips)
marksupertramp: posts small blind $0.01
Tha_Saint7: posts big blind $0.02
*** HOLE CARDS ***
Dealt to LLregs [2h 7c]
greyman34940 has timed out
greyman34940: folds
H3spanhol: folds
dealmekkplease: folds
LLregs: folds
marksupertramp: raises $0.04 to $0.06
Tha_Saint7: folds
Uncalled bet ($0.04) returned to marksupertramp
marksupertramp collected $0.04 from pot
marksupertramp: doesn't show hand
*** SUMMARY ***
Total pot $0.04 | Rake $0
Seat 1: LLregs (button) folded before Flop (didn't bet)
Seat 2: marksupertramp (small blind) collected ($0.04)
Seat 3: Tha_Saint7 (big blind) folded before Flop
Seat 4: greyman34940 folded before Flop (didn't bet)
Seat 5: H3spanhol folded before Flop (didn't bet)
Seat 6: dealmekkplease folded before Flop (didn't bet)

PokerStars Zoom Hand #247968608233:  Hold'em No Limit ($0.01/$0.02) - 2023/12/30 22:19:23 WET [2023/12/30 17:19:23 ET]
Table 'Halley' 6-max Seat #1 is the button
Seat 1: Weily8 ($2.41 in chips)
Seat 2: Rewest_044 ($1.07 in chips)
Seat 3: 888lifeIS ($2 in chips)
Seat 4: pauloaugusto157 ($3.60 in chips)
Seat 5: LLregs ($12.09 in chips)
Seat 6: karprinic ($0.90 in chips)
Rewest_044: posts small blind $0.01
888lifeIS: posts big blind $0.02
*** HOLE CARDS ***
Dealt to LLregs [9c Jc]
pauloaugusto157: calls $0.02
LLregs: folds
karprinic: folds
Weily8: folds
Rewest_044: calls $0.01
888lifeIS: checks
*** FLOP *** [Ac 4h 7d]
Rewest_044: checks
888lifeIS: bets $0.04
pauloaugusto157: calls $0.04
Rewest_044: folds
*** TURN *** [Ac 4h 7d] [9d]
888lifeIS: checks
pauloaugusto157: bets $0.02
888lifeIS: calls $0.02
*** RIVER *** [Ac 4h 7d 9d] [3h]
888lifeIS: checks
pauloaugusto157: bets $0.02
888lifeIS: calls $0.02
*** SHOW DOWN ***
pauloaugusto157: shows [Kc 9s] (a pair of Nines)
888lifeIS: shows [Ah Td] (a pair of Aces)
888lifeIS collected $0.21 from pot
*** SUMMARY ***
Total pot $0.22 | Rake $0.01
Board [Ac 4h 7d 9d 3h]
Seat 1: Weily8 (button) folded before Flop (didn't bet)
Seat 2: Rewest_044 (small blind) folded on the Flop
Seat 3: 888lifeIS (big blind) showed [Ah Td] and won ($0.21) with a pair of Aces
Seat 4: pauloaugusto157 showed [Kc 9s] and lost with a pair of Nines
Seat 5: LLregs folded before Flop (didn't bet)
Seat 6: karprinic folded before Flop (didn't bet)

PokerStars Zoom Hand #247968616217:  Hold'em No Limit ($0.01/$0.02) - 2023/12/30 22:19:44 WET [2023/12/30 17:19:44 ET]
Table 'Halley' 6-max Seat #1 is the button
Seat 1: HooliganBasher ($2.37 in chips)
Seat 2: LLregs ($12.07 in chips)
Seat 3: ZappingZebras ($3.31 in chips)
Seat 4: Mary_D_1973 ($1.88 in chips)
Seat 5: TeodorRR92 ($2.84 in chips)
Seat 6: 3ener ($3.57 in chips)
LLregs: posts small blind $0.01
ZappingZebras: posts big blind $0.02
*** HOLE CARDS ***
Dealt to LLregs [2h Jh]
Mary_D_1973: folds
TeodorRR92: folds
3ener: folds
HooliganBasher: folds
LLregs: raises $0.04 to $0.06
ZappingZebras: folds
Uncalled bet ($0.04) returned to LLregs
LLregs collected $0.04 from pot
LLregs: doesn't show hand
*** SUMMARY ***
Total pot $0.04 | Rake $0
Seat 1: HooliganBasher (button) folded before Flop (didn't bet)
Seat 2: LLregs (small blind) collected ($0.04)
Seat 3: ZappingZebras (big blind) folded before Flop
Seat 4: Mary_D_1973 folded before Flop (didn't bet)
Seat 5: TeodorRR92 folded before Flop (didn't bet)
Seat 6: 3ener folded before Flop (didn't bet)

PokerStars Zoom Hand #247968623151:  Hold'em No Limit ($0.01/$0.02) - 2023/12/30 22:20:02 WET [2023/12/30 17:20:02 ET]
Table 'Halley' 6-max Seat #1 is the button
Seat 1: LLregs ($12.09 in chips)
Seat 2: cc_midel ($2.89 in chips)
Seat 3: Josiel Dahmer ($1.47 in chips)
Seat 4: Ira Duchenko ($1.13 in chips)
Seat 5: shavarun ($2.15 in chips)
Seat 6: erikpavon ($2.24 in chips)
cc_midel: posts small blind $0.01
Josiel Dahmer: posts big blind $0.02
*** HOLE CARDS ***
Dealt to LLregs [Jd 5s]
Ira Duchenko: folds
shavarun: folds
erikpavon: folds
LLregs: raises $0.04 to $0.06
cc_midel: folds
Josiel Dahmer: calls $0.04
*** FLOP *** [8s Ah 2c]
Josiel Dahmer: bets $0.13
LLregs: folds
Uncalled bet ($0.13) returned to Josiel Dahmer
Josiel Dahmer collected $0.13 from pot
Josiel Dahmer: doesn't show hand
*** SUMMARY ***
Total pot $0.13 | Rake $0
Board [8s Ah 2c]
Seat 1: LLregs (button) folded on the Flop
Seat 2: cc_midel (small blind) folded before Flop
Seat 3: Josiel Dahmer (big blind) collected ($0.13)
Seat 4: Ira Duchenko folded before Flop (didn't bet)
Seat 5: shavarun folded before Flop (didn't bet)
Seat 6: erikpavon folded before Flop (didn't bet)

PokerStars Zoom Hand #247968612600:  Hold'em No Limit ($0.01/$0.02) - 2023/12/30 22:19:35 WET [2023/12/30 17:19:35 ET]
Table 'Halley' 6-max Seat #1 is the button
Seat 1: danival2 ($7.14 in chips)
Seat 2: High Fumph ($2.11 in chips)
Seat 3: LLregs ($12.09 in chips)
Seat 4: shavarun ($2.18 in chips)
Seat 5: ChessMaster2002 ($4.37 in chips)
Seat 6: DanRussel ($1.57 in chips)
High Fumph: posts small blind $0.01
LLregs: posts big blind $0.02
*** HOLE CARDS ***
Dealt to LLregs [8s 3c]
shavarun: folds
ChessMaster2002: folds
DanRussel: folds
danival2: raises $0.03 to $0.05
High Fumph: calls $0.04
LLregs: folds
*** FLOP *** [Kh 5h Js]
High Fumph: checks
danival2: bets $0.03
High Fumph: calls $0.03
*** TURN *** [Kh 5h Js] [Ad]
High Fumph: checks
danival2: checks
*** RIVER *** [Kh 5h Js Ad] [3d]
High Fumph: bets $0.06
danival2: folds
Uncalled bet ($0.06) returned to High Fumph
High Fumph collected $0.17 from pot
High Fumph: doesn't show hand
*** SUMMARY ***
Total pot $0.18 | Rake $0.01
Board [Kh 5h Js Ad 3d]
Seat 1: danival2 (button) folded on the River
Seat 2: High Fumph (small blind) collected ($0.17)
Seat 3: LLregs (big blind) folded before Flop
Seat 4: shavarun folded before Flop (didn't bet)
Seat 5: ChessMaster2002 folded before Flop (didn't bet)
Seat 6: DanRussel folded before Flop (didn't bet)

PokerStars Zoom Hand #247968631611:  Hold'em No Limit ($0.01/$0.02) - 2023/12/30 22:20:24 WET [2023/12/30 17:20:24 ET]
Table 'Halley' 6-max Seat #1 is the button
Seat 1: xCancuN88x ($2.10 in chips)
Seat 2: frankquanki ($2.85 in chips)
Seat 3: ggnavarrovaz ($3.46 in chips)
Seat 4: Mwilson766 ($1.47 in chips)
Seat 5: LLregs ($12.03 in chips)
Seat 6: jbarrios007 ($1.61 in chips)
frankquanki: posts small blind $0.01
ggnavarrovaz: posts big blind $0.02
*** HOLE CARDS ***
Dealt to LLregs [3s 5h]
Mwilson766: raises $0.03 to $0.05
LLregs: folds
jbarrios007: folds
xCancuN88x: folds
frankquanki: folds
ggnavarrovaz: folds
Uncalled bet ($0.03) returned to Mwilson766
Mwilson766 collected $0.05 from pot
Mwilson766: doesn't show hand
*** SUMMARY ***
Total pot $0.05 | Rake $0
Seat 1: xCancuN88x (button) folded before Flop (didn't bet)
Seat 2: frankquanki (small blind) folded before Flop
Seat 3: ggnavarrovaz (big blind) folded before Flop
Seat 4: Mwilson766 collected ($0.05)
Seat 5: LLregs folded before Flop (didn't bet)
Seat 6: jbarrios007 folded before Flop (didn't bet)

PokerStars Zoom Hand #247968634234:  Hold'em No Limit ($0.01/$0.02) - 2023/12/30 22:20:31 WET [2023/12/30 17:20:31 ET]
Table 'Halley' 6-max Seat #1 is the button
Seat 1: kasse112 ($5.77 in chips)
Seat 2: my sapphire ($1.50 in chips)
Seat 3: LLregs ($12.03 in chips)
Seat 4: Mary_D_1973 ($1.78 in chips)
Seat 5: PaulNichol ($1.14 in chips)
Seat 6: LineScald ($1.35 in chips)
my sapphire: posts small blind $0.01
LLregs: posts big blind $0.02
*** HOLE CARDS ***
Dealt to LLregs [9c 7h]
Mary_D_1973: folds
PaulNichol: calls $0.02
LineScald: folds
kasse112: folds
my sapphire: folds
LLregs: checks
*** FLOP *** [4c 7d Qd]
LLregs: bets $0.06
PaulNichol: calls $0.06
*** TURN *** [4c 7d Qd] [7c]
LLregs: bets $0.08
PaulNichol: folds
Uncalled bet ($0.08) returned to LLregs
LLregs collected $0.16 from pot
LLregs: doesn't show hand
*** SUMMARY ***
Total pot $0.17 | Rake $0.01
Board [4c 7d Qd 7c]
Seat 1: kasse112 (button) folded before Flop (didn't bet)
Seat 2: my sapphire (small blind) folded before Flop
Seat 3: LLregs (big blind) collected ($0.16)
Seat 4: Mary_D_1973 folded before Flop (didn't bet)
Seat 5: PaulNichol folded on the Turn
Seat 6: LineScald folded before Flop (didn't bet)

PokerStars Zoom Hand #247968629721:  Hold'em No Limit ($0.01/$0.02) - 2023/12/30 22:20:19 WET [2023/12/30 17:20:19 ET]
Table 'Halley' 6-max Seat #1 is the button
Seat 1: makabresku ($1.29 in chips)
Seat 2: sTIKs21 ($2.28 in chips)
Seat 3: cc_midel ($2.88 in chips)
Seat 4: my sapphire ($1.50 in chips)
Seat 5: marcos15vargass ($2.83 in chips)
Seat 6: LLregs ($12.03 in chips)
sTIKs21: posts small blind $0.01
cc_midel: posts big blind $0.02
*** HOLE CARDS ***
Dealt to LLregs [Qs 7c]
my sapphire: folds
marcos15vargass: raises $0.04 to $0.06
LLregs: folds
makabresku: folds
sTIKs21: folds
cc_midel: calls $0.04
*** FLOP *** [4c 6h 3h]
cc_midel: bets $0.04
marcos15vargass: calls $0.04
*** TURN *** [4c 6h 3h] [3c]
cc_midel: bets $0.10
marcos15vargass: calls $0.10
*** RIVER *** [4c 6h 3h 3c] [Qd]
cc_midel: bets $0.20
marcos15vargass: folds
Uncalled bet ($0.20) returned to cc_midel
cc_midel collected $0.40 from pot
cc_midel: doesn't show hand
*** SUMMARY ***
Total pot $0.41 | Rake $0.01
Board [4c 6h 3h 3c Qd]
Seat 1: makabresku (button) folded before Flop (didn't bet)
Seat 2: sTIKs21 (small blind) folded before Flop
Seat 3: cc_midel (big blind) collected ($0.40)
Seat 4: my sapphire folded before Flop (didn't bet)
Seat 5: marcos15vargass folded on the River
Seat 6: LLregs folded before Flop (didn't bet)

PokerStars Zoom Hand #247968644730:  Hold'em No Limit ($0.01/$0.02) - 2023/12/30 22:20:58 WET [2023/12/30 17:20:58 ET]
Table 'Halley' 6-max Seat #1 is the button
Seat 1: LLregs ($12.11 in chips)
Seat 2: Szklana.poker ($2.35 in chips)
Seat 3: ChessMaster2002 ($2 in chips)
Seat 4: pokerkdan ($5.01 in chips)
Seat 5: hybridi ($2 in chips)
Seat 6: Agneobr ($1.88 in chips)
Szklana.poker: posts small blind $0.01
ChessMaster2002: posts big blind $0.02
*** HOLE CARDS ***
Dealt to LLregs [9h Ah]
pokerkdan: folds
hybridi: folds
Agneobr: folds
LLregs: raises $0.04 to $0.06
Szklana.poker: folds
ChessMaster2002: folds
Uncalled bet ($0.04) returned to LLregs
LLregs collected $0.05 from pot
LLregs: doesn't show hand
*** SUMMARY ***
Total pot $0.05 | Rake $0
Seat 1: LLregs (button) collected ($0.05)
Seat 2: Szklana.poker (small blind) folded before Flop
Seat 3: ChessMaster2002 (big blind) folded before Flop
Seat 4: pokerkdan folded before Flop (didn't bet)
Seat 5: hybridi folded before Flop (didn't bet)
Seat 6: Agneobr folded before Flop (didn't bet)

PokerStars Zoom Hand #247968633023:  Hold'em No Limit ($0.01/$0.02) - 2023/12/30 22:20:27 WET [2023/12/30 17:20:27 ET]
Table 'Halley' 6-max Seat #1 is the button
Seat 1: Weily8 ($2.09 in chips)
Seat 2: tom216216216 ($2.47 in chips)
Seat 3: ZiggyBoy90 ($2 in chips)
Seat 4: sTIKs21 ($2.27 in chips)
Seat 5: LLregs ($12.03 in chips)
Seat 6: Dimoni797979 ($6.12 in chips)
tom216216216: posts small blind $0.01
ZiggyBoy90: posts big blind $0.02
*** HOLE CARDS ***
Dealt to LLregs [9s Kh]
sTIKs21: folds
LLregs: folds
Dimoni797979: raises $0.02 to $0.04
Weily8: folds
tom216216216: folds
ZiggyBoy90: calls $0.02
*** FLOP *** [Jc 6d 4d]
ZiggyBoy90: checks
Dimoni797979: bets $0.09
ZiggyBoy90: calls $0.09
*** TURN *** [Jc 6d 4d] [8d]
ZiggyBoy90: checks
Dimoni797979: bets $0.13
ZiggyBoy90: calls $0.13
*** RIVER *** [Jc 6d 4d 8d] [Qh]
ZiggyBoy90: checks
Dimoni797979: checks
*** SHOW DOWN ***
ZiggyBoy90: shows [Qd Ac] (a pair of Queens)
Dimoni797979: mucks hand
ZiggyBoy90 collected $0.51 from pot
*** SUMMARY ***
Total pot $0.53 | Rake $0.02
Board [Jc 6d 4d 8d Qh]
Seat 1: Weily8 (button) folded before Flop (didn't bet)
Seat 2: tom216216216 (small blind) folded before Flop
Seat 3: ZiggyBoy90 (big blind) showed [Qd Ac] and won ($0.51) with a pair of Queens
Seat 4: sTIKs21 folded before Flop (didn't bet)
Seat 5: LLregs folded before Flop (didn't bet)
Seat 6: Dimoni797979 mucked [Ks Jh]

PokerStars Zoom Hand #247968653258:  Hold'em No Limit ($0.01/$0.02) - 2023/12/30 22:21:20 WET [2023/12/30 17:21:20 ET]
Table 'Halley' 6-max Seat #1 is the button
Seat 1: emopokera ($3.01 in chips)
Seat 2: LLregs ($12.14 in chips)
Seat 3: degelcamus ($3.44 in chips)
Seat 4: greyman34940 ($4.04 in chips)
Seat 5: Kamylo20 ($3.99 in chips)
Seat 6: 888lifeIS ($2.17 in chips)
LLregs: posts small blind $0.01
degelcamus: posts big blind $0.02
*** HOLE CARDS ***
Dealt to LLregs [6d Qs]
greyman34940: folds
Kamylo20: folds
888lifeIS: folds
emopokera: folds
LLregs: folds
Uncalled bet ($0.01) returned to degelcamus
degelcamus collected $0.02 from pot
degelcamus: doesn't show hand
*** SUMMARY ***
Total pot $0.02 | Rake $0
Seat 1: emopokera (button) folded before Flop (didn't bet)
Seat 2: LLregs (small blind) folded before Flop
Seat 3: degelcamus (big blind) collected ($0.02)
Seat 4: greyman34940 folded before Flop (didn't bet)
Seat 5: Kamylo20 folded before Flop (didn't bet)
Seat 6: 888lifeIS folded before Flop (didn't bet)

PokerStars Zoom Hand #247968657811:  Hold'em No Limit ($0.01/$0.02) - 2023/12/30 22:21:32 WET [2023/12/30 17:21:32 ET]
Table 'Halley' 6-max Seat #1 is the button
Seat 1: CaptainB1ack ($5.31 in chips)
Seat 2: ChessMaster2002 ($2 in chips)
Seat 3: Wilmots18 ($1.97 in chips)
Seat 4: carbonero59 ($2.21 in chips)
Seat 5: LLregs ($12.13 in chips)
Seat 6: greyman34940 ($2.39 in chips)
ChessMaster2002: posts small blind $0.01
Wilmots18: posts big blind $0.02
*** HOLE CARDS ***
Dealt to LLregs [9s 3c]
carbonero59: folds
LLregs: folds
greyman34940: folds
CaptainB1ack: folds
ChessMaster2002: folds
Uncalled bet ($0.01) returned to Wilmots18
Wilmots18 collected $0.02 from pot
Wilmots18: doesn't show hand
*** SUMMARY ***
Total pot $0.02 | Rake $0
Seat 1: CaptainB1ack (button) folded before Flop (didn't bet)
Seat 2: ChessMaster2002 (small blind) folded before Flop
Seat 3: Wilmots18 (big blind) collected ($0.02)
Seat 4: carbonero59 folded before Flop (didn't bet)
Seat 5: LLregs folded before Flop (didn't bet)
Seat 6: greyman34940 folded before Flop (didn't bet)

PokerStars Zoom Hand #247968655425:  Hold'em No Limit ($0.01/$0.02) - 2023/12/30 22:21:25 WET [2023/12/30 17:21:25 ET]
Table 'Halley' 6-max Seat #1 is the button
Seat 1: kakani78 ($2.03 in chips)
Seat 2: Szklana.poker ($3.21 in chips)
Seat 3: santogr893 ($14.67 in chips)
Seat 4: LLregs ($12.13 in chips)
Seat 5: PabloBeans ($1.47 in chips)
Seat 6: claudia74 ($0.75 in chips)
Szklana.poker: posts small blind $0.01
santogr893: posts big blind $0.02
*** HOLE CARDS ***
Dealt to LLregs [Th 4c]
LLregs: folds
PabloBeans: calls $0.02
claudia74: calls $0.02
kakani78: folds
Szklana.poker: folds
santogr893: checks
*** FLOP *** [9d 2s 2c]
santogr893: checks
PabloBeans: bets $0.10
claudia74: folds
santogr893: folds
Uncalled bet ($0.10) returned to PabloBeans
PabloBeans collected $0.07 from pot
PabloBeans: doesn't show hand
*** SUMMARY ***
Total pot $0.07 | Rake $0
Board [9d 2s 2c]
Seat 1: kakani78 (button) folded before Flop (didn't bet)
Seat 2: Szklana.poker (small blind) folded before Flop
Seat 3: santogr893 (big blind) folded on the Flop
Seat 4: LLregs folded before Flop (didn't bet)
Seat 5: PabloBeans collected ($0.07)
Seat 6: claudia74 folded on the Flop

PokerStars Zoom Hand #247968654398:  Hold'em No Limit ($0.01/$0.02) - 2023/12/30 22:21:23 WET [2023/12/30 17:21:23 ET]
Table 'Halley' 6-max Seat #1 is the button
Seat 1: Bergländer ($1.68 in chips)
Seat 2: Beduin250 ($2.40 in chips)
Seat 3: Quirian ($1.89 in chips)
Seat 4: shavarun ($2.12 in chips)
Seat 5: xK1R1Lx ($2.22 in chips)
Seat 6: LLregs ($12.13 in chips)
Beduin250: posts small blind $0.01
Quirian: posts big blind $0.02
*** HOLE CARDS ***
Dealt to LLregs [3h 4d]
shavarun: folds
xK1R1Lx: calls $0.02
LLregs: folds
Bergländer: folds
Beduin250: raises $0.02 to $0.04
Quirian: raises $0.06 to $0.10
xK1R1Lx: folds
Beduin250: calls $0.06
*** FLOP *** [Ts 9h 7h]
Beduin250: checks
Quirian: bets $0.11
Beduin250: folds
Uncalled bet ($0.11) returned to Quirian
Quirian collected $0.21 from pot
Quirian: doesn't show hand
*** SUMMARY ***
Total pot $0.22 | Rake $0.01
Board [Ts 9h 7h]
Seat 1: Bergländer (button) folded before Flop (didn't bet)
Seat 2: Beduin250 (small blind) folded on the Flop
Seat 3: Quirian (big blind) collected ($0.21)
Seat 4: shavarun folded before Flop (didn't bet)
Seat 5: xK1R1Lx folded before Flop
Seat 6: LLregs folded before Flop (didn't bet)

PokerStars Zoom Hand #247968656695:  Hold'em No Limit ($0.01/$0.02) - 2023/12/30 22:21:29 WET [2023/12/30 17:21:29 ET]
Table 'Halley' 6-max Seat #1 is the button
Seat 1: anthimoskon ($1.66 in chips)
Seat 2: PaulNichol ($1.18 in chips)
Seat 3: greyman34940 ($4.04 in chips)
Seat 4: LLregs ($12.13 in chips)
Seat 5: karprinic ($0.91 in chips)
Seat 6: Shaka667 ($2.74 in chips)
PaulNichol: posts small blind $0.01
greyman34940: posts big blind $0.02
*** HOLE CARDS ***
Dealt to LLregs [2c Jd]
LLregs: folds
karprinic: folds
Shaka667: folds
anthimoskon: folds
PaulNichol: calls $0.01
greyman34940: checks
*** FLOP *** [Qh Js Kd]
PaulNichol: bets $0.02
greyman34940: calls $0.02
*** TURN *** [Qh Js Kd] [Th]
PaulNichol: bets $0.04
greyman34940: calls $0.04
*** RIVER *** [Qh Js Kd Th] [Ks]
PaulNichol: bets $0.15
greyman34940: calls $0.15
*** SHOW DOWN ***
PaulNichol: shows [Ad 3s] (a straight, Ten to Ace)
greyman34940: shows [Qd As] (a straight, Ten to Ace)
PaulNichol collected $0.22 from pot
greyman34940 collected $0.22 from pot
*** SUMMARY ***
Total pot $0.46 | Rake $0.02
Board [Qh Js Kd Th Ks]
Seat 1: anthimoskon (button) folded before Flop (didn't bet)
Seat 2: PaulNichol (small blind) showed [Ad 3s] and won ($0.22) with a straight, Ten to Ace
Seat 3: greyman34940 (big blind) showed [Qd As] and won ($0.22) with a straight, Ten to Ace
Seat 4: LLregs folded before Flop (didn't bet)
Seat 5: karprinic folded before Flop (didn't bet)
Seat 6: Shaka667 folded before Flop (didn't bet)

PokerStars Zoom Hand #247968659024:  Hold'em No Limit ($0.01/$0.02) - 2023/12/30 22:21:35 WET [2023/12/30 17:21:35 ET]
Table 'Halley' 6-max Seat #1 is the button
Seat 1: ZorroZoltan ($2.19 in chips)
Seat 2: batya1212 ($2.27 in chips)
Seat 3: LLregs ($12.13 in chips)
Seat 4: VIDOPRO23 ($2.85 in chips)
Seat 5: gismouck ($2 in chips)
Seat 6: kasse112 ($5.64 in chips)
batya1212: posts small blind $0.01
LLregs: posts big blind $0.02
*** HOLE CARDS ***
Dealt to LLregs [Tc Kc]
VIDOPRO23: raises $0.05 to $0.07
gismouck: folds
kasse112: folds
ZorroZoltan: folds
batya1212: folds
LLregs: calls $0.05
*** FLOP *** [4c Qh Ad]
LLregs: checks
VIDOPRO23: checks
*** TURN *** [4c Qh Ad] [4s]
LLregs: checks
VIDOPRO23: bets $0.07
LLregs: folds
Uncalled bet ($0.07) returned to VIDOPRO23
VIDOPRO23 collected $0.14 from pot
VIDOPRO23: doesn't show hand
*** SUMMARY ***
Total pot $0.15 | Rake $0.01
Board [4c Qh Ad 4s]
Seat 1: ZorroZoltan (button) folded before Flop (didn't bet)
Seat 2: batya1212 (small blind) folded before Flop
Seat 3: LLregs (big blind) folded on the Turn
Seat 4: VIDOPRO23 collected ($0.14)
Seat 5: gismouck folded before Flop (didn't bet)
Seat 6: kasse112 folded before Flop (didn't bet)

PokerStars Zoom Hand #247968675644:  Hold'em No Limit ($0.01/$0.02) - 2023/12/30 22:22:17 WET [2023/12/30 17:22:17 ET]
Table 'Halley' 6-max Seat #1 is the button
Seat 1: ChessMaster2002 ($5.12 in chips)
Seat 2: rex20b ($1.04 in chips)
Seat 3: Kamylo20 ($3.85 in chips)
Seat 4: micdik ($1.36 in chips)
Seat 5: Rewest_044 ($0.90 in chips)
Seat 6: LLregs ($12.06 in chips)
rex20b: posts small blind $0.01
Kamylo20: posts big blind $0.02
*** HOLE CARDS ***
Dealt to LLregs [Td Qd]
micdik: raises $0.02 to $0.04
Rewest_044: folds
LLregs: calls $0.04
ChessMaster2002: folds
rex20b: calls $0.03
Kamylo20: folds
*** FLOP *** [3s 5s 5h]
rex20b: checks
micdik: checks
LLregs: bets $0.05
rex20b: folds
micdik: folds
Uncalled bet ($0.05) returned to LLregs
LLregs collected $0.14 from pot
LLregs: doesn't show hand
*** SUMMARY ***
Total pot $0.14 | Rake $0
Board [3s 5s 5h]
Seat 1: ChessMaster2002 (button) folded before Flop (didn't bet)
Seat 2: rex20b (small blind) folded on the Flop
Seat 3: Kamylo20 (big blind) folded before Flop
Seat 4: micdik folded on the Flop
Seat 5: Rewest_044 folded before Flop (didn't bet)
Seat 6: LLregs collected ($0.14)

PokerStars Zoom Hand #247968687418:  Hold'em No Limit ($0.01/$0.02) - 2023/12/30 22:22:48 WET [2023/12/30 17:22:48 ET]
Table 'Halley' 6-max Seat #1 is the button
Seat 1: roz534 ($3.31 in chips)
Seat 2: LLregs ($12.16 in chips)
Seat 3: sTIKs21 ($2.22 in chips)
Seat 4: jjuul ($1.75 in chips)
Seat 5: portilho69 ($0.91 in chips)
Seat 6: conspy84 ($0.93 in chips)
LLregs: posts small blind $0.01
sTIKs21: posts big blind $0.02
*** HOLE CARDS ***
Dealt to LLregs [8h 7s]
jjuul: folds
portilho69: folds
conspy84: folds
roz534: calls $0.02
LLregs: folds
sTIKs21: checks
*** FLOP *** [Ks 3c 4h]
sTIKs21: checks
roz534: checks
*** TURN *** [Ks 3c 4h] [Kd]
sTIKs21: checks
roz534: checks
*** RIVER *** [Ks 3c 4h Kd] [8c]
sTIKs21: checks
roz534: checks
*** SHOW DOWN ***
sTIKs21: shows [2c Th] (a pair of Kings)
roz534: shows [7d Ts] (a pair of Kings - Ten+Eight+Seven kicker)
roz534 collected $0.05 from pot
*** SUMMARY ***
Total pot $0.05 | Rake $0
Board [Ks 3c 4h Kd 8c]
Seat 1: roz534 (button) showed [7d Ts] and won ($0.05) with a pair of Kings
Seat 2: LLregs (small blind) folded before Flop
Seat 3: sTIKs21 (big blind) showed [2c Th] and lost with a pair of Kings
Seat 4: jjuul folded before Flop (didn't bet)
Seat 5: portilho69 folded before Flop (didn't bet)
Seat 6: conspy84 folded before Flop (didn't bet)

PokerStars Zoom Hand #247968688829:  Hold'em No Limit ($0.01/$0.02) - 2023/12/30 22:22:51 WET [2023/12/30 17:22:51 ET]
Table 'Halley' 6-max Seat #1 is the button
Seat 1: Kevin99991 ($3.26 in chips)
Seat 2: frankquanki ($5.95 in chips)
Seat 3: LLregs ($12.15 in chips)
Seat 4: Rewest_044 ($0.83 in chips)
Seat 5: jjuul ($1.75 in chips)
Seat 6: leedsrounder ($2.26 in chips)
frankquanki: posts small blind $0.01
LLregs: posts big blind $0.02
*** HOLE CARDS ***
Dealt to LLregs [9c Kd]
Rewest_044: folds
jjuul: folds
leedsrounder: raises $0.03 to $0.05
Kevin99991: folds
frankquanki: folds
LLregs: calls $0.03
*** FLOP *** [Jh 9h Ah]
LLregs: checks
leedsrounder: checks
*** TURN *** [Jh 9h Ah] [3s]
LLregs: checks
leedsrounder: bets $0.06
LLregs: calls $0.06
*** RIVER *** [Jh 9h Ah 3s] [3h]
LLregs: checks
leedsrounder: bets $0.14
LLregs: folds
Uncalled bet ($0.14) returned to leedsrounder
leedsrounder collected $0.22 from pot
leedsrounder: doesn't show hand
*** SUMMARY ***
Total pot $0.23 | Rake $0.01
Board [Jh 9h Ah 3s 3h]
Seat 1: Kevin99991 (button) folded before Flop (didn't bet)
Seat 2: frankquanki (small blind) folded before Flop
Seat 3: LLregs (big blind) folded on the River
Seat 4: Rewest_044 folded before Flop (didn't bet)
Seat 5: jjuul folded before Flop (didn't bet)
Seat 6: leedsrounder collected ($0.22)

PokerStars Zoom Hand #247968715887:  Hold'em No Limit ($0.01/$0.02) - 2023/12/30 22:24:02 WET [2023/12/30 17:24:02 ET]
Table 'Halley' 6-max Seat #1 is the button
Seat 1: LLregs ($12.04 in chips)
Seat 2: erikpavon ($2.54 in chips)
Seat 3: Harold_Seven ($1.42 in chips)
Seat 4: HooliganBasher ($2.19 in chips)
Seat 5: Player928475 ($2.08 in chips)
Seat 6: Weily8 ($1.70 in chips)
erikpavon: posts small blind $0.01
Harold_Seven: posts big blind $0.02
*** HOLE CARDS ***
Dealt to LLregs [Ad 3c]
HooliganBasher: folds
Player928475: folds
Weily8: folds
LLregs: folds
erikpavon: raises $0.04 to $0.06
Harold_Seven: folds
Uncalled bet ($0.04) returned to erikpavon
erikpavon collected $0.04 from pot
erikpavon: doesn't show hand
*** SUMMARY ***
Total pot $0.04 | Rake $0
Seat 1: LLregs (button) folded before Flop (didn't bet)
Seat 2: erikpavon (small blind) collected ($0.04)
Seat 3: Harold_Seven (big blind) folded before Flop
Seat 4: HooliganBasher folded before Flop (didn't bet)
Seat 5: Player928475 folded before Flop (didn't bet)
Seat 6: Weily8 folded before Flop (didn't bet)

PokerStars Zoom Hand #247968717328:  Hold'em No Limit ($0.01/$0.02) - 2023/12/30 22:24:06 WET [2023/12/30 17:24:06 ET]
Table 'Halley' 6-max Seat #1 is the button
Seat 1: papakulikov ($2.32 in chips)
Seat 2: Weily8 ($1.70 in chips)
Seat 3: marcos15vargass ($3.55 in chips)
Seat 4: LLregs ($12.04 in chips)
Seat 5: IngeniEbr10 ($2.09 in chips)
Seat 6: Limpingpolice ($8.07 in chips)
Weily8: posts small blind $0.01
marcos15vargass: posts big blind $0.02
*** HOLE CARDS ***
Dealt to LLregs [4s 4d]
LLregs: folds
IngeniEbr10: raises $0.02 to $0.04
Limpingpolice: folds
papakulikov: folds
Weily8: raises $0.12 to $0.16
marcos15vargass: folds
IngeniEbr10: folds
Uncalled bet ($0.12) returned to Weily8
Weily8 collected $0.10 from pot
Weily8: doesn't show hand
*** SUMMARY ***
Total pot $0.10 | Rake $0
Seat 1: papakulikov (button) folded before Flop (didn't bet)
Seat 2: Weily8 (small blind) collected ($0.10)
Seat 3: marcos15vargass (big blind) folded before Flop
Seat 4: LLregs folded before Flop (didn't bet)
Seat 5: IngeniEbr10 folded before Flop
Seat 6: Limpingpolice folded before Flop (didn't bet)

PokerStars Zoom Hand #247968718496:  Hold'em No Limit ($0.01/$0.02) - 2023/12/30 22:24:09 WET [2023/12/30 17:24:09 ET]
Table 'Halley' 6-max Seat #1 is the button
Seat 1: Beduin250 ($2.20 in chips)
Seat 2: shavarun ($2.07 in chips)
Seat 3: TeodorRR92 ($2.86 in chips)
Seat 4: LLregs ($12.04 in chips)
Seat 5: frankquanki ($2.85 in chips)
Seat 6: FrancoGaston74 ($2.89 in chips)
shavarun: posts small blind $0.01
TeodorRR92: posts big blind $0.02
*** HOLE CARDS ***
Dealt to LLregs [6d 2d]
LLregs: folds
frankquanki: raises $0.04 to $0.06
FrancoGaston74: folds
Beduin250: calls $0.06
shavarun: folds
TeodorRR92: calls $0.04
*** FLOP *** [2h 6s Qh]
TeodorRR92: checks
frankquanki: checks
Beduin250: checks
*** TURN *** [2h 6s Qh] [Ah]
TeodorRR92: bets $0.13
frankquanki: folds
Beduin250: folds
Uncalled bet ($0.13) returned to TeodorRR92
TeodorRR92 collected $0.18 from pot
TeodorRR92: doesn't show hand
*** SUMMARY ***
Total pot $0.19 | Rake $0.01
Board [2h 6s Qh Ah]
Seat 1: Beduin250 (button) folded on the Turn
Seat 2: shavarun (small blind) folded before Flop
Seat 3: TeodorRR92 (big blind) collected ($0.18)
Seat 4: LLregs folded before Flop (didn't bet)
Seat 5: frankquanki folded on the Turn
Seat 6: FrancoGaston74 folded before Flop (didn't bet)

PokerStars Zoom Hand #247968720038:  Hold'em No Limit ($0.01/$0.02) - 2023/12/30 22:24:13 WET [2023/12/30 17:24:13 ET]
Table 'Halley' 6-max Seat #1 is the button
Seat 1: underwater91 ($1.20 in chips)
Seat 2: 3ener ($4.31 in chips)
Seat 3: mikasafin ($2.23 in chips)
Seat 4: Kamylo20 ($2.63 in chips)
Seat 5: pedroph3ks ($1.95 in chips)
Seat 6: LLregs ($12.04 in chips)
3ener: posts small blind $0.01
mikasafin: posts big blind $0.02
*** HOLE CARDS ***
Dealt to LLregs [Js Jc]
Kamylo20: folds
pedroph3ks: raises $0.03 to $0.05
LLregs: raises $0.15 to $0.20
underwater91: folds
3ener: folds
mikasafin: folds
pedroph3ks: calls $0.15
*** FLOP *** [3s 8h Qc]
pedroph3ks: checks
LLregs: bets $0.20
pedroph3ks: calls $0.20
*** TURN *** [3s 8h Qc] [6h]
pedroph3ks: checks
LLregs: bets $0.26
pedroph3ks: calls $0.26
*** RIVER *** [3s 8h Qc 6h] [Ts]
pedroph3ks: checks
LLregs: checks
*** SHOW DOWN ***
pedroph3ks: shows [As Ks] (high card Ace)
LLregs: shows [Js Jc] (a pair of Jacks)
LLregs collected $1.30 from pot
*** SUMMARY ***
Total pot $1.35 | Rake $0.05
Board [3s 8h Qc 6h Ts]
Seat 1: underwater91 (button) folded before Flop (didn't bet)
Seat 2: 3ener (small blind) folded before Flop
Seat 3: mikasafin (big blind) folded before Flop
Seat 4: Kamylo20 folded before Flop (didn't bet)
Seat 5: pedroph3ks showed [As Ks] and lost with high card Ace
Seat 6: LLregs showed [Js Jc] and won ($1.30) with a pair of Jacks

PokerStars Zoom Hand #247968750145:  Hold'em No Limit ($0.01/$0.02) - 2023/12/30 22:25:31 WET [2023/12/30 17:25:31 ET]
Table 'Halley' 6-max Seat #1 is the button
Seat 1: HarryHaller77 ($2.11 in chips)
Seat 2: AdriPato ($2 in chips)
Seat 3: TheOliver ($2.88 in chips)
Seat 4: gesaes ($1.94 in chips)
Seat 5: LLregs ($12.67 in chips)
Seat 6: leonardoobsb ($2.15 in chips)
AdriPato: posts small blind $0.01
TheOliver: posts big blind $0.02
*** HOLE CARDS ***
Dealt to LLregs [6d Td]
gesaes: folds
LLregs: folds
leonardoobsb: folds
HarryHaller77: folds
AdriPato: raises $0.04 to $0.06
TheOliver: folds
Uncalled bet ($0.04) returned to AdriPato
AdriPato collected $0.04 from pot
AdriPato: doesn't show hand
*** SUMMARY ***
Total pot $0.04 | Rake $0
Seat 1: HarryHaller77 (button) folded before Flop (didn't bet)
Seat 2: AdriPato (small blind) collected ($0.04)
Seat 3: TheOliver (big blind) folded before Flop
Seat 4: gesaes folded before Flop (didn't bet)
Seat 5: LLregs folded before Flop (didn't bet)
Seat 6: leonardoobsb folded before Flop (didn't bet)

PokerStars Zoom Hand #247968746033:  Hold'em No Limit ($0.01/$0.02) - 2023/12/30 22:25:20 WET [2023/12/30 17:25:20 ET]
Table 'Halley' 6-max Seat #1 is the button
Seat 1: 888lifeIS ($2.15 in chips)
Seat 2: LLregs ($12.68 in chips)
Seat 3: Odysseia ($1.31 in chips)
Seat 4: NineHi72 ($15.67 in chips)
Seat 5: IBRODIAN-ACER ($2.35 in chips)
Seat 6: Dr_$$$pookey ($3.46 in chips)
LLregs: posts small blind $0.01
Odysseia: posts big blind $0.02
*** HOLE CARDS ***
Dealt to LLregs [4h 5c]
NineHi72: folds
IBRODIAN-ACER: folds
Dr_$$$pookey: folds
888lifeIS: raises $0.02 to $0.04
LLregs: folds
Odysseia: calls $0.02
*** FLOP *** [Kd 4d 6h]
Odysseia: checks
888lifeIS: bets $0.06
Odysseia: folds
Uncalled bet ($0.06) returned to 888lifeIS
888lifeIS collected $0.09 from pot
888lifeIS: doesn't show hand
*** SUMMARY ***
Total pot $0.09 | Rake $0
Board [Kd 4d 6h]
Seat 1: 888lifeIS (button) collected ($0.09)
Seat 2: LLregs (small blind) folded before Flop
Seat 3: Odysseia (big blind) folded on the Flop
Seat 4: NineHi72 folded before Flop (didn't bet)
Seat 5: IBRODIAN-ACER folded before Flop (didn't bet)
Seat 6: Dr_$$$pookey folded before Flop (didn't bet)

PokerStars Zoom Hand #247968751653:  Hold'em No Limit ($0.01/$0.02) - 2023/12/30 22:25:35 WET [2023/12/30 17:25:35 ET]
Table 'Halley' 6-max Seat #1 is the button
Seat 1: Estepario_KA ($7.44 in chips)
Seat 2: HooliganBasher ($2 in chips)
Seat 3: LLregs ($12.67 in chips)
Seat 4: Quantum771 ($2.05 in chips)
Seat 5: CaptainB1ack ($4.79 in chips)
Seat 6: IBRODIAN-ACER ($2.78 in chips)
HooliganBasher: posts small blind $0.01
LLregs: posts big blind $0.02
*** HOLE CARDS ***
Dealt to LLregs [4h Qc]
Quantum771: folds
CaptainB1ack: folds
IBRODIAN-ACER: folds
Estepario_KA: raises $0.04 to $0.06
HooliganBasher: folds
LLregs: folds
Uncalled bet ($0.04) returned to Estepario_KA
Estepario_KA collected $0.05 from pot
Estepario_KA: doesn't show hand
*** SUMMARY ***
Total pot $0.05 | Rake $0
Seat 1: Estepario_KA (button) collected ($0.05)
Seat 2: HooliganBasher (small blind) folded before Flop
Seat 3: LLregs (big blind) folded before Flop
Seat 4: Quantum771 folded before Flop (didn't bet)
Seat 5: CaptainB1ack folded before Flop (didn't bet)
Seat 6: IBRODIAN-ACER folded before Flop (didn't bet)

PokerStars Zoom Hand #247968748590:  Hold'em No Limit ($0.01/$0.02) - 2023/12/30 22:25:27 WET [2023/12/30 17:25:27 ET]
Table 'Halley' 6-max Seat #1 is the button
Seat 1: LLregs ($12.67 in chips)
Seat 2: Dr_$$$pookey ($3.46 in chips)
Seat 3: IBRODIAN-ACER ($2.35 in chips)
Seat 4: Estepario_KA ($4.91 in chips)
Seat 5: degelcamus ($3.30 in chips)
Seat 6: jamam333 ($5.71 in chips)
Dr_$$$pookey: posts small blind $0.01
IBRODIAN-ACER: posts big blind $0.02
*** HOLE CARDS ***
Dealt to LLregs [2d 4s]
Estepario_KA: raises $0.04 to $0.06
degelcamus: folds
jamam333: calls $0.06
LLregs: folds
Dr_$$$pookey: calls $0.05
IBRODIAN-ACER: folds
*** FLOP *** [Ad 4h 9s]
Dr_$$$pookey: checks
Estepario_KA: bets $0.10
jamam333: folds
Dr_$$$pookey: calls $0.10
*** TURN *** [Ad 4h 9s] [Jc]
Dr_$$$pookey: checks
Estepario_KA: checks
*** RIVER *** [Ad 4h 9s Jc] [4d]
Dr_$$$pookey: bets $0.38
Estepario_KA: folds
Uncalled bet ($0.38) returned to Dr_$$$pookey
Dr_$$$pookey collected $0.39 from pot
Dr_$$$pookey: doesn't show hand
*** SUMMARY ***
Total pot $0.40 | Rake $0.01
Board [Ad 4h 9s Jc 4d]
Seat 1: LLregs (button) folded before Flop (didn't bet)
Seat 2: Dr_$$$pookey (small blind) collected ($0.39)
Seat 3: IBRODIAN-ACER (big blind) folded before Flop
Seat 4: Estepario_KA folded on the River
Seat 5: degelcamus folded before Flop (didn't bet)
Seat 6: jamam333 folded on the Flop

PokerStars Zoom Hand #247968756866:  Hold'em No Limit ($0.01/$0.02) - 2023/12/30 22:25:48 WET [2023/12/30 17:25:48 ET]
Table 'Halley' 6-max Seat #1 is the button
Seat 1: batya1212 ($2.36 in chips)
Seat 2: LLregs ($12.65 in chips)
Seat 3: Wilmots18 ($2.17 in chips)
Seat 4: 3ener ($8.77 in chips)
Seat 5: kasse112 ($6.28 in chips)
Seat 6: Mrga02 ($2.45 in chips)
LLregs: posts small blind $0.01
Wilmots18: posts big blind $0.02
*** HOLE CARDS ***
Dealt to LLregs [6c As]
3ener: raises $0.02 to $0.04
kasse112: folds
Mrga02: folds
batya1212: folds
LLregs: calls $0.03
Wilmots18: folds
*** FLOP *** [5s Qd 2d]
LLregs: checks
3ener: bets $0.05
LLregs: raises $0.11 to $0.16
3ener: calls $0.11
*** TURN *** [5s Qd 2d] [Ad]
LLregs: checks
3ener: checks
*** RIVER *** [5s Qd 2d Ad] [Qs]
LLregs: bets $0.20
3ener: calls $0.20
*** SHOW DOWN ***
LLregs: shows [6c As] (two pair, Aces and Queens)
3ener: mucks hand
LLregs collected $0.79 from pot
*** SUMMARY ***
Total pot $0.82 | Rake $0.03
Board [5s Qd 2d Ad Qs]
Seat 1: batya1212 (button) folded before Flop (didn't bet)
Seat 2: LLregs (small blind) showed [6c As] and won ($0.79) with two pair, Aces and Queens
Seat 3: Wilmots18 (big blind) folded before Flop
Seat 4: 3ener mucked [6d 6h]
Seat 5: kasse112 folded before Flop (didn't bet)
Seat 6: Mrga02 folded before Flop (didn't bet)

PokerStars Zoom Hand #247968776262:  Hold'em No Limit ($0.01/$0.02) - 2023/12/30 22:26:39 WET [2023/12/30 17:26:39 ET]
Table 'Halley' 6-max Seat #1 is the button
Seat 1: DropIceoleito ($1.39 in chips)
Seat 2: Mwilson766 ($1.80 in chips)
Seat 3: 514dw5000 ($1.20 in chips)
Seat 4: AdriPato ($4.53 in chips)
Seat 5: danik87654321 ($1.97 in chips)
Seat 6: LLregs ($13.04 in chips)
Mwilson766: posts small blind $0.01
514dw5000: posts big blind $0.02
*** HOLE CARDS ***
Dealt to LLregs [3d 6c]
AdriPato: folds
danik87654321: raises $0.04 to $0.06
LLregs: folds
DropIceoleito: raises $1.33 to $1.39 and is all-in
Mwilson766: folds
514dw5000: folds
danik87654321: folds
Uncalled bet ($1.33) returned to DropIceoleito
DropIceoleito collected $0.15 from pot
DropIceoleito: doesn't show hand
*** SUMMARY ***
Total pot $0.15 | Rake $0
Seat 1: DropIceoleito (button) collected ($0.15)
Seat 2: Mwilson766 (small blind) folded before Flop
Seat 3: 514dw5000 (big blind) folded before Flop
Seat 4: AdriPato folded before Flop (didn't bet)
Seat 5: danik87654321 folded before Flop
Seat 6: LLregs folded before Flop (didn't bet)

PokerStars Zoom Hand #247968780828:  Hold'em No Limit ($0.01/$0.02) - 2023/12/30 22:26:51 WET [2023/12/30 17:26:51 ET]
Table 'Halley' 6-max Seat #1 is the button
Seat 1: LLregs ($13.04 in chips)
Seat 2: Mizhina ($2 in chips)
Seat 3: hybridi ($2.09 in chips)
Seat 4: DanRussel ($1.53 in chips)
Seat 5: greyman34940 ($2.71 in chips)
Seat 6: frankquanki ($3.51 in chips)
Mizhina: posts small blind $0.01
hybridi: posts big blind $0.02
*** HOLE CARDS ***
Dealt to LLregs [Td Tc]
DanRussel: folds
greyman34940: folds
frankquanki: raises $0.04 to $0.06
LLregs: raises $0.10 to $0.16
Mizhina: folds
hybridi: folds
frankquanki: folds
Uncalled bet ($0.10) returned to LLregs
LLregs collected $0.15 from pot
LLregs: doesn't show hand
*** SUMMARY ***
Total pot $0.15 | Rake $0
Seat 1: LLregs (button) collected ($0.15)
Seat 2: Mizhina (small blind) folded before Flop
Seat 3: hybridi (big blind) folded before Flop
Seat 4: DanRussel folded before Flop (didn't bet)
Seat 5: greyman34940 folded before Flop (didn't bet)
Seat 6: frankquanki folded before Flop

PokerStars Zoom Hand #247968787147:  Hold'em No Limit ($0.01/$0.02) - 2023/12/30 22:27:07 WET [2023/12/30 17:27:07 ET]
Table 'Halley' 6-max Seat #1 is the button
Seat 1: srna10 ($3.45 in chips)
Seat 2: BossTH4 ($3.17 in chips)
Seat 3: Harold_Seven ($1.51 in chips)
Seat 4: shavarun ($2.54 in chips)
Seat 5: LLregs ($13.13 in chips)
Seat 6: haevyT220 ($2.66 in chips)
BossTH4: posts small blind $0.01
Harold_Seven: posts big blind $0.02
*** HOLE CARDS ***
Dealt to LLregs [3h Qs]
shavarun: folds
LLregs: folds
haevyT220: calls $0.02
srna10: raises $0.06 to $0.08
BossTH4: folds
Harold_Seven: calls $0.06
haevyT220: calls $0.06
*** FLOP *** [5d 3c Th]
Harold_Seven: checks
haevyT220: checks
srna10: bets $0.18
Harold_Seven: folds
haevyT220: folds
Uncalled bet ($0.18) returned to srna10
srna10 collected $0.24 from pot
srna10: doesn't show hand
*** SUMMARY ***
Total pot $0.25 | Rake $0.01
Board [5d 3c Th]
Seat 1: srna10 (button) collected ($0.24)
Seat 2: BossTH4 (small blind) folded before Flop
Seat 3: Harold_Seven (big blind) folded on the Flop
Seat 4: shavarun folded before Flop (didn't bet)
Seat 5: LLregs folded before Flop (didn't bet)
Seat 6: haevyT220 folded on the Flop

PokerStars Zoom Hand #247968788978:  Hold'em No Limit ($0.01/$0.02) - 2023/12/30 22:27:12 WET [2023/12/30 17:27:12 ET]
Table 'Halley' 6-max Seat #1 is the button
Seat 1: IngeniEbr10 ($2.71 in chips)
Seat 2: portilho69 ($1.77 in chips)
Seat 3: TamiSieche ($1.33 in chips)
Seat 4: LLregs ($13.13 in chips)
Seat 5: Szklana.poker ($3.14 in chips)
Seat 6: LakiusPS ($0.90 in chips)
portilho69: posts small blind $0.01
TamiSieche: posts big blind $0.02
*** HOLE CARDS ***
Dealt to LLregs [9d 8h]
LLregs: folds
Szklana.poker: folds
LakiusPS: calls $0.02
IngeniEbr10: folds
portilho69: raises $0.02 to $0.04
TamiSieche: folds
LakiusPS: calls $0.02
*** FLOP *** [8d Kc Qc]
portilho69: bets $0.10
LakiusPS: calls $0.10
*** TURN *** [8d Kc Qc] [5h]
portilho69: checks
LakiusPS: bets $0.20
portilho69: folds
Uncalled bet ($0.20) returned to LakiusPS
LakiusPS collected $0.29 from pot
LakiusPS: doesn't show hand
*** SUMMARY ***
Total pot $0.30 | Rake $0.01
Board [8d Kc Qc 5h]
Seat 1: IngeniEbr10 (button) folded before Flop (didn't bet)
Seat 2: portilho69 (small blind) folded on the Turn
Seat 3: TamiSieche (big blind) folded before Flop
Seat 4: LLregs folded before Flop (didn't bet)
Seat 5: Szklana.poker folded before Flop (didn't bet)
Seat 6: LakiusPS collected ($0.29)

PokerStars Zoom Hand #247968790442:  Hold'em No Limit ($0.01/$0.02) - 2023/12/30 22:27:16 WET [2023/12/30 17:27:16 ET]
Table 'Halley' 6-max Seat #1 is the button
Seat 1: leedsrounder ($2.26 in chips)
Seat 2: BrinkssBrow ($1.88 in chips)
Seat 3: LLregs ($13.13 in chips)
Seat 4: davor987 ($2 in chips)
Seat 5: emopokera ($2.38 in chips)
Seat 6: Odysseia ($0.67 in chips)
BrinkssBrow: posts small blind $0.01
LLregs: posts big blind $0.02
*** HOLE CARDS ***
Dealt to LLregs [Ks Qh]
davor987: folds
emopokera: folds
Odysseia: raises $0.02 to $0.04
leedsrounder: raises $0.08 to $0.12
BrinkssBrow: folds
LLregs: calls $0.10
Odysseia: calls $0.08
*** FLOP *** [4h 7c 4c]
LLregs: checks
Odysseia: checks
leedsrounder: bets $0.24
LLregs: folds
Odysseia: folds
Uncalled bet ($0.24) returned to leedsrounder
leedsrounder collected $0.36 from pot
leedsrounder: doesn't show hand
*** SUMMARY ***
Total pot $0.37 | Rake $0.01
Board [4h 7c 4c]
Seat 1: leedsrounder (button) collected ($0.36)
Seat 2: BrinkssBrow (small blind) folded before Flop
Seat 3: LLregs (big blind) folded on the Flop
Seat 4: davor987 folded before Flop (didn't bet)
Seat 5: emopokera folded before Flop (didn't bet)
Seat 6: Odysseia folded on the Flop

PokerStars Zoom Hand #247968808258:  Hold'em No Limit ($0.01/$0.02) - 2023/12/30 22:28:02 WET [2023/12/30 17:28:02 ET]
Table 'Halley' 6-max Seat #1 is the button
Seat 1: shovetoi ($2.04 in chips)
Seat 2: Mizhina ($2.17 in chips)
Seat 3: IBRODIAN-ACER ($8.95 in chips)
Seat 4: FlyingAm1sh ($4.94 in chips)
Seat 5: CrazyMozggg ($0.72 in chips)
Seat 6: LLregs ($13.01 in chips)
Mizhina: posts small blind $0.01
IBRODIAN-ACER: posts big blind $0.02
*** HOLE CARDS ***
Dealt to LLregs [Qd Ah]
FlyingAm1sh: folds
CrazyMozggg: folds
LLregs: raises $0.04 to $0.06
shovetoi: folds
Mizhina: folds
IBRODIAN-ACER: folds
Uncalled bet ($0.04) returned to LLregs
LLregs collected $0.05 from pot
LLregs: doesn't show hand
*** SUMMARY ***
Total pot $0.05 | Rake $0
Seat 1: shovetoi (button) folded before Flop (didn't bet)
Seat 2: Mizhina (small blind) folded before Flop
Seat 3: IBRODIAN-ACER (big blind) folded before Flop
Seat 4: FlyingAm1sh folded before Flop (didn't bet)
Seat 5: CrazyMozggg folded before Flop (didn't bet)
Seat 6: LLregs collected ($0.05)

PokerStars Zoom Hand #247968817415:  Hold'em No Limit ($0.01/$0.02) - 2023/12/30 22:28:26 WET [2023/12/30 17:28:26 ET]
Table 'Halley' 6-max Seat #1 is the button
Seat 1: LLregs ($13.04 in chips)
Seat 2: Kamylo20 ($3.89 in chips)
Seat 3: frankquanki ($4.37 in chips)
Seat 4: my sapphire ($2.02 in chips)
Seat 5: JucyBits ($2 in chips)
Seat 6: Estepario_KA ($7.22 in chips)
Kamylo20: posts small blind $0.01
frankquanki: posts big blind $0.02
*** HOLE CARDS ***
Dealt to LLregs [3c 3s]
my sapphire: folds
JucyBits: folds
Estepario_KA: folds
LLregs: raises $0.04 to $0.06
Kamylo20: folds
frankquanki: raises $0.13 to $0.19
LLregs: calls $0.13
*** FLOP *** [Jd 5c Ah]
frankquanki: bets $0.19
LLregs: folds
Uncalled bet ($0.19) returned to frankquanki
frankquanki collected $0.38 from pot
frankquanki: doesn't show hand
*** SUMMARY ***
Total pot $0.39 | Rake $0.01
Board [Jd 5c Ah]
Seat 1: LLregs (button) folded on the Flop
Seat 2: Kamylo20 (small blind) folded before Flop
Seat 3: frankquanki (big blind) collected ($0.38)
Seat 4: my sapphire folded before Flop (didn't bet)
Seat 5: JucyBits folded before Flop (didn't bet)
Seat 6: Estepario_KA folded before Flop (didn't bet)

PokerStars Zoom Hand #247968825079:  Hold'em No Limit ($0.01/$0.02) - 2023/12/30 22:28:46 WET [2023/12/30 17:28:46 ET]
Table 'Halley' 6-max Seat #1 is the button
Seat 1: Mary_D_1973 ($2.16 in chips)
Seat 2: LLregs ($12.85 in chips)
Seat 3: Molineux2002 ($3.89 in chips)
Seat 4: Mavis Ann ($1.68 in chips)
Seat 5: WEBOO1 ($2.78 in chips)
Seat 6: sTIKs21 ($4.14 in chips)
LLregs: posts small blind $0.01
Molineux2002: posts big blind $0.02
*** HOLE CARDS ***
Dealt to LLregs [7h 7s]
Mavis Ann: calls $0.02
WEBOO1: folds
sTIKs21: folds
Mary_D_1973: raises $0.04 to $0.06
LLregs: calls $0.05
Molineux2002: folds
Mavis Ann: calls $0.04
*** FLOP *** [7c As 2s]
LLregs: checks
Mavis Ann: bets $0.02
Mary_D_1973: calls $0.02
LLregs: calls $0.02
*** TURN *** [7c As 2s] [Qd]
LLregs: checks
Mavis Ann: bets $0.02
Mary_D_1973: calls $0.02
LLregs: calls $0.02
*** RIVER *** [7c As 2s Qd] [5h]
LLregs: checks
Mavis Ann: bets $0.02
Mary_D_1973: calls $0.02
LLregs: raises $0.28 to $0.30
Mavis Ann: calls $0.28
Mary_D_1973: folds
*** SHOW DOWN ***
LLregs: shows [7h 7s] (three of a kind, Sevens)
Mavis Ann: mucks hand
LLregs collected $0.91 from pot
*** SUMMARY ***
Total pot $0.94 | Rake $0.03
Board [7c As 2s Qd 5h]
Seat 1: Mary_D_1973 (button) folded on the River
Seat 2: LLregs (small blind) showed [7h 7s] and won ($0.91) with three of a kind, Sevens
Seat 3: Molineux2002 (big blind) folded before Flop
Seat 4: Mavis Ann mucked [7d Ad]
Seat 5: WEBOO1 folded before Flop (didn't bet)
Seat 6: sTIKs21 folded before Flop (didn't bet)

PokerStars Zoom Hand #247968858745:  Hold'em No Limit ($0.01/$0.02) - 2023/12/30 22:30:14 WET [2023/12/30 17:30:14 ET]
Table 'Halley' 6-max Seat #1 is the button
Seat 1: pedroph3ks ($1.98 in chips)
Seat 2: SeuCleiton ($3.15 in chips)
Seat 3: Raymond322 ($4.87 in chips)
Seat 4: LLregs ($13.36 in chips)
Seat 5: Mrga02 ($2.29 in chips)
Seat 6: FlyingAm1sh ($4.96 in chips)
SeuCleiton: posts small blind $0.01
Raymond322: posts big blind $0.02
*** HOLE CARDS ***
Dealt to LLregs [Js 3d]
LLregs: folds
Mrga02: raises $0.03 to $0.05
FlyingAm1sh: folds
pedroph3ks: folds
SeuCleiton: folds
Raymond322: folds
Uncalled bet ($0.03) returned to Mrga02
Mrga02 collected $0.05 from pot
Mrga02: doesn't show hand
*** SUMMARY ***
Total pot $0.05 | Rake $0
Seat 1: pedroph3ks (button) folded before Flop (didn't bet)
Seat 2: SeuCleiton (small blind) folded before Flop
Seat 3: Raymond322 (big blind) folded before Flop
Seat 4: LLregs folded before Flop (didn't bet)
Seat 5: Mrga02 collected ($0.05)
Seat 6: FlyingAm1sh folded before Flop (didn't bet)

PokerStars Zoom Hand #247968862116:  Hold'em No Limit ($0.01/$0.02) - 2023/12/30 22:30:23 WET [2023/12/30 17:30:23 ET]
Table 'Halley' 6-max Seat #1 is the button
Seat 1: greyman34940 ($3.60 in chips)
Seat 2: ONIPIKA ($2.01 in chips)
Seat 3: LLregs ($13.36 in chips)
Seat 4: lksmonster ($2.59 in chips)
Seat 5: edhillm ($2.02 in chips)
Seat 6: S-Solaris83 ($2.25 in chips)
ONIPIKA: posts small blind $0.01
LLregs: posts big blind $0.02
*** HOLE CARDS ***
Dealt to LLregs [Ts 2d]
lksmonster: raises $0.04 to $0.06
edhillm: folds
S-Solaris83: folds
greyman34940: folds
ONIPIKA: folds
LLregs: folds
Uncalled bet ($0.04) returned to lksmonster
lksmonster collected $0.05 from pot
lksmonster: doesn't show hand
*** SUMMARY ***
Total pot $0.05 | Rake $0
Seat 1: greyman34940 (button) folded before Flop (didn't bet)
Seat 2: ONIPIKA (small blind) folded before Flop
Seat 3: LLregs (big blind) folded before Flop
Seat 4: lksmonster collected ($0.05)
Seat 5: edhillm folded before Flop (didn't bet)
Seat 6: S-Solaris83 folded before Flop (didn't bet)

PokerStars Zoom Hand #247968855011:  Hold'em No Limit ($0.01/$0.02) - 2023/12/30 22:30:04 WET [2023/12/30 17:30:04 ET]
Table 'Halley' 6-max Seat #1 is the button
Seat 1: robirevesz2002 ($0.93 in chips)
Seat 2: Libin13 ($6.51 in chips)
Seat 3: Argani619 ($4.18 in chips)
Seat 4: haevyT220 ($2.48 in chips)
Seat 5: LLregs ($13.36 in chips)
Seat 6: Estepario_KA ($7.19 in chips)
Libin13: posts small blind $0.01
Argani619: posts big blind $0.02
*** HOLE CARDS ***
Dealt to LLregs [4c 3d]
haevyT220: calls $0.02
LLregs: folds
Estepario_KA: raises $0.04 to $0.06
robirevesz2002: calls $0.06
Libin13: folds
Argani619: folds
haevyT220: folds
*** FLOP *** [3s 2s 7h]
Estepario_KA: checks
robirevesz2002: checks
*** TURN *** [3s 2s 7h] [8c]
Estepario_KA: bets $0.08
robirevesz2002: calls $0.08
*** RIVER *** [3s 2s 7h 8c] [Qc]
Estepario_KA: checks
robirevesz2002: checks
*** SHOW DOWN ***
Estepario_KA: shows [3c Ac] (a pair of Threes)
robirevesz2002: shows [3h 2h] (two pair, Threes and Deuces)
robirevesz2002 collected $0.32 from pot
*** SUMMARY ***
Total pot $0.33 | Rake $0.01
Board [3s 2s 7h 8c Qc]
Seat 1: robirevesz2002 (button) showed [3h 2h] and won ($0.32) with two pair, Threes and Deuces
Seat 2: Libin13 (small blind) folded before Flop
Seat 3: Argani619 (big blind) folded before Flop
Seat 4: haevyT220 folded before Flop
Seat 5: LLregs folded before Flop (didn't bet)
Seat 6: Estepario_KA showed [3c Ac] and lost with a pair of Threes

PokerStars Zoom Hand #247968860253:  Hold'em No Limit ($0.01/$0.02) - 2023/12/30 22:30:18 WET [2023/12/30 17:30:18 ET]
Table 'Halley' 6-max Seat #1 is the button
Seat 1: ZiggyBoy90 ($3.28 in chips)
Seat 2: batya1212 ($2.31 in chips)
Seat 3: postcomd ($1.94 in chips)
Seat 4: LLregs ($13.36 in chips)
Seat 5: HarryHaller77 ($2.43 in chips)
Seat 6: FokaPKS ($0.60 in chips)
batya1212: posts small blind $0.01
postcomd: posts big blind $0.02
*** HOLE CARDS ***
Dealt to LLregs [Qc 2h]
LLregs: folds
HarryHaller77: folds
FokaPKS: folds
ZiggyBoy90: raises $0.03 to $0.05
batya1212: folds
postcomd: calls $0.03
*** FLOP *** [9s 4c 5d]
postcomd: checks
ZiggyBoy90: bets $0.04
postcomd: calls $0.04
*** TURN *** [9s 4c 5d] [4h]
postcomd: checks
ZiggyBoy90: checks
*** RIVER *** [9s 4c 5d 4h] [7h]
postcomd: bets $0.09
ZiggyBoy90: folds
Uncalled bet ($0.09) returned to postcomd
postcomd collected $0.18 from pot
postcomd: doesn't show hand
*** SUMMARY ***
Total pot $0.19 | Rake $0.01
Board [9s 4c 5d 4h 7h]
Seat 1: ZiggyBoy90 (button) folded on the River
Seat 2: batya1212 (small blind) folded before Flop
Seat 3: postcomd (big blind) collected ($0.18)
Seat 4: LLregs folded before Flop (didn't bet)
Seat 5: HarryHaller77 folded before Flop (didn't bet)
Seat 6: FokaPKS folded before Flop (didn't bet)

PokerStars Zoom Hand #247968869634:  Hold'em No Limit ($0.01/$0.02) - 2023/12/30 22:30:43 WET [2023/12/30 17:30:43 ET]
Table 'Halley' 6-max Seat #1 is the button
Seat 1: ZiggyBoy90 ($2.28 in chips)
Seat 2: LLregs ($13.34 in chips)
Seat 3: hybridi ($2.28 in chips)
Seat 4: Dimoni797979 ($3.49 in chips)
Seat 5: frankquanki ($5.92 in chips)
Seat 6: danival2 ($7.54 in chips)
LLregs: posts small blind $0.01
hybridi: posts big blind $0.02
*** HOLE CARDS ***
Dealt to LLregs [Jc 5h]
Dimoni797979 has timed out
Dimoni797979: folds
frankquanki: folds
danival2: folds
ZiggyBoy90: folds
LLregs: raises $0.04 to $0.06
hybridi: folds
Uncalled bet ($0.04) returned to LLregs
LLregs collected $0.04 from pot
LLregs: doesn't show hand
*** SUMMARY ***
Total pot $0.04 | Rake $0
Seat 1: ZiggyBoy90 (button) folded before Flop (didn't bet)
Seat 2: LLregs (small blind) collected ($0.04)
Seat 3: hybridi (big blind) folded before Flop
Seat 4: Dimoni797979 folded before Flop (didn't bet)
Seat 5: frankquanki folded before Flop (didn't bet)
Seat 6: danival2 folded before Flop (didn't bet)

PokerStars Zoom Hand #247968883880:  Hold'em No Limit ($0.01/$0.02) - 2023/12/30 22:31:22 WET [2023/12/30 17:31:22 ET]
Table 'Halley' 6-max Seat #1 is the button
Seat 1: emopokera ($3.47 in chips)
Seat 2: WEBOO1 ($2.85 in chips)
Seat 3: HooliganBasher ($2.59 in chips)
Seat 4: leonardoobsb ($2.14 in chips)
Seat 5: jakeboots ($2.20 in chips)
Seat 6: LLregs ($13.36 in chips)
WEBOO1: posts small blind $0.01
HooliganBasher: posts big blind $0.02
*** HOLE CARDS ***
Dealt to LLregs [Kh Qd]
leonardoobsb: folds
jakeboots: folds
LLregs: raises $0.04 to $0.06
emopokera: folds
WEBOO1: folds
HooliganBasher: calls $0.04
*** FLOP *** [4s 6s Ts]
HooliganBasher: checks
LLregs: bets $0.04
HooliganBasher: calls $0.04
*** TURN *** [4s 6s Ts] [9h]
HooliganBasher: checks
LLregs: bets $0.15
HooliganBasher: folds
Uncalled bet ($0.15) returned to LLregs
LLregs collected $0.20 from pot
LLregs: doesn't show hand
*** SUMMARY ***
Total pot $0.21 | Rake $0.01
Board [4s 6s Ts 9h]
Seat 1: emopokera (button) folded before Flop (didn't bet)
Seat 2: WEBOO1 (small blind) folded before Flop
Seat 3: HooliganBasher (big blind) folded on the Turn
Seat 4: leonardoobsb folded before Flop (didn't bet)
Seat 5: jakeboots folded before Flop (didn't bet)
Seat 6: LLregs collected ($0.20)

PokerStars Zoom Hand #247968899814:  Hold'em No Limit ($0.01/$0.02) - 2023/12/30 22:32:04 WET [2023/12/30 17:32:04 ET]
Table 'Halley' 6-max Seat #1 is the button
Seat 1: danielito577 ($1.27 in chips)
Seat 2: jbarrios007 ($5.29 in chips)
Seat 3: degelcamus ($3.18 in chips)
Seat 4: bmrao ($2.68 in chips)
Seat 5: LLregs ($13.46 in chips)
Seat 6: emiliospoker ($1.12 in chips)
jbarrios007: posts small blind $0.01
degelcamus: posts big blind $0.02
*** HOLE CARDS ***
Dealt to LLregs [Ts 2h]
bmrao: folds
LLregs: folds
emiliospoker: folds
danielito577: folds
jbarrios007: raises $0.04 to $0.06
degelcamus: folds
Uncalled bet ($0.04) returned to jbarrios007
jbarrios007 collected $0.04 from pot
jbarrios007: doesn't show hand
*** SUMMARY ***
Total pot $0.04 | Rake $0
Seat 1: danielito577 (button) folded before Flop (didn't bet)
Seat 2: jbarrios007 (small blind) collected ($0.04)
Seat 3: degelcamus (big blind) folded before Flop
Seat 4: bmrao folded before Flop (didn't bet)
Seat 5: LLregs folded before Flop (didn't bet)
Seat 6: emiliospoker folded before Flop (didn't bet)

PokerStars Zoom Hand #247968901714:  Hold'em No Limit ($0.01/$0.02) - 2023/12/30 22:32:09 WET [2023/12/30 17:32:09 ET]
Table 'Halley' 6-max Seat #1 is the button
Seat 1: AWiseGuyEh ($3.34 in chips)
Seat 2: KwenHaka ($1.88 in chips)
Seat 3: freefrolloff ($2.58 in chips)
Seat 4: LLregs ($13.46 in chips)
Seat 5: GarotoMaroto#1 ($1.17 in chips)
Seat 6: srna10 ($4.11 in chips)
KwenHaka: posts small blind $0.01
freefrolloff: posts big blind $0.02
*** HOLE CARDS ***
Dealt to LLregs [Th 6c]
LLregs: folds
GarotoMaroto#1: raises $0.02 to $0.04
srna10: folds
AWiseGuyEh: folds
KwenHaka: folds
freefrolloff: folds
Uncalled bet ($0.02) returned to GarotoMaroto#1
GarotoMaroto#1 collected $0.05 from pot
GarotoMaroto#1: doesn't show hand
*** SUMMARY ***
Total pot $0.05 | Rake $0
Seat 1: AWiseGuyEh (button) folded before Flop (didn't bet)
Seat 2: KwenHaka (small blind) folded before Flop
Seat 3: freefrolloff (big blind) folded before Flop
Seat 4: LLregs folded before Flop (didn't bet)
Seat 5: GarotoMaroto#1 collected ($0.05)
Seat 6: srna10 folded before Flop (didn't bet)

PokerStars Zoom Hand #247968902738:  Hold'em No Limit ($0.01/$0.02) - 2023/12/30 22:32:11 WET [2023/12/30 17:32:11 ET]
Table 'Halley' 6-max Seat #1 is the button
Seat 1: Mizhina ($2 in chips)
Seat 2: capuuh ($2.41 in chips)
Seat 3: LLregs ($13.46 in chips)
Seat 4: emopokera ($3.10 in chips)
Seat 5: Cifuli ($0.89 in chips)
Seat 6: 42Oedipius ($5.57 in chips)
capuuh: posts small blind $0.01
LLregs: posts big blind $0.02
*** HOLE CARDS ***
Dealt to LLregs [2c Qs]
emopokera: folds
Cifuli: folds
42Oedipius: folds
Mizhina: folds
capuuh: raises $0.04 to $0.06
LLregs: folds
Uncalled bet ($0.04) returned to capuuh
capuuh collected $0.04 from pot
capuuh: doesn't show hand
*** SUMMARY ***
Total pot $0.04 | Rake $0
Seat 1: Mizhina (button) folded before Flop (didn't bet)
Seat 2: capuuh (small blind) collected ($0.04)
Seat 3: LLregs (big blind) folded before Flop
Seat 4: emopokera folded before Flop (didn't bet)
Seat 5: Cifuli folded before Flop (didn't bet)
Seat 6: 42Oedipius folded before Flop (didn't bet)

PokerStars Zoom Hand #247968911089:  Hold'em No Limit ($0.01/$0.02) - 2023/12/30 22:32:34 WET [2023/12/30 17:32:34 ET]
Table 'Halley' 6-max Seat #1 is the button
Seat 1: LLregs ($13.44 in chips)
Seat 2: AugereDivus ($3.99 in chips)
Seat 3: Nikand999 ($0.76 in chips)
Seat 4: Gambleatze ($2.39 in chips)
Seat 5: DanRussel ($1.19 in chips)
Seat 6: Quirian ($2.14 in chips)
AugereDivus: posts small blind $0.01
Nikand999: posts big blind $0.02
*** HOLE CARDS ***
Dealt to LLregs [9c 6d]
Gambleatze: folds
DanRussel: raises $0.03 to $0.05
Quirian: folds
LLregs: folds
AugereDivus: folds
Nikand999: folds
Uncalled bet ($0.03) returned to DanRussel
DanRussel collected $0.05 from pot
DanRussel: doesn't show hand
*** SUMMARY ***
Total pot $0.05 | Rake $0
Seat 1: LLregs (button) folded before Flop (didn't bet)
Seat 2: AugereDivus (small blind) folded before Flop
Seat 3: Nikand999 (big blind) folded before Flop
Seat 4: Gambleatze folded before Flop (didn't bet)
Seat 5: DanRussel collected ($0.05)
Seat 6: Quirian folded before Flop (didn't bet)

PokerStars Zoom Hand #247968916769:  Hold'em No Limit ($0.01/$0.02) - 2023/12/30 22:32:49 WET [2023/12/30 17:32:49 ET]
Table 'Halley' 6-max Seat #1 is the button
Seat 1: koinodoino ($3.72 in chips)
Seat 2: LLregs ($13.44 in chips)
Seat 3: 50 vs 50 ($2 in chips)
Seat 4: jjuul ($1.06 in chips)
Seat 5: lksmonster ($2.82 in chips)
Seat 6: sTIKs21 ($2.18 in chips)
LLregs: posts small blind $0.01
50 vs 50: posts big blind $0.02
*** HOLE CARDS ***
Dealt to LLregs [3d 9h]
jjuul: folds
lksmonster: raises $0.02 to $0.04
sTIKs21: raises $0.12 to $0.16
koinodoino: folds
LLregs: folds
50 vs 50: folds
lksmonster: calls $0.12
*** FLOP *** [Qh 4d Jc]
lksmonster: checks
sTIKs21: bets $0.16
lksmonster: folds
Uncalled bet ($0.16) returned to sTIKs21
sTIKs21 collected $0.34 from pot
sTIKs21: doesn't show hand
*** SUMMARY ***
Total pot $0.35 | Rake $0.01
Board [Qh 4d Jc]
Seat 1: koinodoino (button) folded before Flop (didn't bet)
Seat 2: LLregs (small blind) folded before Flop
Seat 3: 50 vs 50 (big blind) folded before Flop
Seat 4: jjuul folded before Flop (didn't bet)
Seat 5: lksmonster folded on the Flop
Seat 6: sTIKs21 collected ($0.34)

PokerStars Zoom Hand #247968925494:  Hold'em No Limit ($0.01/$0.02) - 2023/12/30 22:33:12 WET [2023/12/30 17:33:12 ET]
Table 'Halley' 6-max Seat #1 is the button
Seat 1: LLregs ($13.43 in chips)
Seat 2: cr@sh test ($2 in chips)
Seat 3: Its all Real ($1.66 in chips)
Seat 4: Cnavy ($2.05 in chips)
Seat 5: soulachicon ($4.35 in chips)
Seat 6: Turuntor ($2.28 in chips)
cr@sh test: posts small blind $0.01
Its all Real: posts big blind $0.02
*** HOLE CARDS ***
Dealt to LLregs [5c Ac]
Cnavy: folds
soulachicon: folds
Turuntor: folds
LLregs: folds
cr@sh test: calls $0.01
Its all Real: checks
*** FLOP *** [5s 6d 7h]
cr@sh test: checks
Its all Real: checks
*** TURN *** [5s 6d 7h] [2h]
cr@sh test: checks
Its all Real: checks
*** RIVER *** [5s 6d 7h 2h] [Ts]
cr@sh test: checks
Its all Real: checks
*** SHOW DOWN ***
cr@sh test: shows [Ad 3c] (high card Ace)
Its all Real: mucks hand
cr@sh test collected $0.04 from pot
*** SUMMARY ***
Total pot $0.04 | Rake $0
Board [5s 6d 7h 2h Ts]
Seat 1: LLregs (button) folded before Flop (didn't bet)
Seat 2: cr@sh test (small blind) showed [Ad 3c] and won ($0.04) with high card Ace
Seat 3: Its all Real (big blind) mucked [Jc 3d]
Seat 4: Cnavy folded before Flop (didn't bet)
Seat 5: soulachicon folded before Flop (didn't bet)
Seat 6: Turuntor folded before Flop (didn't bet)

PokerStars Zoom Hand #247968931107:  Hold'em No Limit ($0.01/$0.02) - 2023/12/30 22:33:27 WET [2023/12/30 17:33:27 ET]
Table 'Halley' 6-max Seat #1 is the button
Seat 1: Estepario_KA ($7.25 in chips)
Seat 2: HarryHaller77 ($2.23 in chips)
Seat 3: Cashmachinex ($2 in chips)
Seat 4: rrluis1930 ($2.53 in chips)
Seat 5: ZiggyBoy90 ($2.29 in chips)
Seat 6: LLregs ($13.43 in chips)
HarryHaller77: posts small blind $0.01
Cashmachinex: posts big blind $0.02
*** HOLE CARDS ***
Dealt to LLregs [4d 6d]
rrluis1930: raises $0.03 to $0.05
ZiggyBoy90: folds
LLregs: folds
Estepario_KA: calls $0.05
HarryHaller77: folds
Cashmachinex: folds
*** FLOP *** [Ac As Js]
rrluis1930: checks
Estepario_KA: checks
*** TURN *** [Ac As Js] [2s]
rrluis1930: checks
Estepario_KA: bets $0.07
rrluis1930: raises $0.20 to $0.27
Estepario_KA: folds
Uncalled bet ($0.20) returned to rrluis1930
rrluis1930 collected $0.26 from pot
rrluis1930: doesn't show hand
*** SUMMARY ***
Total pot $0.27 | Rake $0.01
Board [Ac As Js 2s]
Seat 1: Estepario_KA (button) folded on the Turn
Seat 2: HarryHaller77 (small blind) folded before Flop
Seat 3: Cashmachinex (big blind) folded before Flop
Seat 4: rrluis1930 collected ($0.26)
Seat 5: ZiggyBoy90 folded before Flop (didn't bet)
Seat 6: LLregs folded before Flop (didn't bet)

PokerStars Zoom Hand #247968936701:  Hold'em No Limit ($0.01/$0.02) - 2023/12/30 22:33:42 WET [2023/12/30 17:33:42 ET]
Table 'Halley' 6-max Seat #1 is the button
Seat 1: jbarrios007 ($1.87 in chips)
Seat 2: Pierre300873 ($4.20 in chips)
Seat 3: Livio100 ($0.98 in chips)
Seat 4: abeech94 ($2.80 in chips)
Seat 5: LLregs ($13.43 in chips)
Seat 6: alaercio ($1.89 in chips)
Pierre300873: posts small blind $0.01
Livio100: posts big blind $0.02
*** HOLE CARDS ***
Dealt to LLregs [Ah Td]
abeech94: folds
LLregs: raises $0.04 to $0.06
alaercio: folds
jbarrios007: folds
Pierre300873: folds
Livio100: calls $0.04
*** FLOP *** [8s Js 4s]
Livio100: checks
LLregs: checks
*** TURN *** [8s Js 4s] [9d]
Livio100: bets $0.07
LLregs: calls $0.07
*** RIVER *** [8s Js 4s 9d] [Kd]
Livio100: checks
LLregs: checks
*** SHOW DOWN ***
Livio100: shows [Ad Qs] (high card Ace)
LLregs: mucks hand
Livio100 collected $0.26 from pot
*** SUMMARY ***
Total pot $0.27 | Rake $0.01
Board [8s Js 4s 9d Kd]
Seat 1: jbarrios007 (button) folded before Flop (didn't bet)
Seat 2: Pierre300873 (small blind) folded before Flop
Seat 3: Livio100 (big blind) showed [Ad Qs] and won ($0.26) with high card Ace
Seat 4: abeech94 folded before Flop (didn't bet)
Seat 5: LLregs mucked [Ah Td]
Seat 6: alaercio folded before Flop (didn't bet)

PokerStars Zoom Hand #247968952900:  Hold'em No Limit ($0.01/$0.02) - 2023/12/30 22:34:25 WET [2023/12/30 17:34:25 ET]
Table 'Halley' 6-max Seat #1 is the button
Seat 1: danik87654321 ($2.14 in chips)
Seat 2: Raymond322 ($4.57 in chips)
Seat 3: PaulNichol ($1.62 in chips)
Seat 4: Mizhina ($2.01 in chips)
Seat 5: capuuh ($2.13 in chips)
Seat 6: LLregs ($13.30 in chips)
Raymond322: posts small blind $0.01
PaulNichol: posts big blind $0.02
*** HOLE CARDS ***
Dealt to LLregs [4s 9s]
Mizhina: folds
capuuh: folds
LLregs: folds
danik87654321: raises $0.04 to $0.06
Raymond322: folds
PaulNichol: folds
Uncalled bet ($0.04) returned to danik87654321
danik87654321 collected $0.05 from pot
danik87654321: doesn't show hand
*** SUMMARY ***
Total pot $0.05 | Rake $0
Seat 1: danik87654321 (button) collected ($0.05)
Seat 2: Raymond322 (small blind) folded before Flop
Seat 3: PaulNichol (big blind) folded before Flop
Seat 4: Mizhina folded before Flop (didn't bet)
Seat 5: capuuh folded before Flop (didn't bet)
Seat 6: LLregs folded before Flop (didn't bet)

PokerStars Zoom Hand #247968951549:  Hold'em No Limit ($0.01/$0.02) - 2023/12/30 22:34:22 WET [2023/12/30 17:34:22 ET]
Table 'Halley' 6-max Seat #1 is the button
Seat 1: abeech94 ($3.41 in chips)
Seat 2: CoverXx ($2.07 in chips)
Seat 3: carbonero59 ($2 in chips)
Seat 4: PenTAce ($2.78 in chips)
Seat 5: LLregs ($13.30 in chips)
Seat 6: Tha_Saint7 ($6.59 in chips)
CoverXx: posts small blind $0.01
carbonero59: posts big blind $0.02
*** HOLE CARDS ***
Dealt to LLregs [6h 4c]
PenTAce: folds
LLregs: folds
Tha_Saint7: folds
abeech94: raises $0.04 to $0.06
CoverXx: folds
carbonero59: folds
Uncalled bet ($0.04) returned to abeech94
abeech94 collected $0.05 from pot
abeech94: doesn't show hand
*** SUMMARY ***
Total pot $0.05 | Rake $0
Seat 1: abeech94 (button) collected ($0.05)
Seat 2: CoverXx (small blind) folded before Flop
Seat 3: carbonero59 (big blind) folded before Flop
Seat 4: PenTAce folded before Flop (didn't bet)
Seat 5: LLregs folded before Flop (didn't bet)
Seat 6: Tha_Saint7 folded before Flop (didn't bet)

PokerStars Zoom Hand #247968954134:  Hold'em No Limit ($0.01/$0.02) - 2023/12/30 22:34:29 WET [2023/12/30 17:34:29 ET]
Table 'Halley' 6-max Seat #1 is the button
Seat 1: founder9 ($2.48 in chips)
Seat 2: DanRussel ($2.33 in chips)
Seat 3: LLregs ($13.30 in chips)
Seat 4: JuanChu070 ($3.32 in chips)
Seat 5: Nikand999 ($1.27 in chips)
Seat 6: Harold_Seven ($1.09 in chips)
DanRussel: posts small blind $0.01
LLregs: posts big blind $0.02
*** HOLE CARDS ***
Dealt to LLregs [7h Tc]
JuanChu070: folds
Nikand999: folds
Harold_Seven: raises $0.03 to $0.05
founder9: calls $0.05
DanRussel: folds
LLregs: folds
*** FLOP *** [Js 8c 5s]
Harold_Seven: checks
founder9: bets $0.07
Harold_Seven: folds
Uncalled bet ($0.07) returned to founder9
founder9 collected $0.13 from pot
founder9: doesn't show hand
*** SUMMARY ***
Total pot $0.13 | Rake $0
Board [Js 8c 5s]
Seat 1: founder9 (button) collected ($0.13)
Seat 2: DanRussel (small blind) folded before Flop
Seat 3: LLregs (big blind) folded before Flop
Seat 4: JuanChu070 folded before Flop (didn't bet)
Seat 5: Nikand999 folded before Flop (didn't bet)
Seat 6: Harold_Seven folded on the Flop

PokerStars Zoom Hand #247968969338:  Hold'em No Limit ($0.01/$0.02) - 2023/12/30 22:35:10 WET [2023/12/30 17:35:10 ET]
Table 'Halley' 6-max Seat #1 is the button
Seat 1: Cnavy ($2.27 in chips)
Seat 2: ZorroZoltan ($3.18 in chips)
Seat 3: M1k3B4gUnc1nh4 ($1.97 in chips)
Seat 4: LLregs ($13.27 in chips)
Seat 5: DanRussel ($2.30 in chips)
Seat 6: frankquanki ($3.76 in chips)
ZorroZoltan: posts small blind $0.01
M1k3B4gUnc1nh4: posts big blind $0.02
*** HOLE CARDS ***
Dealt to LLregs [9d 9c]
LLregs: raises $0.04 to $0.06
DanRussel: folds
frankquanki: folds
Cnavy: folds
ZorroZoltan: folds
M1k3B4gUnc1nh4: folds
Uncalled bet ($0.04) returned to LLregs
LLregs collected $0.05 from pot
LLregs: doesn't show hand
*** SUMMARY ***
Total pot $0.05 | Rake $0
Seat 1: Cnavy (button) folded before Flop (didn't bet)
Seat 2: ZorroZoltan (small blind) folded before Flop
Seat 3: M1k3B4gUnc1nh4 (big blind) folded before Flop
Seat 4: LLregs collected ($0.05)
Seat 5: DanRussel folded before Flop (didn't bet)
Seat 6: frankquanki folded before Flop (didn't bet)

PokerStars Zoom Hand #247968981572:  Hold'em No Limit ($0.01/$0.02) - 2023/12/30 22:35:42 WET [2023/12/30 17:35:42 ET]
Table 'Halley' 6-max Seat #1 is the button
Seat 1: meysar ($2.08 in chips)
Seat 2: PenTAce ($2.04 in chips)
Seat 3: marioleaoo ($2.73 in chips)
Seat 4: LLregs ($13.30 in chips)
Seat 5: VIDOPRO23 ($2.11 in chips)
Seat 6: Weily8 ($3.78 in chips)
PenTAce: posts small blind $0.01
marioleaoo: posts big blind $0.02
*** HOLE CARDS ***
Dealt to LLregs [5c Kd]
LLregs has timed out
LLregs: folds
VIDOPRO23: folds
Weily8: folds
meysar: folds
PenTAce: folds
Uncalled bet ($0.01) returned to marioleaoo
marioleaoo collected $0.02 from pot
marioleaoo: doesn't show hand
*** SUMMARY ***
Total pot $0.02 | Rake $0
Seat 1: meysar (button) folded before Flop (didn't bet)
Seat 2: PenTAce (small blind) folded before Flop
Seat 3: marioleaoo (big blind) collected ($0.02)
Seat 4: LLregs folded before Flop (didn't bet)
Seat 5: VIDOPRO23 folded before Flop (didn't bet)
Seat 6: Weily8 folded before Flop (didn't bet)

PokerStars Zoom Hand #247968960448:  Hold'em No Limit ($0.01/$0.02) - 2023/12/30 22:34:46 WET [2023/12/30 17:34:46 ET]
Table 'Halley' 6-max Seat #1 is the button
Seat 1: ChessMaster2002 ($4.66 in chips)
Seat 2: LLregs ($13.28 in chips)
Seat 3: danival2 ($2.88 in chips)
Seat 4: Harold_Seven ($1.59 in chips)
Seat 5: Gambleatze ($1.97 in chips)
Seat 6: CoverXx ($2.06 in chips)
LLregs: posts small blind $0.01
danival2: posts big blind $0.02
*** HOLE CARDS ***
Dealt to LLregs [Jd 7c]
Harold_Seven: calls $0.02
Gambleatze: calls $0.02
CoverXx: folds
ChessMaster2002: folds
LLregs: folds
danival2: checks
*** FLOP *** [3h 6d 5h]
danival2: checks
Harold_Seven: checks
Gambleatze: checks
*** TURN *** [3h 6d 5h] [Kh]
danival2: checks
Harold_Seven: bets $0.06
Gambleatze: folds
danival2: folds
Uncalled bet ($0.06) returned to Harold_Seven
Harold_Seven collected $0.07 from pot
Harold_Seven: doesn't show hand
*** SUMMARY ***
Total pot $0.07 | Rake $0
Board [3h 6d 5h Kh]
Seat 1: ChessMaster2002 (button) folded before Flop (didn't bet)
Seat 2: LLregs (small blind) folded before Flop
Seat 3: danival2 (big blind) folded on the Turn
Seat 4: Harold_Seven collected ($0.07)
Seat 5: Gambleatze folded on the Turn
Seat 6: CoverXx folded before Flop (didn't bet)

PokerStars Zoom Hand #247968975235:  Hold'em No Limit ($0.01/$0.02) - 2023/12/30 22:35:26 WET [2023/12/30 17:35:26 ET]
Table 'Halley' 6-max Seat #1 is the button
Seat 1: LLregs ($13.30 in chips)
Seat 2: 3ldickson ($0.32 in chips)
Seat 3: WEBOO1 ($2.83 in chips)
Seat 4: Mary_D_1973 ($1.90 in chips)
Seat 5: dealmekkplease ($2.29 in chips)
Seat 6: PabloBeans ($1.17 in chips)
3ldickson: posts small blind $0.01
WEBOO1: posts big blind $0.02
*** HOLE CARDS ***
Dealt to LLregs [As 5c]
Mary_D_1973: folds
dealmekkplease: folds
PabloBeans: folds
LLregs: folds
3ldickson: calls $0.01
WEBOO1: raises $0.05 to $0.07
3ldickson: calls $0.05
*** FLOP *** [7h 6s 7c]
3ldickson: checks
WEBOO1: bets $0.07
3ldickson: folds
Uncalled bet ($0.07) returned to WEBOO1
WEBOO1 collected $0.14 from pot
WEBOO1: doesn't show hand
*** SUMMARY ***
Total pot $0.14 | Rake $0
Board [7h 6s 7c]
Seat 1: LLregs (button) folded before Flop (didn't bet)
Seat 2: 3ldickson (small blind) folded on the Flop
Seat 3: WEBOO1 (big blind) collected ($0.14)
Seat 4: Mary_D_1973 folded before Flop (didn't bet)
Seat 5: dealmekkplease folded before Flop (didn't bet)
Seat 6: PabloBeans folded before Flop (didn't bet)

PokerStars Zoom Hand #247968996122:  Hold'em No Limit ($0.01/$0.02) - 2023/12/30 22:36:21 WET [2023/12/30 17:36:21 ET]
Table 'Halley' 6-max Seat #1 is the button
Seat 1: my sapphire ($3.57 in chips)
Seat 2: 888lifeIS ($2.37 in chips)
Seat 3: LLregs ($13.30 in chips)
Seat 4: Cpt_Price_67 ($1.79 in chips)
Seat 5: placebo1970 ($0.45 in chips)
Seat 6: danik87654321 ($1.84 in chips)
888lifeIS: posts small blind $0.01
LLregs: posts big blind $0.02
*** HOLE CARDS ***
Dealt to LLregs [Jd Qh]
Cpt_Price_67: folds
placebo1970: folds
danik87654321: raises $0.06 to $0.08
my sapphire: folds
888lifeIS: folds
LLregs: calls $0.06
*** FLOP *** [Ts Ad Kd]
LLregs: checks
danik87654321: bets $0.14
LLregs: calls $0.14
*** TURN *** [Ts Ad Kd] [Jh]
LLregs: checks
danik87654321: checks
*** RIVER *** [Ts Ad Kd Jh] [4s]
LLregs: bets $0.33
danik87654321: folds
Uncalled bet ($0.33) returned to LLregs
LLregs collected $0.43 from pot
LLregs: doesn't show hand
*** SUMMARY ***
Total pot $0.45 | Rake $0.02
Board [Ts Ad Kd Jh 4s]
Seat 1: my sapphire (button) folded before Flop (didn't bet)
Seat 2: 888lifeIS (small blind) folded before Flop
Seat 3: LLregs (big blind) collected ($0.43)
Seat 4: Cpt_Price_67 folded before Flop (didn't bet)
Seat 5: placebo1970 folded before Flop (didn't bet)
Seat 6: danik87654321 folded on the River

PokerStars Zoom Hand #247969010849:  Hold'em No Limit ($0.01/$0.02) - 2023/12/30 22:37:01 WET [2023/12/30 17:37:01 ET]
Table 'Halley' 6-max Seat #1 is the button
Seat 1: Mwilson766 ($2.09 in chips)
Seat 2: NeckCarp ($0.53 in chips)
Seat 3: CoverXx ($2.07 in chips)
Seat 4: yanico_0308 ($0.56 in chips)
Seat 5: Quantum771 ($2 in chips)
Seat 6: LLregs ($13.51 in chips)
NeckCarp: posts small blind $0.01
CoverXx: posts big blind $0.02
*** HOLE CARDS ***
Dealt to LLregs [Kc 2c]
yanico_0308: folds
Quantum771: folds
LLregs: folds
Mwilson766: folds
NeckCarp: folds
Uncalled bet ($0.01) returned to CoverXx
CoverXx collected $0.02 from pot
CoverXx: doesn't show hand
*** SUMMARY ***
Total pot $0.02 | Rake $0
Seat 1: Mwilson766 (button) folded before Flop (didn't bet)
Seat 2: NeckCarp (small blind) folded before Flop
Seat 3: CoverXx (big blind) collected ($0.02)
Seat 4: yanico_0308 folded before Flop (didn't bet)
Seat 5: Quantum771 folded before Flop (didn't bet)
Seat 6: LLregs folded before Flop (didn't bet)

PokerStars Zoom Hand #247969012860:  Hold'em No Limit ($0.01/$0.02) - 2023/12/30 22:37:06 WET [2023/12/30 17:37:06 ET]
Table 'Halley' 6-max Seat #1 is the button
Seat 1: LLregs ($13.51 in chips)
Seat 2: RockStarUK ($4.32 in chips)
Seat 3: Quantum771 ($2 in chips)
Seat 4: Mwilson766 ($2.09 in chips)
Seat 5: 3ener ($3 in chips)
Seat 6: MichalG1 ($1.64 in chips)
RockStarUK: posts small blind $0.01
Quantum771: posts big blind $0.02
*** HOLE CARDS ***
Dealt to LLregs [Qd As]
Mwilson766: folds
3ener: folds
MichalG1: folds
LLregs: raises $0.04 to $0.06
RockStarUK: raises $0.10 to $0.16
Quantum771: folds
LLregs: calls $0.10
*** FLOP *** [7d 9s 2s]
RockStarUK: checks
LLregs: bets $0.16
RockStarUK: folds
Uncalled bet ($0.16) returned to LLregs
LLregs collected $0.33 from pot
LLregs: doesn't show hand
*** SUMMARY ***
Total pot $0.34 | Rake $0.01
Board [7d 9s 2s]
Seat 1: LLregs (button) collected ($0.33)
Seat 2: RockStarUK (small blind) folded on the Flop
Seat 3: Quantum771 (big blind) folded before Flop
Seat 4: Mwilson766 folded before Flop (didn't bet)
Seat 5: 3ener folded before Flop (didn't bet)
Seat 6: MichalG1 folded before Flop (didn't bet)

PokerStars Zoom Hand #247969050800:  Hold'em No Limit ($0.01/$0.02) - 2023/12/30 22:38:48 WET [2023/12/30 17:38:48 ET]
Table 'Halley' 6-max Seat #1 is the button
Seat 1: Giocrik ($1.83 in chips)
Seat 2: LLregs ($13.68 in chips)
Seat 3: Sw4nsan ($2.23 in chips)
Seat 4: emiliospoker ($2.41 in chips)
Seat 5: AWiseGuyEh ($2.75 in chips)
Seat 6: TamiSieche ($2.52 in chips)
LLregs: posts small blind $0.01
Sw4nsan: posts big blind $0.02
*** HOLE CARDS ***
Dealt to LLregs [Tc Kh]
emiliospoker: folds
AWiseGuyEh: folds
TamiSieche: folds
Giocrik: folds
LLregs: raises $0.04 to $0.06
Sw4nsan: calls $0.04
*** FLOP *** [6d Ts 4s]
LLregs: bets $0.06
Sw4nsan: calls $0.06
*** TURN *** [6d Ts 4s] [7s]
LLregs: checks
Sw4nsan: checks
*** RIVER *** [6d Ts 4s 7s] [2s]
LLregs: bets $0.05
Sw4nsan: folds
Uncalled bet ($0.05) returned to LLregs
LLregs collected $0.23 from pot
LLregs: doesn't show hand
*** SUMMARY ***
Total pot $0.24 | Rake $0.01
Board [6d Ts 4s 7s 2s]
Seat 1: Giocrik (button) folded before Flop (didn't bet)
Seat 2: LLregs (small blind) collected ($0.23)
Seat 3: Sw4nsan (big blind) folded on the River
Seat 4: emiliospoker folded before Flop (didn't bet)
Seat 5: AWiseGuyEh folded before Flop (didn't bet)
Seat 6: TamiSieche folded before Flop (didn't bet)

PokerStars Zoom Hand #247969069359:  Hold'em No Limit ($0.01/$0.02) - 2023/12/30 22:39:38 WET [2023/12/30 17:39:38 ET]
Table 'Halley' 6-max Seat #1 is the button
Seat 1: HooliganBasher ($2.02 in chips)
Seat 2: clever606 ($2.19 in chips)
Seat 3: Loucomeloo ($2 in chips)
Seat 4: meysar ($2 in chips)
Seat 5: LLregs ($13.79 in chips)
Seat 6: Alves6776 ($0.63 in chips)
clever606: posts small blind $0.01
Loucomeloo: posts big blind $0.02
*** HOLE CARDS ***
Dealt to LLregs [9s Qs]
meysar: folds
LLregs: folds
Alves6776: calls $0.02
HooliganBasher: folds
clever606: folds
Loucomeloo: checks
*** FLOP *** [8d Qd As]
Loucomeloo: checks
Alves6776: checks
*** TURN *** [8d Qd As] [6h]
Loucomeloo: checks
Alves6776: bets $0.02
Loucomeloo: calls $0.02
*** RIVER *** [8d Qd As 6h] [6c]
Loucomeloo: checks
Alves6776: bets $0.04
Loucomeloo: calls $0.04
*** SHOW DOWN ***
Alves6776: shows [3d Jd] (a pair of Sixes)
Loucomeloo: shows [3s Qc] (two pair, Queens and Sixes)
Loucomeloo collected $0.16 from pot
*** SUMMARY ***
Total pot $0.17 | Rake $0.01
Board [8d Qd As 6h 6c]
Seat 1: HooliganBasher (button) folded before Flop (didn't bet)
Seat 2: clever606 (small blind) folded before Flop
Seat 3: Loucomeloo (big blind) showed [3s Qc] and won ($0.16) with two pair, Queens and Sixes
Seat 4: meysar folded before Flop (didn't bet)
Seat 5: LLregs folded before Flop (didn't bet)
Seat 6: Alves6776 showed [3d Jd] and lost with a pair of Sixes

PokerStars Zoom Hand #247969072501:  Hold'em No Limit ($0.01/$0.02) - 2023/12/30 22:39:46 WET [2023/12/30 17:39:46 ET]
Table 'Halley' 6-max Seat #1 is the button
Seat 1: Mizhina ($2.50 in chips)
Seat 2: jakeboots ($2.50 in chips)
Seat 3: batya1212 ($2.09 in chips)
Seat 4: CrazyMozggg ($0.94 in chips)
Seat 5: LLregs ($13.79 in chips)
Seat 6: Giocrik ($2.77 in chips)
jakeboots: posts small blind $0.01
batya1212: posts big blind $0.02
*** HOLE CARDS ***
Dealt to LLregs [Ks 4h]
CrazyMozggg: raises $0.04 to $0.06
LLregs: folds
Giocrik: folds
Mizhina: folds
jakeboots: folds
batya1212: calls $0.04
*** FLOP *** [Qh 5c 4d]
batya1212: checks
CrazyMozggg: checks
*** TURN *** [Qh 5c 4d] [Ac]
batya1212: checks
CrazyMozggg: bets $0.13
batya1212: folds
Uncalled bet ($0.13) returned to CrazyMozggg
CrazyMozggg collected $0.13 from pot
CrazyMozggg: doesn't show hand
*** SUMMARY ***
Total pot $0.13 | Rake $0
Board [Qh 5c 4d Ac]
Seat 1: Mizhina (button) folded before Flop (didn't bet)
Seat 2: jakeboots (small blind) folded before Flop
Seat 3: batya1212 (big blind) folded on the Turn
Seat 4: CrazyMozggg collected ($0.13)
Seat 5: LLregs folded before Flop (didn't bet)
Seat 6: Giocrik folded before Flop (didn't bet)

PokerStars Zoom Hand #247969073787:  Hold'em No Limit ($0.01/$0.02) - 2023/12/30 22:39:50 WET [2023/12/30 17:39:50 ET]
Table 'Halley' 6-max Seat #1 is the button
Seat 1: cagigas ($2.59 in chips)
Seat 2: mag111115 ($1.29 in chips)
Seat 3: Odysseia ($1.94 in chips)
Seat 4: LLregs ($13.79 in chips)
Seat 5: allergy2nuts ($3.60 in chips)
Seat 6: Mary_D_1973 ($3.83 in chips)
mag111115: posts small blind $0.01
Odysseia: posts big blind $0.02
*** HOLE CARDS ***
Dealt to LLregs [3d Js]
LLregs: folds
allergy2nuts: raises $0.04 to $0.06
Mary_D_1973: calls $0.06
cagigas: folds
mag111115: folds
Odysseia: folds
*** FLOP *** [6d Jd 2s]
allergy2nuts: bets $0.06
Mary_D_1973: calls $0.06
*** TURN *** [6d Jd 2s] [7s]
allergy2nuts: bets $0.20
Mary_D_1973: folds
Uncalled bet ($0.20) returned to allergy2nuts
allergy2nuts collected $0.26 from pot
allergy2nuts: doesn't show hand
*** SUMMARY ***
Total pot $0.27 | Rake $0.01
Board [6d Jd 2s 7s]
Seat 1: cagigas (button) folded before Flop (didn't bet)
Seat 2: mag111115 (small blind) folded before Flop
Seat 3: Odysseia (big blind) folded before Flop
Seat 4: LLregs folded before Flop (didn't bet)
Seat 5: allergy2nuts collected ($0.26)
Seat 6: Mary_D_1973 folded on the Turn

PokerStars Zoom Hand #247969074998:  Hold'em No Limit ($0.01/$0.02) - 2023/12/30 22:39:53 WET [2023/12/30 17:39:53 ET]
Table 'Halley' 6-max Seat #1 is the button
Seat 1: ONIPIKA ($2.11 in chips)
Seat 2: PabloBeans ($1.91 in chips)
Seat 3: LLregs ($13.79 in chips)
Seat 4: renech2 ($1.06 in chips)
Seat 5: jakeboots ($2 in chips)
Seat 6: Pierre300873 ($5.08 in chips)
PabloBeans: posts small blind $0.01
LLregs: posts big blind $0.02
*** HOLE CARDS ***
Dealt to LLregs [Td Qs]
renech2: folds
jakeboots: raises $0.02 to $0.04
Pierre300873: folds
ONIPIKA: folds
PabloBeans: calls $0.03
LLregs: calls $0.02
*** FLOP *** [Qd 2s Ks]
PabloBeans: checks
LLregs: bets $0.04
jakeboots: calls $0.04
PabloBeans: calls $0.04
*** TURN *** [Qd 2s Ks] [7d]
PabloBeans: bets $0.10
LLregs: calls $0.10
jakeboots: calls $0.10
*** RIVER *** [Qd 2s Ks 7d] [Jd]
PabloBeans: checks
LLregs: bets $0.40
jakeboots: folds
PabloBeans: calls $0.40
*** SHOW DOWN ***
LLregs: shows [Td Qs] (a pair of Queens)
PabloBeans: shows [Th Kd] (a pair of Kings)
PabloBeans collected $1.29 from pot
*** SUMMARY ***
Total pot $1.34 | Rake $0.05
Board [Qd 2s Ks 7d Jd]
Seat 1: ONIPIKA (button) folded before Flop (didn't bet)
Seat 2: PabloBeans (small blind) showed [Th Kd] and won ($1.29) with a pair of Kings
Seat 3: LLregs (big blind) showed [Td Qs] and lost with a pair of Queens
Seat 4: renech2 folded before Flop (didn't bet)
Seat 5: jakeboots folded on the River
Seat 6: Pierre300873 folded before Flop (didn't bet)

PokerStars Zoom Hand #247969104297:  Hold'em No Limit ($0.01/$0.02) - 2023/12/30 22:41:11 WET [2023/12/30 17:41:11 ET]
Table 'Halley' 6-max Seat #1 is the button
Seat 1: jbarrios007 ($2.32 in chips)
Seat 2: LeandreCHR ($4.80 in chips)
Seat 3: dogor73 ($1.72 in chips)
Seat 4: ImpEdGard ($4.23 in chips)
Seat 5: mcqueen3370 ($2 in chips)
Seat 6: LLregs ($13.21 in chips)
LeandreCHR: posts small blind $0.01
dogor73: posts big blind $0.02
*** HOLE CARDS ***
Dealt to LLregs [Ts 5s]
ImpEdGard: folds
mcqueen3370: folds
LLregs: folds
jbarrios007: folds
LeandreCHR: raises $0.04 to $0.06
dogor73: folds
Uncalled bet ($0.04) returned to LeandreCHR
LeandreCHR collected $0.04 from pot
LeandreCHR: doesn't show hand
*** SUMMARY ***
Total pot $0.04 | Rake $0
Seat 1: jbarrios007 (button) folded before Flop (didn't bet)
Seat 2: LeandreCHR (small blind) collected ($0.04)
Seat 3: dogor73 (big blind) folded before Flop
Seat 4: ImpEdGard folded before Flop (didn't bet)
Seat 5: mcqueen3370 folded before Flop (didn't bet)
Seat 6: LLregs folded before Flop (didn't bet)

PokerStars Zoom Hand #247969106533:  Hold'em No Limit ($0.01/$0.02) - 2023/12/30 22:41:17 WET [2023/12/30 17:41:17 ET]
Table 'Halley' 6-max Seat #1 is the button
Seat 1: MATIASdaKING32 ($1.64 in chips)
Seat 2: LLregs ($13.21 in chips)
Seat 3: IngeniEbr10 ($2.47 in chips)
Seat 4: RafkeProost ($2.57 in chips)
Seat 5: Alexm8205 ($2.41 in chips)
Seat 6: jamielee348 ($1.48 in chips)
LLregs: posts small blind $0.01
IngeniEbr10: posts big blind $0.02
*** HOLE CARDS ***
Dealt to LLregs [6d 4s]
RafkeProost: folds
Alexm8205 has timed out
Alexm8205: folds
jamielee348: calls $0.02
MATIASdaKING32: folds
LLregs: folds
IngeniEbr10: checks
*** FLOP *** [2c 3c Ts]
IngeniEbr10: checks
jamielee348: bets $0.06
IngeniEbr10: folds
Uncalled bet ($0.06) returned to jamielee348
jamielee348 collected $0.05 from pot
jamielee348: doesn't show hand
*** SUMMARY ***
Total pot $0.05 | Rake $0
Board [2c 3c Ts]
Seat 1: MATIASdaKING32 (button) folded before Flop (didn't bet)
Seat 2: LLregs (small blind) folded before Flop
Seat 3: IngeniEbr10 (big blind) folded on the Flop
Seat 4: RafkeProost folded before Flop (didn't bet)
Seat 5: Alexm8205 folded before Flop (didn't bet)
Seat 6: jamielee348 collected ($0.05)

PokerStars Zoom Hand #247969107636:  Hold'em No Limit ($0.01/$0.02) - 2023/12/30 22:41:20 WET [2023/12/30 17:41:20 ET]
Table 'Halley' 6-max Seat #1 is the button
Seat 1: PabloBeans ($2.62 in chips)
Seat 2: batya1212 ($2 in chips)
Seat 3: Mizhina ($2.46 in chips)
Seat 4: LLregs ($13.20 in chips)
Seat 5: jakeboots ($2.78 in chips)
Seat 6: MagikarpStar ($2.30 in chips)
batya1212: posts small blind $0.01
Mizhina: posts big blind $0.02
*** HOLE CARDS ***
Dealt to LLregs [6h 6c]
LLregs: raises $0.04 to $0.06
jakeboots: folds
MagikarpStar: folds
PabloBeans: folds
batya1212: calls $0.05
Mizhina: folds
*** FLOP *** [3d Ks 3h]
batya1212: checks
LLregs: checks
*** TURN *** [3d Ks 3h] [6d]
batya1212: bets $0.05
LLregs: calls $0.05
*** RIVER *** [3d Ks 3h 6d] [7d]
batya1212: checks
LLregs: bets $0.26
batya1212: calls $0.26
*** SHOW DOWN ***
LLregs: shows [6h 6c] (a full house, Sixes full of Threes)
batya1212: mucks hand
LLregs collected $0.73 from pot
*** SUMMARY ***
Total pot $0.76 | Rake $0.03
Board [3d Ks 3h 6d 7d]
Seat 1: PabloBeans (button) folded before Flop (didn't bet)
Seat 2: batya1212 (small blind) mucked [9d Qd]
Seat 3: Mizhina (big blind) folded before Flop
Seat 4: LLregs showed [6h 6c] and won ($0.73) with a full house, Sixes full of Threes
Seat 5: jakeboots folded before Flop (didn't bet)
Seat 6: MagikarpStar folded before Flop (didn't bet)

PokerStars Zoom Hand #247969131935:  Hold'em No Limit ($0.01/$0.02) - 2023/12/30 22:42:24 WET [2023/12/30 17:42:24 ET]
Table 'Halley' 6-max Seat #1 is the button
Seat 1: 42Oedipius ($2.01 in chips)
Seat 2: 888lifeIS ($2.21 in chips)
Seat 3: LLregs ($13.56 in chips)
Seat 4: Skyter007 ($0.45 in chips)
Seat 5: cr@sh test ($2 in chips)
Seat 6: Tha_Saint7 ($5.54 in chips)
888lifeIS: posts small blind $0.01
LLregs: posts big blind $0.02
*** HOLE CARDS ***
Dealt to LLregs [5c 5h]
Skyter007: folds
cr@sh test: folds
Tha_Saint7: folds
42Oedipius has timed out
42Oedipius: folds
888lifeIS: folds
Uncalled bet ($0.01) returned to LLregs
LLregs collected $0.02 from pot
LLregs: doesn't show hand
*** SUMMARY ***
Total pot $0.02 | Rake $0
Seat 1: 42Oedipius (button) folded before Flop (didn't bet)
Seat 2: 888lifeIS (small blind) folded before Flop
Seat 3: LLregs (big blind) collected ($0.02)
Seat 4: Skyter007 folded before Flop (didn't bet)
Seat 5: cr@sh test folded before Flop (didn't bet)
Seat 6: Tha_Saint7 folded before Flop (didn't bet)

PokerStars Zoom Hand #247969130305:  Hold'em No Limit ($0.01/$0.02) - 2023/12/30 22:42:20 WET [2023/12/30 17:42:20 ET]
Table 'Halley' 6-max Seat #1 is the button
Seat 1: ChessMaster2002 ($5.07 in chips)
Seat 2: Loucomeloo ($2.27 in chips)
Seat 3: @lana@131982 ($1.66 in chips)
Seat 4: Rob Sharona ($2.64 in chips)
Seat 5: LLregs ($13.56 in chips)
Seat 6: 3ldickson ($0.66 in chips)
Loucomeloo: posts small blind $0.01
@lana@131982: posts big blind $0.02
*** HOLE CARDS ***
Dealt to LLregs [8d 5d]
Rob Sharona: raises $0.02 to $0.04
LLregs: folds
3ldickson: folds
ChessMaster2002: folds
Loucomeloo: folds
@lana@131982: calls $0.02
*** FLOP *** [Kc 3d 6d]
@lana@131982: bets $0.02
Rob Sharona: calls $0.02
*** TURN *** [Kc 3d 6d] [4h]
@lana@131982: bets $0.02
Rob Sharona: raises $0.06 to $0.08
@lana@131982: calls $0.06
*** RIVER *** [Kc 3d 6d 4h] [Td]
@lana@131982: checks
Rob Sharona: bets $0.09
@lana@131982: calls $0.09
*** SHOW DOWN ***
Rob Sharona: shows [7h 5h] (a straight, Three to Seven)
@lana@131982: mucks hand
Rob Sharona collected $0.45 from pot
*** SUMMARY ***
Total pot $0.47 | Rake $0.02
Board [Kc 3d 6d 4h Td]
Seat 1: ChessMaster2002 (button) folded before Flop (didn't bet)
Seat 2: Loucomeloo (small blind) folded before Flop
Seat 3: @lana@131982 (big blind) mucked [Qc Kd]
Seat 4: Rob Sharona showed [7h 5h] and won ($0.45) with a straight, Three to Seven
Seat 5: LLregs folded before Flop (didn't bet)
Seat 6: 3ldickson folded before Flop (didn't bet)

PokerStars Zoom Hand #247969139686:  Hold'em No Limit ($0.01/$0.02) - 2023/12/30 22:42:45 WET [2023/12/30 17:42:45 ET]
Table 'Halley' 6-max Seat #1 is the button
Seat 1: LLregs ($13.57 in chips)
Seat 2: AWiseGuyEh ($2.85 in chips)
Seat 3: Giocrik ($3.25 in chips)
Seat 4: cane_corzo86 ($2.66 in chips)
Seat 5: GamblersDream ($1.16 in chips)
Seat 6: NineHi72 ($14.41 in chips)
AWiseGuyEh: posts small blind $0.01
Giocrik: posts big blind $0.02
*** HOLE CARDS ***
Dealt to LLregs [Th Qs]
cane_corzo86: folds
GamblersDream: folds
NineHi72: folds
LLregs has timed out
LLregs: folds
AWiseGuyEh: folds
Uncalled bet ($0.01) returned to Giocrik
Giocrik collected $0.02 from pot
Giocrik: doesn't show hand
*** SUMMARY ***
Total pot $0.02 | Rake $0
Seat 1: LLregs (button) folded before Flop (didn't bet)
Seat 2: AWiseGuyEh (small blind) folded before Flop
Seat 3: Giocrik (big blind) collected ($0.02)
Seat 4: cane_corzo86 folded before Flop (didn't bet)
Seat 5: GamblersDream folded before Flop (didn't bet)
Seat 6: NineHi72 folded before Flop (didn't bet)

PokerStars Zoom Hand #247969213355:  Hold'em No Limit ($0.01/$0.02) - 2023/12/30 22:46:04 WET [2023/12/30 17:46:04 ET]
Table 'Halley' 6-max Seat #1 is the button
Seat 1: my sapphire ($2.18 in chips)
Seat 2: pablosalermo ($1.12 in chips)
Seat 3: cr@sh test ($4.15 in chips)
Seat 4: 888lifeIS ($2.02 in chips)
Seat 5: Leka69420 ($1.84 in chips)
Seat 6: LLregs ($13.57 in chips)
pablosalermo: posts small blind $0.01
cr@sh test: posts big blind $0.02
*** HOLE CARDS ***
Dealt to LLregs [9h 8h]
888lifeIS: folds
Leka69420: folds
LLregs: raises $0.04 to $0.06
my sapphire: folds
pablosalermo: calls $0.05
cr@sh test: folds
*** FLOP *** [6s 9s 6d]
pablosalermo: checks
LLregs: checks
*** TURN *** [6s 9s 6d] [7c]
pablosalermo: checks
LLregs: bets $0.04
pablosalermo: folds
Uncalled bet ($0.04) returned to LLregs
LLregs collected $0.14 from pot
LLregs: doesn't show hand
*** SUMMARY ***
Total pot $0.14 | Rake $0
Board [6s 9s 6d 7c]
Seat 1: my sapphire (button) folded before Flop (didn't bet)
Seat 2: pablosalermo (small blind) folded on the Turn
Seat 3: cr@sh test (big blind) folded before Flop
Seat 4: 888lifeIS folded before Flop (didn't bet)
Seat 5: Leka69420 folded before Flop (didn't bet)
Seat 6: LLregs collected ($0.14)

PokerStars Zoom Hand #247969223163:  Hold'em No Limit ($0.01/$0.02) - 2023/12/30 22:46:30 WET [2023/12/30 17:46:30 ET]
Table 'Halley' 6-max Seat #1 is the button
Seat 1: LLregs ($13.65 in chips)
Seat 2: Cpt_Price_67 ($1.82 in chips)
Seat 3: monkmeleon ($2 in chips)
Seat 4: Weily8 ($2.43 in chips)
Seat 5: Nikand999 ($1.80 in chips)
Seat 6: 1976 T ($0.96 in chips)
Cpt_Price_67: posts small blind $0.01
monkmeleon: posts big blind $0.02
*** HOLE CARDS ***
Dealt to LLregs [4h 5s]
Weily8: folds
Nikand999: folds
1976 T: folds
LLregs: folds
Cpt_Price_67: folds
Uncalled bet ($0.01) returned to monkmeleon
monkmeleon collected $0.02 from pot
monkmeleon: doesn't show hand
*** SUMMARY ***
Total pot $0.02 | Rake $0
Seat 1: LLregs (button) folded before Flop (didn't bet)
Seat 2: Cpt_Price_67 (small blind) folded before Flop
Seat 3: monkmeleon (big blind) collected ($0.02)
Seat 4: Weily8 folded before Flop (didn't bet)
Seat 5: Nikand999 folded before Flop (didn't bet)
Seat 6: 1976 T folded before Flop (didn't bet)

PokerStars Zoom Hand #247969224481:  Hold'em No Limit ($0.01/$0.02) - 2023/12/30 22:46:34 WET [2023/12/30 17:46:34 ET]
Table 'Halley' 6-max Seat #1 is the button
Seat 1: IBRODIAN-ACER ($2.97 in chips)
Seat 2: LLregs ($13.65 in chips)
Seat 3: meysar ($2.82 in chips)
Seat 4: gamma720 ($0.77 in chips)
Seat 5: NoDenyPanda ($4.05 in chips)
Seat 6: NeckCarp ($0.98 in chips)
LLregs: posts small blind $0.01
meysar: posts big blind $0.02
*** HOLE CARDS ***
Dealt to LLregs [9d As]
gamma720: raises $0.02 to $0.04
NoDenyPanda: folds
NeckCarp: folds
IBRODIAN-ACER: folds
LLregs: folds
meysar: calls $0.02
*** FLOP *** [Jc 8s 3h]
meysar: checks
gamma720: checks
*** TURN *** [Jc 8s 3h] [8c]
meysar: checks
gamma720: checks
*** RIVER *** [Jc 8s 3h 8c] [9h]
meysar: bets $0.07
gamma720: calls $0.07
*** SHOW DOWN ***
meysar: shows [Td 7c] (a straight, Seven to Jack)
gamma720: mucks hand
meysar collected $0.22 from pot
*** SUMMARY ***
Total pot $0.23 | Rake $0.01
Board [Jc 8s 3h 8c 9h]
Seat 1: IBRODIAN-ACER (button) folded before Flop (didn't bet)
Seat 2: LLregs (small blind) folded before Flop
Seat 3: meysar (big blind) showed [Td 7c] and won ($0.22) with a straight, Seven to Jack
Seat 4: gamma720 mucked [Kc 9s]
Seat 5: NoDenyPanda folded before Flop (didn't bet)
Seat 6: NeckCarp folded before Flop (didn't bet)

PokerStars Zoom Hand #247969241727:  Hold'em No Limit ($0.01/$0.02) - 2023/12/30 22:47:21 WET [2023/12/30 17:47:21 ET]
Table 'Halley' 6-max Seat #1 is the button
Seat 1: davidbarrels ($1.76 in chips)
Seat 2: ilb571 ($2.24 in chips)
Seat 3: LLregs ($13.64 in chips)
Seat 4: Livio100 ($1.22 in chips)
Seat 5: Giocrik ($2.04 in chips)
Seat 6: Tha_Saint7 ($4.08 in chips)
ilb571: posts small blind $0.01
LLregs: posts big blind $0.02
*** HOLE CARDS ***
Dealt to LLregs [3s 4d]
Livio100: folds
Giocrik: raises $0.04 to $0.06
Tha_Saint7: folds
davidbarrels: folds
ilb571: folds
LLregs: folds
Uncalled bet ($0.04) returned to Giocrik
Giocrik collected $0.05 from pot
Giocrik: doesn't show hand
*** SUMMARY ***
Total pot $0.05 | Rake $0
Seat 1: davidbarrels (button) folded before Flop (didn't bet)
Seat 2: ilb571 (small blind) folded before Flop
Seat 3: LLregs (big blind) folded before Flop
Seat 4: Livio100 folded before Flop (didn't bet)
Seat 5: Giocrik collected ($0.05)
Seat 6: Tha_Saint7 folded before Flop (didn't bet)

PokerStars Zoom Hand #247969235988:  Hold'em No Limit ($0.01/$0.02) - 2023/12/30 22:47:05 WET [2023/12/30 17:47:05 ET]
Table 'Halley' 6-max Seat #1 is the button
Seat 1: PenTAce ($2.31 in chips)
Seat 2: g-upp-y_doda ($0.47 in chips)
Seat 3: Svartbäcken ($1.82 in chips)
Seat 4: LLregs ($13.64 in chips)
Seat 5: IBRODIAN-ACER ($2.97 in chips)
Seat 6: jonbeton8 ($2.39 in chips)
g-upp-y_doda: posts small blind $0.01
Svartbäcken: posts big blind $0.02
*** HOLE CARDS ***
Dealt to LLregs [8h 9h]
jonbeton8 is disconnected
LLregs has timed out
LLregs: folds
IBRODIAN-ACER: folds
jonbeton8 has timed out while disconnected
jonbeton8: folds
PenTAce: raises $0.04 to $0.06
g-upp-y_doda: calls $0.05
Svartbäcken: folds
*** FLOP *** [7d 4d 6s]
g-upp-y_doda: bets $0.41 and is all-in
PenTAce: folds
Uncalled bet ($0.41) returned to g-upp-y_doda
g-upp-y_doda collected $0.14 from pot
g-upp-y_doda: doesn't show hand
*** SUMMARY ***
Total pot $0.14 | Rake $0
Board [7d 4d 6s]
Seat 1: PenTAce (button) folded on the Flop
Seat 2: g-upp-y_doda (small blind) collected ($0.14)
Seat 3: Svartbäcken (big blind) folded before Flop
Seat 4: LLregs folded before Flop (didn't bet)
Seat 5: IBRODIAN-ACER folded before Flop (didn't bet)
Seat 6: jonbeton8 folded before Flop (didn't bet)

PokerStars Zoom Hand #247969246225:  Hold'em No Limit ($0.01/$0.02) - 2023/12/30 22:47:33 WET [2023/12/30 17:47:33 ET]
Table 'Halley' 6-max Seat #1 is the button
Seat 1: Rikko6688 ($2.26 in chips)
Seat 2: PSVMagdeburg ($1.64 in chips)
Seat 3: Leka69420 ($1.80 in chips)
Seat 4: conspy84 ($1.52 in chips)
Seat 5: LLregs ($13.62 in chips)
Seat 6: napoli222 ($3.69 in chips)
PSVMagdeburg: posts small blind $0.01
Leka69420: posts big blind $0.02
*** HOLE CARDS ***
Dealt to LLregs [4s Kc]
conspy84: folds
LLregs: folds
napoli222: folds
Rikko6688 has timed out
Rikko6688: folds
PSVMagdeburg: folds
Uncalled bet ($0.01) returned to Leka69420
Leka69420 collected $0.02 from pot
Leka69420: doesn't show hand
*** SUMMARY ***
Total pot $0.02 | Rake $0
Seat 1: Rikko6688 (button) folded before Flop (didn't bet)
Seat 2: PSVMagdeburg (small blind) folded before Flop
Seat 3: Leka69420 (big blind) collected ($0.02)
Seat 4: conspy84 folded before Flop (didn't bet)
Seat 5: LLregs folded before Flop (didn't bet)
Seat 6: napoli222 folded before Flop (didn't bet)

PokerStars Zoom Hand #247969251343:  Hold'em No Limit ($0.01/$0.02) - 2023/12/30 22:47:46 WET [2023/12/30 17:47:46 ET]
Table 'Halley' 6-max Seat #1 is the button
Seat 1: maritokpo ($2.56 in chips)
Seat 2: Mizhina ($2 in chips)
Seat 3: Ilikefossil ($2 in chips)
Seat 4: 888lifeIS ($2.04 in chips)
Seat 5: Holding1994 ($4.19 in chips)
Seat 6: LLregs ($13.61 in chips)
Mizhina: posts small blind $0.01
Ilikefossil: posts big blind $0.02
*** HOLE CARDS ***
Dealt to LLregs [Kh 5c]
888lifeIS: folds
Holding1994: folds
LLregs: folds
maritokpo: folds
Mizhina: folds
Uncalled bet ($0.01) returned to Ilikefossil
Ilikefossil collected $0.02 from pot
Ilikefossil: doesn't show hand
*** SUMMARY ***
Total pot $0.02 | Rake $0
Seat 1: maritokpo (button) folded before Flop (didn't bet)
Seat 2: Mizhina (small blind) folded before Flop
Seat 3: Ilikefossil (big blind) collected ($0.02)
Seat 4: 888lifeIS folded before Flop (didn't bet)
Seat 5: Holding1994 folded before Flop (didn't bet)
Seat 6: LLregs folded before Flop (didn't bet)

PokerStars Zoom Hand #247969235044:  Hold'em No Limit ($0.01/$0.02) - 2023/12/30 22:47:02 WET [2023/12/30 17:47:02 ET]
Table 'Halley' 6-max Seat #1 is the button
Seat 1: degelcamus ($3.16 in chips)
Seat 2: eektwomice ($2.13 in chips)
Seat 3: Sw4nsan ($2.27 in chips)
Seat 4: LLregs ($13.64 in chips)
Seat 5: Harold_Seven ($1.02 in chips)
Seat 6: shermheadryder ($3.88 in chips)
eektwomice: posts small blind $0.01
Sw4nsan: posts big blind $0.02
*** HOLE CARDS ***
Dealt to LLregs [6h 5h]
LLregs: folds
Harold_Seven: folds
shermheadryder: folds
degelcamus: folds
eektwomice: raises $0.04 to $0.06
Sw4nsan: calls $0.04
*** FLOP *** [Qd Tc 3c]
eektwomice: bets $0.06
Sw4nsan: calls $0.06
*** TURN *** [Qd Tc 3c] [Jd]
eektwomice: bets $0.12
Sw4nsan: calls $0.12
*** RIVER *** [Qd Tc 3c Jd] [Ah]
eektwomice: checks
Sw4nsan: bets $0.15
eektwomice: calls $0.15
*** SHOW DOWN ***
Sw4nsan: shows [3d 7d] (a pair of Threes)
eektwomice: shows [6s Ac] (a pair of Aces)
eektwomice collected $0.75 from pot
*** SUMMARY ***
Total pot $0.78 | Rake $0.03
Board [Qd Tc 3c Jd Ah]
Seat 1: degelcamus (button) folded before Flop (didn't bet)
Seat 2: eektwomice (small blind) showed [6s Ac] and won ($0.75) with a pair of Aces
Seat 3: Sw4nsan (big blind) showed [3d 7d] and lost with a pair of Threes
Seat 4: LLregs folded before Flop (didn't bet)
Seat 5: Harold_Seven folded before Flop (didn't bet)
Seat 6: shermheadryder folded before Flop (didn't bet)

PokerStars Zoom Hand #247969252897:  Hold'em No Limit ($0.01/$0.02) - 2023/12/30 22:47:51 WET [2023/12/30 17:47:51 ET]
Table 'Halley' 6-max Seat #1 is the button
Seat 1: LLregs ($13.61 in chips)
Seat 2: Weily8 ($2.38 in chips)
Seat 3: jbarrios007 ($3.61 in chips)
Seat 4: NoDenyPanda ($2.47 in chips)
Seat 5: JuanChu070 ($3.04 in chips)
Seat 6: Mizhina ($2 in chips)
Weily8: posts small blind $0.01
jbarrios007: posts big blind $0.02
*** HOLE CARDS ***
Dealt to LLregs [Kc 2d]
NoDenyPanda: folds
JuanChu070: folds
Mizhina: folds
LLregs: folds
Weily8: raises $0.04 to $0.06
jbarrios007: folds
Uncalled bet ($0.04) returned to Weily8
Weily8 collected $0.04 from pot
Weily8: doesn't show hand
*** SUMMARY ***
Total pot $0.04 | Rake $0
Seat 1: LLregs (button) folded before Flop (didn't bet)
Seat 2: Weily8 (small blind) collected ($0.04)
Seat 3: jbarrios007 (big blind) folded before Flop
Seat 4: NoDenyPanda folded before Flop (didn't bet)
Seat 5: JuanChu070 folded before Flop (didn't bet)
Seat 6: Mizhina folded before Flop (didn't bet)

PokerStars Zoom Hand #247969254630:  Hold'em No Limit ($0.01/$0.02) - 2023/12/30 22:47:55 WET [2023/12/30 17:47:55 ET]
Table 'Halley' 6-max Seat #1 is the button
Seat 1: eektwomice ($2.81 in chips)
Seat 2: stunner993 ($1.13 in chips)
Seat 3: Pedroreidelas ($0.08 in chips)
Seat 4: Svartbäcken ($1.79 in chips)
Seat 5: LLregs ($13.61 in chips)
Seat 6: vimpu ($2.31 in chips)
stunner993: posts small blind $0.01
Pedroreidelas: posts big blind $0.02
*** HOLE CARDS ***
Dealt to LLregs [2d 7c]
Svartbäcken: folds
LLregs: folds
vimpu: raises $0.02 to $0.04
eektwomice: folds
stunner993: raises $0.08 to $0.12
Pedroreidelas: folds
vimpu: calls $0.08
*** FLOP *** [3d Ad Qs]
stunner993: bets $0.06
vimpu: folds
Uncalled bet ($0.06) returned to stunner993
stunner993 collected $0.25 from pot
stunner993: doesn't show hand
*** SUMMARY ***
Total pot $0.26 | Rake $0.01
Board [3d Ad Qs]
Seat 1: eektwomice (button) folded before Flop (didn't bet)
Seat 2: stunner993 (small blind) collected ($0.25)
Seat 3: Pedroreidelas (big blind) folded before Flop
Seat 4: Svartbäcken folded before Flop (didn't bet)
Seat 5: LLregs folded before Flop (didn't bet)
Seat 6: vimpu folded on the Flop

PokerStars Zoom Hand #247969256088:  Hold'em No Limit ($0.01/$0.02) - 2023/12/30 22:47:59 WET [2023/12/30 17:47:59 ET]
Table 'Halley' 6-max Seat #1 is the button
Seat 1: HooliganBasher ($3.05 in chips)
Seat 2: abeech94 ($2.03 in chips)
Seat 3: LLregs ($13.61 in chips)
Seat 4: my sapphire ($2.17 in chips)
Seat 5: 232489410 ($2.51 in chips)
Seat 6: capuuh ($2.11 in chips)
abeech94: posts small blind $0.01
LLregs: posts big blind $0.02
*** HOLE CARDS ***
Dealt to LLregs [Qc 8d]
my sapphire: raises $0.03 to $0.05
232489410: folds
capuuh: folds
HooliganBasher: folds
abeech94: folds
LLregs: calls $0.03
*** FLOP *** [5d Tc 8h]
LLregs: checks
my sapphire: bets $0.06
LLregs: calls $0.06
*** TURN *** [5d Tc 8h] [7d]
LLregs: checks
my sapphire: bets $0.17
LLregs: calls $0.17
*** RIVER *** [5d Tc 8h 7d] [3h]
LLregs: checks
my sapphire: checks
*** SHOW DOWN ***
LLregs: shows [Qc 8d] (a pair of Eights)
my sapphire: shows [Td 9d] (a pair of Tens)
my sapphire collected $0.55 from pot
*** SUMMARY ***
Total pot $0.57 | Rake $0.02
Board [5d Tc 8h 7d 3h]
Seat 1: HooliganBasher (button) folded before Flop (didn't bet)
Seat 2: abeech94 (small blind) folded before Flop
Seat 3: LLregs (big blind) showed [Qc 8d] and lost with a pair of Eights
Seat 4: my sapphire showed [Td 9d] and won ($0.55) with a pair of Tens
Seat 5: 232489410 folded before Flop (didn't bet)
Seat 6: capuuh folded before Flop (didn't bet)

PokerStars Zoom Hand #247969249473:  Hold'em No Limit ($0.01/$0.02) - 2023/12/30 22:47:41 WET [2023/12/30 17:47:41 ET]
Table 'Halley' 6-max Seat #1 is the button
Seat 1: meysar ($2.91 in chips)
Seat 2: LLregs ($13.62 in chips)
Seat 3: S-Solaris83 ($1.85 in chips)
Seat 4: davidbarrels ($1.39 in chips)
Seat 5: TSCardinals ($2.09 in chips)
Seat 6: TeodorRR92 ($4.60 in chips)
LLregs: posts small blind $0.01
S-Solaris83: posts big blind $0.02
*** HOLE CARDS ***
Dealt to LLregs [6h Th]
davidbarrels: folds
TSCardinals: folds
TeodorRR92: raises $0.04 to $0.06
meysar: raises $0.15 to $0.21
LLregs: folds
S-Solaris83: folds
TeodorRR92: calls $0.15
*** FLOP *** [4c 4h 4d]
TeodorRR92: checks
meysar: bets $0.32
TeodorRR92: calls $0.32
*** TURN *** [4c 4h 4d] [9h]
TeodorRR92: checks
meysar: checks
*** RIVER *** [4c 4h 4d 9h] [6c]
TeodorRR92: bets $0.43
meysar: folds
Uncalled bet ($0.43) returned to TeodorRR92
TeodorRR92 collected $1.05 from pot
TeodorRR92: doesn't show hand
*** SUMMARY ***
Total pot $1.09 | Rake $0.04
Board [4c 4h 4d 9h 6c]
Seat 1: meysar (button) folded on the River
Seat 2: LLregs (small blind) folded before Flop
Seat 3: S-Solaris83 (big blind) folded before Flop
Seat 4: davidbarrels folded before Flop (didn't bet)
Seat 5: TSCardinals folded before Flop (didn't bet)
Seat 6: TeodorRR92 collected ($1.05)

PokerStars Zoom Hand #247969272747:  Hold'em No Limit ($0.01/$0.02) - 2023/12/30 22:48:45 WET [2023/12/30 17:48:45 ET]
Table 'Halley' 6-max Seat #1 is the button
Seat 1: jbarrios007 ($2.97 in chips)
Seat 2: LLregs ($13.33 in chips)
Seat 3: cr@sh test ($4.18 in chips)
Seat 4: allergy2nuts ($2.04 in chips)
Seat 5: HarryHaller77 ($3.27 in chips)
Seat 6: mag111115 ($0.96 in chips)
LLregs: posts small blind $0.01
cr@sh test: posts big blind $0.02
*** HOLE CARDS ***
Dealt to LLregs [5s 9d]
allergy2nuts: folds
HarryHaller77: folds
mag111115: folds
jbarrios007: folds
LLregs: folds
Uncalled bet ($0.01) returned to cr@sh test
cr@sh test collected $0.02 from pot
cr@sh test: doesn't show hand
*** SUMMARY ***
Total pot $0.02 | Rake $0
Seat 1: jbarrios007 (button) folded before Flop (didn't bet)
Seat 2: LLregs (small blind) folded before Flop
Seat 3: cr@sh test (big blind) collected ($0.02)
Seat 4: allergy2nuts folded before Flop (didn't bet)
Seat 5: HarryHaller77 folded before Flop (didn't bet)
Seat 6: mag111115 folded before Flop (didn't bet)

PokerStars Zoom Hand #247969274964:  Hold'em No Limit ($0.01/$0.02) - 2023/12/30 22:48:51 WET [2023/12/30 17:48:51 ET]
Table 'Halley' 6-max Seat #1 is the button
Seat 1: Crisium B ($2.48 in chips)
Seat 2: coy1e_f1ush ($1.99 in chips)
Seat 3: srna10 ($2.57 in chips)
Seat 4: mcqueen3370 ($1.96 in chips)
Seat 5: allergy2nuts ($2.04 in chips)
Seat 6: LLregs ($13.32 in chips)
coy1e_f1ush: posts small blind $0.01
srna10: posts big blind $0.02
*** HOLE CARDS ***
Dealt to LLregs [3d Kd]
mcqueen3370: raises $0.02 to $0.04
allergy2nuts: folds
LLregs: folds
Crisium B: folds
coy1e_f1ush: folds
srna10: folds
Uncalled bet ($0.02) returned to mcqueen3370
mcqueen3370 collected $0.05 from pot
mcqueen3370: doesn't show hand
*** SUMMARY ***
Total pot $0.05 | Rake $0
Seat 1: Crisium B (button) folded before Flop (didn't bet)
Seat 2: coy1e_f1ush (small blind) folded before Flop
Seat 3: srna10 (big blind) folded before Flop
Seat 4: mcqueen3370 collected ($0.05)
Seat 5: allergy2nuts folded before Flop (didn't bet)
Seat 6: LLregs folded before Flop (didn't bet)

PokerStars Zoom Hand #247969273972:  Hold'em No Limit ($0.01/$0.02) - 2023/12/30 22:48:48 WET [2023/12/30 17:48:48 ET]
Table 'Halley' 6-max Seat #1 is the button
Seat 1: LLregs ($13.32 in chips)
Seat 2: ZorroZoltan ($4.74 in chips)
Seat 3: Gerox118 ($0.94 in chips)
Seat 4: Ilikefossil ($2 in chips)
Seat 5: HooliganBasher ($7.91 in chips)
Seat 6: shermheadryder ($3.79 in chips)
ZorroZoltan: posts small blind $0.01
Gerox118: posts big blind $0.02
*** HOLE CARDS ***
Dealt to LLregs [4d 8c]
Ilikefossil: folds
HooliganBasher: folds
shermheadryder: raises $0.04 to $0.06
LLregs: folds
ZorroZoltan: folds
Gerox118: folds
Uncalled bet ($0.04) returned to shermheadryder
shermheadryder collected $0.05 from pot
shermheadryder: doesn't show hand
*** SUMMARY ***
Total pot $0.05 | Rake $0
Seat 1: LLregs (button) folded before Flop (didn't bet)
Seat 2: ZorroZoltan (small blind) folded before Flop
Seat 3: Gerox118 (big blind) folded before Flop
Seat 4: Ilikefossil folded before Flop (didn't bet)
Seat 5: HooliganBasher folded before Flop (didn't bet)
Seat 6: shermheadryder collected ($0.05)

PokerStars Zoom Hand #247969276368:  Hold'em No Limit ($0.01/$0.02) - 2023/12/30 22:48:55 WET [2023/12/30 17:48:55 ET]
Table 'Halley' 6-max Seat #1 is the button
Seat 1: sTIKs21 ($2.08 in chips)
Seat 2: IngeniEbr10 ($2.27 in chips)
Seat 3: meysar ($2.27 in chips)
Seat 4: Wahnsinn24 ($1.30 in chips)
Seat 5: LLregs ($13.32 in chips)
Seat 6: conspy84 ($1.48 in chips)
IngeniEbr10: posts small blind $0.01
meysar: posts big blind $0.02
*** HOLE CARDS ***
Dealt to LLregs [Qc 9d]
Wahnsinn24: folds
LLregs: folds
conspy84: folds
sTIKs21: raises $0.03 to $0.05
IngeniEbr10: folds
meysar: calls $0.03
*** FLOP *** [7s Js 2h]
meysar: bets $0.06
sTIKs21: folds
Uncalled bet ($0.06) returned to meysar
meysar collected $0.11 from pot
meysar: doesn't show hand
*** SUMMARY ***
Total pot $0.11 | Rake $0
Board [7s Js 2h]
Seat 1: sTIKs21 (button) folded on the Flop
Seat 2: IngeniEbr10 (small blind) folded before Flop
Seat 3: meysar (big blind) collected ($0.11)
Seat 4: Wahnsinn24 folded before Flop (didn't bet)
Seat 5: LLregs folded before Flop (didn't bet)
Seat 6: conspy84 folded before Flop (didn't bet)

PokerStars Zoom Hand #247969278207:  Hold'em No Limit ($0.01/$0.02) - 2023/12/30 22:49:00 WET [2023/12/30 17:49:00 ET]
Table 'Halley' 6-max Seat #1 is the button
Seat 1: CoverXx ($2.87 in chips)
Seat 2: Casinoca$h ($2.31 in chips)
Seat 3: degelcamus ($6.01 in chips)
Seat 4: LLregs ($13.32 in chips)
Seat 5: Rob Sharona ($2.30 in chips)
Seat 6: davidbarrels ($1.77 in chips)
Casinoca$h: posts small blind $0.01
degelcamus: posts big blind $0.02
*** HOLE CARDS ***
Dealt to LLregs [5h 7c]
LLregs: folds
Rob Sharona: folds
davidbarrels: raises $0.04 to $0.06
CoverXx: folds
Casinoca$h: folds
degelcamus: folds
Uncalled bet ($0.04) returned to davidbarrels
davidbarrels collected $0.05 from pot
davidbarrels: doesn't show hand
*** SUMMARY ***
Total pot $0.05 | Rake $0
Seat 1: CoverXx (button) folded before Flop (didn't bet)
Seat 2: Casinoca$h (small blind) folded before Flop
Seat 3: degelcamus (big blind) folded before Flop
Seat 4: LLregs folded before Flop (didn't bet)
Seat 5: Rob Sharona folded before Flop (didn't bet)
Seat 6: davidbarrels collected ($0.05)

PokerStars Zoom Hand #247969270892:  Hold'em No Limit ($0.01/$0.02) - 2023/12/30 22:48:40 WET [2023/12/30 17:48:40 ET]
Table 'Halley' 6-max Seat #1 is the button
Seat 1: Harold_Seven ($0.97 in chips)
Seat 2: mjeenetto ($1.65 in chips)
Seat 3: edhillm ($2 in chips)
Seat 4: Alexm8205 ($2.42 in chips)
Seat 5: pablosalermo ($0.76 in chips)
Seat 6: LLregs ($13.33 in chips)
mjeenetto: posts small blind $0.01
edhillm: posts big blind $0.02
*** HOLE CARDS ***
Dealt to LLregs [7c Kd]
Alexm8205: folds
pablosalermo: raises $0.02 to $0.04
LLregs: folds
Harold_Seven: folds
mjeenetto: calls $0.03
edhillm: folds
*** FLOP *** [9d Kh Js]
mjeenetto: checks
pablosalermo: bets $0.05
mjeenetto: calls $0.05
*** TURN *** [9d Kh Js] [2d]
mjeenetto: checks
pablosalermo: checks
*** RIVER *** [9d Kh Js 2d] [Ac]
mjeenetto: bets $0.06
pablosalermo: folds
Uncalled bet ($0.06) returned to mjeenetto
mjeenetto collected $0.19 from pot
mjeenetto: doesn't show hand
*** SUMMARY ***
Total pot $0.20 | Rake $0.01
Board [9d Kh Js 2d Ac]
Seat 1: Harold_Seven (button) folded before Flop (didn't bet)
Seat 2: mjeenetto (small blind) collected ($0.19)
Seat 3: edhillm (big blind) folded before Flop
Seat 4: Alexm8205 folded before Flop (didn't bet)
Seat 5: pablosalermo folded on the River
Seat 6: LLregs folded before Flop (didn't bet)

PokerStars Zoom Hand #247969279642:  Hold'em No Limit ($0.01/$0.02) - 2023/12/30 22:49:04 WET [2023/12/30 17:49:04 ET]
Table 'Halley' 6-max Seat #1 is the button
Seat 1: IngeniEbr10 ($2.26 in chips)
Seat 2: 3ldickson ($0.86 in chips)
Seat 3: LLregs ($13.32 in chips)
Seat 4: abeech94 ($2.02 in chips)
Seat 5: shermheadryder ($3.82 in chips)
Seat 6: Rob Sharona ($2.30 in chips)
3ldickson: posts small blind $0.01
LLregs: posts big blind $0.02
*** HOLE CARDS ***
Dealt to LLregs [9h As]
abeech94: folds
shermheadryder: folds
Rob Sharona: folds
IngeniEbr10: raises $0.03 to $0.05
3ldickson: folds
LLregs: calls $0.03
*** FLOP *** [Ac Qd Qs]
LLregs: checks
IngeniEbr10: bets $0.04
LLregs: calls $0.04
*** TURN *** [Ac Qd Qs] [5c]
LLregs: checks
IngeniEbr10: checks
*** RIVER *** [Ac Qd Qs 5c] [5d]
LLregs: bets $0.06
IngeniEbr10: folds
Uncalled bet ($0.06) returned to LLregs
LLregs collected $0.18 from pot
LLregs: doesn't show hand
*** SUMMARY ***
Total pot $0.19 | Rake $0.01
Board [Ac Qd Qs 5c 5d]
Seat 1: IngeniEbr10 (button) folded on the River
Seat 2: 3ldickson (small blind) folded before Flop
Seat 3: LLregs (big blind) collected ($0.18)
Seat 4: abeech94 folded before Flop (didn't bet)
Seat 5: shermheadryder folded before Flop (didn't bet)
Seat 6: Rob Sharona folded before Flop (didn't bet)

PokerStars Zoom Hand #247969292997:  Hold'em No Limit ($0.01/$0.02) - 2023/12/30 22:49:41 WET [2023/12/30 17:49:41 ET]
Table 'Halley' 6-max Seat #1 is the button
Seat 1: napoli222 ($3.69 in chips)
Seat 2: LLregs ($13.41 in chips)
Seat 3: abeech94 ($3.79 in chips)
Seat 4: RafkeProost ($3.38 in chips)
Seat 5: r3v3rs3f3r3t ($2 in chips)
Seat 6: jbarrios007 ($1.34 in chips)
LLregs: posts small blind $0.01
abeech94: posts big blind $0.02
*** HOLE CARDS ***
Dealt to LLregs [Qs 3d]
RafkeProost: folds
r3v3rs3f3r3t: folds
jbarrios007: folds
napoli222: folds
LLregs: folds
Uncalled bet ($0.01) returned to abeech94
abeech94 collected $0.02 from pot
abeech94: doesn't show hand
*** SUMMARY ***
Total pot $0.02 | Rake $0
Seat 1: napoli222 (button) folded before Flop (didn't bet)
Seat 2: LLregs (small blind) folded before Flop
Seat 3: abeech94 (big blind) collected ($0.02)
Seat 4: RafkeProost folded before Flop (didn't bet)
Seat 5: r3v3rs3f3r3t folded before Flop (didn't bet)
Seat 6: jbarrios007 folded before Flop (didn't bet)

PokerStars Zoom Hand #247969291245:  Hold'em No Limit ($0.01/$0.02) - 2023/12/30 22:49:36 WET [2023/12/30 17:49:36 ET]
Table 'Halley' 6-max Seat #1 is the button
Seat 1: jbarrios007 ($1.34 in chips)
Seat 2: xCancuN88x ($2.23 in chips)
Seat 3: TSCardinals ($2.13 in chips)
Seat 4: LLregs ($13.41 in chips)
Seat 5: Harold_Seven ($2.59 in chips)
Seat 6: n3olin3 ($0.80 in chips)
xCancuN88x: posts small blind $0.01
TSCardinals: posts big blind $0.02
*** HOLE CARDS ***
Dealt to LLregs [2c 6c]
LLregs: folds
Harold_Seven: folds
n3olin3: folds
jbarrios007: folds
xCancuN88x: calls $0.01
TSCardinals: checks
*** FLOP *** [Tc 5c Td]
xCancuN88x: bets $0.02
TSCardinals: calls $0.02
*** TURN *** [Tc 5c Td] [2d]
xCancuN88x: checks
TSCardinals: bets $0.06
xCancuN88x: raises $0.12 to $0.18
TSCardinals: calls $0.12
*** RIVER *** [Tc 5c Td 2d] [6h]
xCancuN88x: checks
TSCardinals: checks
*** SHOW DOWN ***
xCancuN88x: shows [4c Ah] (a pair of Tens)
TSCardinals: shows [7h 5h] (two pair, Tens and Fives)
TSCardinals collected $0.42 from pot
*** SUMMARY ***
Total pot $0.44 | Rake $0.02
Board [Tc 5c Td 2d 6h]
Seat 1: jbarrios007 (button) folded before Flop (didn't bet)
Seat 2: xCancuN88x (small blind) showed [4c Ah] and lost with a pair of Tens
Seat 3: TSCardinals (big blind) showed [7h 5h] and won ($0.42) with two pair, Tens and Fives
Seat 4: LLregs folded before Flop (didn't bet)
Seat 5: Harold_Seven folded before Flop (didn't bet)
Seat 6: n3olin3 folded before Flop (didn't bet)

PokerStars Zoom Hand #247969294475:  Hold'em No Limit ($0.01/$0.02) - 2023/12/30 22:49:45 WET [2023/12/30 17:49:45 ET]
Table 'Halley' 6-max Seat #1 is the button
Seat 1: MrMole235 ($3.27 in chips)
Seat 2: Harold_Seven ($2.59 in chips)
Seat 3: LLregs ($13.40 in chips)
Seat 4: beza156 ($1.89 in chips)
Seat 5: CoverXx ($2.79 in chips)
Seat 6: 232489410 ($2.52 in chips)
Harold_Seven: posts small blind $0.01
LLregs: posts big blind $0.02
*** HOLE CARDS ***
Dealt to LLregs [Ac Jd]
beza156: folds
CoverXx: raises $0.04 to $0.06
232489410: folds
MrMole235: folds
Harold_Seven: folds
LLregs: calls $0.04
*** FLOP *** [Jc Qh Kh]
LLregs: bets $0.06
CoverXx: calls $0.06
*** TURN *** [Jc Qh Kh] [9d]
LLregs: checks
CoverXx: checks
*** RIVER *** [Jc Qh Kh 9d] [5d]
LLregs: bets $0.08
CoverXx: folds
Uncalled bet ($0.08) returned to LLregs
LLregs collected $0.24 from pot
LLregs: doesn't show hand
*** SUMMARY ***
Total pot $0.25 | Rake $0.01
Board [Jc Qh Kh 9d 5d]
Seat 1: MrMole235 (button) folded before Flop (didn't bet)
Seat 2: Harold_Seven (small blind) folded before Flop
Seat 3: LLregs (big blind) collected ($0.24)
Seat 4: beza156 folded before Flop (didn't bet)
Seat 5: CoverXx folded on the River
Seat 6: 232489410 folded before Flop (didn't bet)

PokerStars Zoom Hand #247969317558:  Hold'em No Limit ($0.01/$0.02) - 2023/12/30 22:50:49 WET [2023/12/30 17:50:49 ET]
Table 'Halley' 6-max Seat #1 is the button
Seat 1: napoli222 ($3.30 in chips)
Seat 2: WEBOO1 ($1.14 in chips)
Seat 3: CrazyMozggg ($1.27 in chips)
Seat 4: LLregs ($13.52 in chips)
Seat 5: Holding1994 ($3.93 in chips)
Seat 6: Tha_Saint7 ($3.95 in chips)
WEBOO1: posts small blind $0.01
CrazyMozggg: posts big blind $0.02
*** HOLE CARDS ***
Dealt to LLregs [4d 7h]
LLregs: folds
Holding1994: folds
Tha_Saint7: folds
napoli222: folds
WEBOO1: raises $0.04 to $0.06
CrazyMozggg: folds
Uncalled bet ($0.04) returned to WEBOO1
WEBOO1 collected $0.04 from pot
WEBOO1: doesn't show hand
*** SUMMARY ***
Total pot $0.04 | Rake $0
Seat 1: napoli222 (button) folded before Flop (didn't bet)
Seat 2: WEBOO1 (small blind) collected ($0.04)
Seat 3: CrazyMozggg (big blind) folded before Flop
Seat 4: LLregs folded before Flop (didn't bet)
Seat 5: Holding1994 folded before Flop (didn't bet)
Seat 6: Tha_Saint7 folded before Flop (didn't bet)

PokerStars Zoom Hand #247969320507:  Hold'em No Limit ($0.01/$0.02) - 2023/12/30 22:50:57 WET [2023/12/30 17:50:57 ET]
Table 'Halley' 6-max Seat #1 is the button
Seat 1: emopokera ($1.67 in chips)
Seat 2: LLregs ($13.52 in chips)
Seat 3: greyman34940 ($3.84 in chips)
Seat 4: Quirian ($2.19 in chips)
Seat 5: pablosalermo ($0.70 in chips)
Seat 6: jjuul ($1.50 in chips)
LLregs: posts small blind $0.01
greyman34940: posts big blind $0.02
*** HOLE CARDS ***
Dealt to LLregs [Qh 6d]
Quirian: folds
pablosalermo: folds
jjuul: raises $0.03 to $0.05
emopokera: folds
LLregs: folds
greyman34940: folds
Uncalled bet ($0.03) returned to jjuul
jjuul collected $0.05 from pot
jjuul: doesn't show hand
*** SUMMARY ***
Total pot $0.05 | Rake $0
Seat 1: emopokera (button) folded before Flop (didn't bet)
Seat 2: LLregs (small blind) folded before Flop
Seat 3: greyman34940 (big blind) folded before Flop
Seat 4: Quirian folded before Flop (didn't bet)
Seat 5: pablosalermo folded before Flop (didn't bet)
Seat 6: jjuul collected ($0.05)

PokerStars Zoom Hand #247969322951:  Hold'em No Limit ($0.01/$0.02) - 2023/12/30 22:51:04 WET [2023/12/30 17:51:04 ET]
Table 'Halley' 6-max Seat #1 is the button
Seat 1: LLregs ($13.51 in chips)
Seat 2: null11 ($1.35 in chips)
Seat 3: davor987 ($2 in chips)
Seat 4: ZiggyBoy90 ($2 in chips)
Seat 5: bassman526 ($2.19 in chips)
Seat 6: cr@sh test ($2.01 in chips)
null11: posts small blind $0.01
davor987: posts big blind $0.02
*** HOLE CARDS ***
Dealt to LLregs [Ks Qs]
ZiggyBoy90: folds
bassman526: raises $0.02 to $0.04
cr@sh test: folds
LLregs: calls $0.04
null11: folds
davor987: folds
*** FLOP *** [4s Ah Jd]
bassman526: bets $0.04
LLregs: calls $0.04
*** TURN *** [4s Ah Jd] [5c]
bassman526: bets $0.02
LLregs: calls $0.02
*** RIVER *** [4s Ah Jd 5c] [4h]
bassman526: bets $0.02
LLregs: calls $0.02
*** SHOW DOWN ***
bassman526: shows [7s As] (two pair, Aces and Fours)
LLregs: mucks hand
bassman526 collected $0.26 from pot
*** SUMMARY ***
Total pot $0.27 | Rake $0.01
Board [4s Ah Jd 5c 4h]
Seat 1: LLregs (button) mucked [Ks Qs]
Seat 2: null11 (small blind) folded before Flop
Seat 3: davor987 (big blind) folded before Flop
Seat 4: ZiggyBoy90 folded before Flop (didn't bet)
Seat 5: bassman526 showed [7s As] and won ($0.26) with two pair, Aces and Fours
Seat 6: cr@sh test folded before Flop (didn't bet)

PokerStars Zoom Hand #247969342543:  Hold'em No Limit ($0.01/$0.02) - 2023/12/30 22:51:58 WET [2023/12/30 17:51:58 ET]
Table 'Halley' 6-max Seat #1 is the button
Seat 1: greyman34940 ($6.83 in chips)
Seat 2: PenTAce ($3.31 in chips)
Seat 3: anthimoskon ($1.85 in chips)
Seat 4: Its all Real ($7.21 in chips)
Seat 5: pedroph3ks ($2.69 in chips)
Seat 6: LLregs ($13.39 in chips)
PenTAce: posts small blind $0.01
anthimoskon: posts big blind $0.02
*** HOLE CARDS ***
Dealt to LLregs [4c Ad]
Its all Real: folds
pedroph3ks: raises $0.02 to $0.04
LLregs: folds
greyman34940: folds
PenTAce: folds
anthimoskon: folds
Uncalled bet ($0.02) returned to pedroph3ks
pedroph3ks collected $0.05 from pot
pedroph3ks: doesn't show hand
*** SUMMARY ***
Total pot $0.05 | Rake $0
Seat 1: greyman34940 (button) folded before Flop (didn't bet)
Seat 2: PenTAce (small blind) folded before Flop
Seat 3: anthimoskon (big blind) folded before Flop
Seat 4: Its all Real folded before Flop (didn't bet)
Seat 5: pedroph3ks collected ($0.05)
Seat 6: LLregs folded before Flop (didn't bet)

PokerStars Zoom Hand #247969340382:  Hold'em No Limit ($0.01/$0.02) - 2023/12/30 22:51:52 WET [2023/12/30 17:51:52 ET]
Table 'Halley' 6-max Seat #1 is the button
Seat 1: LLregs ($13.39 in chips)
Seat 2: conspy84 ($3.88 in chips)
Seat 3: Dr G Homer ($2.35 in chips)
Seat 4: ONIPIKA ($3.73 in chips)
Seat 5: 2plateado2 ($4.13 in chips)
Seat 6: MrMole235 ($3.30 in chips)
conspy84: posts small blind $0.01
Dr G Homer: posts big blind $0.02
*** HOLE CARDS ***
Dealt to LLregs [Tc 3d]
ONIPIKA: folds
2plateado2: folds
MrMole235: raises $0.03 to $0.05
LLregs: folds
conspy84: folds
Dr G Homer: folds
Uncalled bet ($0.03) returned to MrMole235
MrMole235 collected $0.05 from pot
MrMole235: doesn't show hand
*** SUMMARY ***
Total pot $0.05 | Rake $0
Seat 1: LLregs (button) folded before Flop (didn't bet)
Seat 2: conspy84 (small blind) folded before Flop
Seat 3: Dr G Homer (big blind) folded before Flop
Seat 4: ONIPIKA folded before Flop (didn't bet)
Seat 5: 2plateado2 folded before Flop (didn't bet)
Seat 6: MrMole235 collected ($0.05)

PokerStars Zoom Hand #247969343998:  Hold'em No Limit ($0.01/$0.02) - 2023/12/30 22:52:02 WET [2023/12/30 17:52:02 ET]
Table 'Halley' 6-max Seat #1 is the button
Seat 1: VIDOPRO23 ($2.78 in chips)
Seat 2: RafkeProost ($3.52 in chips)
Seat 3: Alexm8205 ($2.11 in chips)
Seat 4: LLregs ($13.39 in chips)
Seat 5: ggnavarrovaz ($5.82 in chips)
Seat 6: cr@sh test ($3.43 in chips)
RafkeProost: posts small blind $0.01
Alexm8205: posts big blind $0.02
*** HOLE CARDS ***
Dealt to LLregs [4h 9s]
LLregs: folds
ggnavarrovaz: folds
cr@sh test: folds
VIDOPRO23: raises $0.05 to $0.07
RafkeProost: folds
Alexm8205: calls $0.05
*** FLOP *** [Kh 7s Ah]
Alexm8205: bets $0.04
VIDOPRO23: calls $0.04
*** TURN *** [Kh 7s Ah] [3h]
Alexm8205: checks
VIDOPRO23: checks
*** RIVER *** [Kh 7s Ah 3h] [7c]
Alexm8205: bets $0.04
VIDOPRO23: calls $0.04
*** SHOW DOWN ***
Alexm8205: shows [6h 6c] (two pair, Sevens and Sixes)
VIDOPRO23: shows [As Qs] (two pair, Aces and Sevens)
VIDOPRO23 collected $0.30 from pot
*** SUMMARY ***
Total pot $0.31 | Rake $0.01
Board [Kh 7s Ah 3h 7c]
Seat 1: VIDOPRO23 (button) showed [As Qs] and won ($0.30) with two pair, Aces and Sevens
Seat 2: RafkeProost (small blind) folded before Flop
Seat 3: Alexm8205 (big blind) showed [6h 6c] and lost with two pair, Sevens and Sixes
Seat 4: LLregs folded before Flop (didn't bet)
Seat 5: ggnavarrovaz folded before Flop (didn't bet)
Seat 6: cr@sh test folded before Flop (didn't bet)

PokerStars Zoom Hand #247969346155:  Hold'em No Limit ($0.01/$0.02) - 2023/12/30 22:52:08 WET [2023/12/30 17:52:08 ET]
Table 'Halley' 6-max Seat #1 is the button
Seat 1: capuuh ($2.61 in chips)
Seat 2: davor987 ($2 in chips)
Seat 3: LLregs ($13.39 in chips)
Seat 4: conspy84 ($3.87 in chips)
Seat 5: WEBOO1 ($1.10 in chips)
Seat 6: NineHi72 ($13.56 in chips)
davor987: posts small blind $0.01
LLregs: posts big blind $0.02
*** HOLE CARDS ***
Dealt to LLregs [3h Ah]
conspy84: folds
WEBOO1: raises $0.04 to $0.06
NineHi72: raises $0.12 to $0.18
capuuh: folds
davor987: folds
LLregs: folds
WEBOO1: folds
Uncalled bet ($0.12) returned to NineHi72
NineHi72 collected $0.15 from pot
NineHi72: doesn't show hand
*** SUMMARY ***
Total pot $0.15 | Rake $0
Seat 1: capuuh (button) folded before Flop (didn't bet)
Seat 2: davor987 (small blind) folded before Flop
Seat 3: LLregs (big blind) folded before Flop
Seat 4: conspy84 folded before Flop (didn't bet)
Seat 5: WEBOO1 folded before Flop
Seat 6: NineHi72 collected ($0.15)

PokerStars Zoom Hand #247969359462:  Hold'em No Limit ($0.01/$0.02) - 2023/12/30 22:52:45 WET [2023/12/30 17:52:45 ET]
Table 'Halley' 6-max Seat #1 is the button
Seat 1: Gustaveira ($1.93 in chips)
Seat 2: greyman34940 ($3.79 in chips)
Seat 3: qw3306 ($2 in chips)
Seat 4: jindjifill ($5.12 in chips)
Seat 5: LLregs ($13.37 in chips)
Seat 6: Libin13 ($4.11 in chips)
greyman34940: posts small blind $0.01
qw3306: posts big blind $0.02
*** HOLE CARDS ***
Dealt to LLregs [Js Ks]
jindjifill: raises $0.04 to $0.06
LLregs: calls $0.06
Libin13: folds
Gustaveira: folds
greyman34940: calls $0.05
qw3306: calls $0.04
*** FLOP *** [4c Ac 6h]
greyman34940: checks
qw3306: checks
jindjifill: bets $0.10
LLregs: folds
greyman34940: folds
qw3306: folds
Uncalled bet ($0.10) returned to jindjifill
jindjifill collected $0.23 from pot
jindjifill: doesn't show hand
*** SUMMARY ***
Total pot $0.24 | Rake $0.01
Board [4c Ac 6h]
Seat 1: Gustaveira (button) folded before Flop (didn't bet)
Seat 2: greyman34940 (small blind) folded on the Flop
Seat 3: qw3306 (big blind) folded on the Flop
Seat 4: jindjifill collected ($0.23)
Seat 5: LLregs folded on the Flop
Seat 6: Libin13 folded before Flop (didn't bet)

PokerStars Zoom Hand #247969372756:  Hold'em No Limit ($0.01/$0.02) - 2023/12/30 22:53:22 WET [2023/12/30 17:53:22 ET]
Table 'Halley' 6-max Seat #1 is the button
Seat 1: Tha_Saint7 ($3.48 in chips)
Seat 2: niv277 ($1.93 in chips)
Seat 3: meysar ($3.20 in chips)
Seat 4: frankquanki ($2.24 in chips)
Seat 5: Giocrik ($2.10 in chips)
Seat 6: LLregs ($13.31 in chips)
niv277: posts small blind $0.01
meysar: posts big blind $0.02
*** HOLE CARDS ***
Dealt to LLregs [5h Ks]
frankquanki: folds
Giocrik: raises $0.02 to $0.04
LLregs: folds
Tha_Saint7: folds
niv277: folds
meysar: calls $0.02
*** FLOP *** [7h 2c 3d]
meysar: checks
Giocrik: bets $0.06
meysar: folds
Uncalled bet ($0.06) returned to Giocrik
Giocrik collected $0.09 from pot
Giocrik: doesn't show hand
*** SUMMARY ***
Total pot $0.09 | Rake $0
Board [7h 2c 3d]
Seat 1: Tha_Saint7 (button) folded before Flop (didn't bet)
Seat 2: niv277 (small blind) folded before Flop
Seat 3: meysar (big blind) folded on the Flop
Seat 4: frankquanki folded before Flop (didn't bet)
Seat 5: Giocrik collected ($0.09)
Seat 6: LLregs folded before Flop (didn't bet)

PokerStars Zoom Hand #247969379623:  Hold'em No Limit ($0.01/$0.02) - 2023/12/30 22:53:41 WET [2023/12/30 17:53:41 ET]
Table 'Halley' 6-max Seat #1 is the button
Seat 1: DropIceoleito ($1.02 in chips)
Seat 2: LLregs ($13.31 in chips)
Seat 3: Paquistane$ ($1.78 in chips)
Seat 4: davidbarrels ($2.73 in chips)
Seat 5: 888lifeIS ($2 in chips)
Seat 6: 42Oedipius ($2 in chips)
LLregs: posts small blind $0.01
Paquistane$: posts big blind $0.02
*** HOLE CARDS ***
Dealt to LLregs [2h 6h]
davidbarrels: folds
888lifeIS: folds
42Oedipius: folds
DropIceoleito: folds
LLregs: folds
Uncalled bet ($0.01) returned to Paquistane$
Paquistane$ collected $0.02 from pot
Paquistane$: doesn't show hand
*** SUMMARY ***
Total pot $0.02 | Rake $0
Seat 1: DropIceoleito (button) folded before Flop (didn't bet)
Seat 2: LLregs (small blind) folded before Flop
Seat 3: Paquistane$ (big blind) collected ($0.02)
Seat 4: davidbarrels folded before Flop (didn't bet)
Seat 5: 888lifeIS folded before Flop (didn't bet)
Seat 6: 42Oedipius folded before Flop (didn't bet)

PokerStars Zoom Hand #247969382519:  Hold'em No Limit ($0.01/$0.02) - 2023/12/30 22:53:49 WET [2023/12/30 17:53:49 ET]
Table 'Halley' 6-max Seat #1 is the button
Seat 1: allergy2nuts ($2.18 in chips)
Seat 2: LLregs ($13.30 in chips)
Seat 3: DropIceoleito ($1.02 in chips)
Seat 4: marwood888 ($0.71 in chips)
Seat 5: dealmekkplease ($2.20 in chips)
Seat 6: FEROIZ ($2.04 in chips)
LLregs: posts small blind $0.01
DropIceoleito: posts big blind $0.02
*** HOLE CARDS ***
Dealt to LLregs [9c Qs]
marwood888: folds
dealmekkplease: folds
FEROIZ: folds
allergy2nuts: raises $0.04 to $0.06
LLregs: folds
DropIceoleito: folds
Uncalled bet ($0.04) returned to allergy2nuts
allergy2nuts collected $0.05 from pot
allergy2nuts: doesn't show hand
*** SUMMARY ***
Total pot $0.05 | Rake $0
Seat 1: allergy2nuts (button) collected ($0.05)
Seat 2: LLregs (small blind) folded before Flop
Seat 3: DropIceoleito (big blind) folded before Flop
Seat 4: marwood888 folded before Flop (didn't bet)
Seat 5: dealmekkplease folded before Flop (didn't bet)
Seat 6: FEROIZ folded before Flop (didn't bet)

PokerStars Zoom Hand #247969376005:  Hold'em No Limit ($0.01/$0.02) - 2023/12/30 22:53:31 WET [2023/12/30 17:53:31 ET]
Table 'Halley' 6-max Seat #1 is the button
Seat 1: LLregs ($13.31 in chips)
Seat 2: alexmdq11 ($2.48 in chips)
Seat 3: Tha_Saint7 ($3.47 in chips)
Seat 4: DropIceoleito ($1.46 in chips)
Seat 5: qw3306 ($2 in chips)
Seat 6: OKIRKOSTAS ($0.92 in chips)
alexmdq11: posts small blind $0.01
Tha_Saint7: posts big blind $0.02
*** HOLE CARDS ***
Dealt to LLregs [3s 3d]
DropIceoleito: folds
qw3306: folds
OKIRKOSTAS: folds
LLregs: folds
alexmdq11: raises $0.02 to $0.04
Tha_Saint7: raises $0.08 to $0.12
alexmdq11: calls $0.08
*** FLOP *** [3c Th Jd]
alexmdq11: checks
Tha_Saint7: checks
*** TURN *** [3c Th Jd] [9c]
alexmdq11: checks
Tha_Saint7: checks
*** RIVER *** [3c Th Jd 9c] [4s]
alexmdq11: bets $0.12
Tha_Saint7: calls $0.12
*** SHOW DOWN ***
alexmdq11: shows [4d Ac] (a pair of Fours)
Tha_Saint7: shows [Kd Tc] (a pair of Tens)
Tha_Saint7 collected $0.46 from pot
*** SUMMARY ***
Total pot $0.48 | Rake $0.02
Board [3c Th Jd 9c 4s]
Seat 1: LLregs (button) folded before Flop (didn't bet)
Seat 2: alexmdq11 (small blind) showed [4d Ac] and lost with a pair of Fours
Seat 3: Tha_Saint7 (big blind) showed [Kd Tc] and won ($0.46) with a pair of Tens
Seat 4: DropIceoleito folded before Flop (didn't bet)
Seat 5: qw3306 folded before Flop (didn't bet)
Seat 6: OKIRKOSTAS folded before Flop (didn't bet)

PokerStars Zoom Hand #247969385776:  Hold'em No Limit ($0.01/$0.02) - 2023/12/30 22:53:58 WET [2023/12/30 17:53:58 ET]
Table 'Halley' 6-max Seat #1 is the button
Seat 1: dogor73 ($1.26 in chips)
Seat 2: 888lifeIS ($2 in chips)
Seat 3: LLregs ($13.29 in chips)
Seat 4: ONIPIKA ($2.44 in chips)
Seat 5: 42Oedipius ($5.40 in chips)
Seat 6: Quantum771 ($2.14 in chips)
888lifeIS: posts small blind $0.01
LLregs: posts big blind $0.02
*** HOLE CARDS ***
Dealt to LLregs [9h 8d]
ONIPIKA: folds
42Oedipius: folds
Quantum771: folds
dogor73: raises $0.02 to $0.04
888lifeIS: calls $0.03
LLregs: calls $0.02
*** FLOP *** [As Ks 2s]
888lifeIS: checks
LLregs: checks
dogor73: checks
*** TURN *** [As Ks 2s] [Jh]
888lifeIS: checks
LLregs: checks
dogor73: bets $0.06
888lifeIS: folds
LLregs: folds
Uncalled bet ($0.06) returned to dogor73
dogor73 collected $0.12 from pot
dogor73: doesn't show hand
*** SUMMARY ***
Total pot $0.12 | Rake $0
Board [As Ks 2s Jh]
Seat 1: dogor73 (button) collected ($0.12)
Seat 2: 888lifeIS (small blind) folded on the Turn
Seat 3: LLregs (big blind) folded on the Turn
Seat 4: ONIPIKA folded before Flop (didn't bet)
Seat 5: 42Oedipius folded before Flop (didn't bet)
Seat 6: Quantum771 folded before Flop (didn't bet)

PokerStars Zoom Hand #247969381073:  Hold'em No Limit ($0.01/$0.02) - 2023/12/30 22:53:45 WET [2023/12/30 17:53:45 ET]
Table 'Halley' 6-max Seat #1 is the button
Seat 1: Giocrik ($1.17 in chips)
Seat 2: portilho69 ($1.17 in chips)
Seat 3: NtwoB ($2.16 in chips)
Seat 4: Nikand999 ($1.78 in chips)
Seat 5: LLregs ($13.30 in chips)
Seat 6: Wahnsinn24 ($1.98 in chips)
portilho69: posts small blind $0.01
NtwoB: posts big blind $0.02
*** HOLE CARDS ***
Dealt to LLregs [Kd 3d]
Nikand999: raises $0.03 to $0.05
LLregs: folds
Wahnsinn24: calls $0.05
Giocrik: folds
portilho69: folds
NtwoB: folds
*** FLOP *** [9c 3s Jd]
Nikand999: bets $0.04
Wahnsinn24: calls $0.04
*** TURN *** [9c 3s Jd] [9d]
Nikand999: checks
Wahnsinn24: checks
*** RIVER *** [9c 3s Jd 9d] [Tc]
Nikand999: checks
Wahnsinn24: checks
*** SHOW DOWN ***
Nikand999: shows [Ac Qc] (a pair of Nines)
Wahnsinn24: shows [4c 4h] (two pair, Nines and Fours)
Wahnsinn24 collected $0.20 from pot
*** SUMMARY ***
Total pot $0.21 | Rake $0.01
Board [9c 3s Jd 9d Tc]
Seat 1: Giocrik (button) folded before Flop (didn't bet)
Seat 2: portilho69 (small blind) folded before Flop
Seat 3: NtwoB (big blind) folded before Flop
Seat 4: Nikand999 showed [Ac Qc] and lost with a pair of Nines
Seat 5: LLregs folded before Flop (didn't bet)
Seat 6: Wahnsinn24 showed [4c 4h] and won ($0.20) with two pair, Nines and Fours

PokerStars Zoom Hand #247969396798:  Hold'em No Limit ($0.01/$0.02) - 2023/12/30 22:54:29 WET [2023/12/30 17:54:29 ET]
Table 'Halley' 6-max Seat #1 is the button
Seat 1: LeandreCHR ($2.29 in chips)
Seat 2: NineHi72 ($14.59 in chips)
Seat 3: cr@sh test ($4.08 in chips)
Seat 4: DropIceoleito ($0.99 in chips)
Seat 5: S-Solaris83 ($2.13 in chips)
Seat 6: LLregs ($13.25 in chips)
NineHi72: posts small blind $0.01
cr@sh test: posts big blind $0.02
*** HOLE CARDS ***
Dealt to LLregs [Th 9d]
DropIceoleito: folds
S-Solaris83: folds
LLregs: raises $0.04 to $0.06
LeandreCHR: raises $0.15 to $0.21
NineHi72: folds
cr@sh test: folds
LLregs: folds
Uncalled bet ($0.15) returned to LeandreCHR
LeandreCHR collected $0.15 from pot
LeandreCHR: doesn't show hand
*** SUMMARY ***
Total pot $0.15 | Rake $0
Seat 1: LeandreCHR (button) collected ($0.15)
Seat 2: NineHi72 (small blind) folded before Flop
Seat 3: cr@sh test (big blind) folded before Flop
Seat 4: DropIceoleito folded before Flop (didn't bet)
Seat 5: S-Solaris83 folded before Flop (didn't bet)
Seat 6: LLregs folded before Flop

PokerStars Zoom Hand #247969403019:  Hold'em No Limit ($0.01/$0.02) - 2023/12/30 22:54:46 WET [2023/12/30 17:54:46 ET]
Table 'Halley' 6-max Seat #1 is the button
Seat 1: LLregs ($13.19 in chips)
Seat 2: Dinostzi ($1.11 in chips)
Seat 3: naruhoka ($6.87 in chips)
Seat 4: omutst ($3.42 in chips)
Seat 5: rafam22 ($1.91 in chips)
Seat 6: medvedka46 ($0.99 in chips)
Dinostzi: posts small blind $0.01
naruhoka: posts big blind $0.02
*** HOLE CARDS ***
Dealt to LLregs [6d 4h]
omutst: raises $0.03 to $0.05
rafam22: folds
medvedka46: folds
LLregs: folds
Dinostzi: folds
naruhoka: folds
Uncalled bet ($0.03) returned to omutst
omutst collected $0.05 from pot
omutst: doesn't show hand
*** SUMMARY ***
Total pot $0.05 | Rake $0
Seat 1: LLregs (button) folded before Flop (didn't bet)
Seat 2: Dinostzi (small blind) folded before Flop
Seat 3: naruhoka (big blind) folded before Flop
Seat 4: omutst collected ($0.05)
Seat 5: rafam22 folded before Flop (didn't bet)
Seat 6: medvedka46 folded before Flop (didn't bet)

PokerStars Zoom Hand #247969404161:  Hold'em No Limit ($0.01/$0.02) - 2023/12/30 22:54:49 WET [2023/12/30 17:54:49 ET]
Table 'Halley' 6-max Seat #1 is the button
Seat 1: ZorroZoltan ($2.31 in chips)
Seat 2: Skelter_AAA ($2 in chips)
Seat 3: ggnavarrovaz ($5.65 in chips)
Seat 4: LLregs ($13.19 in chips)
Seat 5: jjuul ($2.08 in chips)
Seat 6: IngeniEbr10 ($2.03 in chips)
Skelter_AAA: posts small blind $0.01
ggnavarrovaz: posts big blind $0.02
*** HOLE CARDS ***
Dealt to LLregs [Ts 6h]
LLregs: folds
jjuul: folds
IngeniEbr10: folds
ZorroZoltan: folds
Skelter_AAA: raises $0.03 to $0.05
ggnavarrovaz: folds
Uncalled bet ($0.03) returned to Skelter_AAA
Skelter_AAA collected $0.04 from pot
Skelter_AAA: doesn't show hand
*** SUMMARY ***
Total pot $0.04 | Rake $0
Seat 1: ZorroZoltan (button) folded before Flop (didn't bet)
Seat 2: Skelter_AAA (small blind) collected ($0.04)
Seat 3: ggnavarrovaz (big blind) folded before Flop
Seat 4: LLregs folded before Flop (didn't bet)
Seat 5: jjuul folded before Flop (didn't bet)
Seat 6: IngeniEbr10 folded before Flop (didn't bet)

PokerStars Zoom Hand #247969377418:  Hold'em No Limit ($0.01/$0.02) - 2023/12/30 22:53:35 WET [2023/12/30 17:53:35 ET]
Table 'Halley' 6-max Seat #1 is the button
Seat 1: 2plateado2 ($2.49 in chips)
Seat 2: roz534 ($3.45 in chips)
Seat 3: Sw4nsan ($2.35 in chips)
Seat 4: LLregs ($13.31 in chips)
Seat 5: KRAVA088 ($1.77 in chips)
Seat 6: santogr893 ($15.22 in chips)
roz534: posts small blind $0.01
Sw4nsan: posts big blind $0.02
*** HOLE CARDS ***
Dealt to LLregs [Qh 9h]
LLregs: folds
KRAVA088: folds
santogr893: calls $0.02
2plateado2: folds
roz534: calls $0.01
Sw4nsan: checks
*** FLOP *** [Jd Ac 7d]
roz534: checks
Sw4nsan: checks
santogr893: bets $0.02
roz534: calls $0.02
Sw4nsan: calls $0.02
*** TURN *** [Jd Ac 7d] [6h]
roz534: checks
Sw4nsan: checks
santogr893: bets $0.10
roz534: folds
Sw4nsan: folds
Uncalled bet ($0.10) returned to santogr893
santogr893 collected $0.12 from pot
santogr893: doesn't show hand
*** SUMMARY ***
Total pot $0.12 | Rake $0
Board [Jd Ac 7d 6h]
Seat 1: 2plateado2 (button) folded before Flop (didn't bet)
Seat 2: roz534 (small blind) folded on the Turn
Seat 3: Sw4nsan (big blind) folded on the Turn
Seat 4: LLregs folded before Flop (didn't bet)
Seat 5: KRAVA088 folded before Flop (didn't bet)
Seat 6: santogr893 collected ($0.12)

PokerStars Zoom Hand #247969406578:  Hold'em No Limit ($0.01/$0.02) - 2023/12/30 22:54:56 WET [2023/12/30 17:54:56 ET]
Table 'Halley' 6-max Seat #1 is the button
Seat 1: psta999 ($3.91 in chips)
Seat 2: anthimoskon ($0.76 in chips)
Seat 3: LLregs ($13.19 in chips)
Seat 4: jbarrios007 ($3.86 in chips)
Seat 5: KMETA86 ($3.99 in chips)
Seat 6: NASUM333+333 ($1.96 in chips)
anthimoskon: posts small blind $0.01
LLregs: posts big blind $0.02
*** HOLE CARDS ***
Dealt to LLregs [9s Kh]
jbarrios007: folds
KMETA86: folds
NASUM333+333: folds
psta999: folds
anthimoskon: folds
Uncalled bet ($0.01) returned to LLregs
LLregs collected $0.02 from pot
LLregs: doesn't show hand
*** SUMMARY ***
Total pot $0.02 | Rake $0
Seat 1: psta999 (button) folded before Flop (didn't bet)
Seat 2: anthimoskon (small blind) folded before Flop
Seat 3: LLregs (big blind) collected ($0.02)
Seat 4: jbarrios007 folded before Flop (didn't bet)
Seat 5: KMETA86 folded before Flop (didn't bet)
Seat 6: NASUM333+333 folded before Flop (didn't bet)

PokerStars Zoom Hand #247969411418:  Hold'em No Limit ($0.01/$0.02) - 2023/12/30 22:55:11 WET [2023/12/30 17:55:11 ET]
Table 'Halley' 6-max Seat #1 is the button
Seat 1: Harold_Seven ($1.49 in chips)
Seat 2: Shmatrixs ($2.01 in chips)
Seat 3: malakat3 ($1.88 in chips)
Seat 4: hybridi ($2 in chips)
Seat 5: LLregs ($13.20 in chips)
Seat 6: flipflop434 ($3.04 in chips)
Shmatrixs: posts small blind $0.01
malakat3: posts big blind $0.02
*** HOLE CARDS ***
Dealt to LLregs [Ks 4d]
hybridi: folds
LLregs: folds
flipflop434: folds
Harold_Seven: folds
Shmatrixs: folds
Uncalled bet ($0.01) returned to malakat3
malakat3 collected $0.02 from pot
malakat3: doesn't show hand
*** SUMMARY ***
Total pot $0.02 | Rake $0
Seat 1: Harold_Seven (button) folded before Flop (didn't bet)
Seat 2: Shmatrixs (small blind) folded before Flop
Seat 3: malakat3 (big blind) collected ($0.02)
Seat 4: hybridi folded before Flop (didn't bet)
Seat 5: LLregs folded before Flop (didn't bet)
Seat 6: flipflop434 folded before Flop (didn't bet)

PokerStars Zoom Hand #247969413292:  Hold'em No Limit ($0.01/$0.02) - 2023/12/30 22:55:18 WET [2023/12/30 17:55:18 ET]
Table 'Halley' 6-max Seat #1 is the button
Seat 1: vimpu ($2.13 in chips)
Seat 2: LLregs ($13.20 in chips)
Seat 3: mcqueen3370 ($1.92 in chips)
Seat 4: ONIPIKA ($2.05 in chips)
Seat 5: abbi555 ($0.76 in chips)
Seat 6: meysar ($3.37 in chips)
LLregs: posts small blind $0.01
mcqueen3370: posts big blind $0.02
*** HOLE CARDS ***
Dealt to LLregs [7c 5s]
ONIPIKA: folds
abbi555: folds
meysar: folds
vimpu: folds
LLregs: raises $0.04 to $0.06
mcqueen3370: folds
Uncalled bet ($0.04) returned to LLregs
LLregs collected $0.04 from pot
LLregs: doesn't show hand
*** SUMMARY ***
Total pot $0.04 | Rake $0
Seat 1: vimpu (button) folded before Flop (didn't bet)
Seat 2: LLregs (small blind) collected ($0.04)
Seat 3: mcqueen3370 (big blind) folded before Flop
Seat 4: ONIPIKA folded before Flop (didn't bet)
Seat 5: abbi555 folded before Flop (didn't bet)
Seat 6: meysar folded before Flop (didn't bet)

PokerStars Zoom Hand #247969405167:  Hold'em No Limit ($0.01/$0.02) - 2023/12/30 22:54:52 WET [2023/12/30 17:54:52 ET]
Table 'Halley' 6-max Seat #1 is the button
Seat 1: Rob Sharona ($2.23 in chips)
Seat 2: coy1e_f1ush ($2.44 in chips)
Seat 3: davidbarrels ($1.95 in chips)
Seat 4: yanico_0308 ($2.10 in chips)
Seat 5: 232489410 ($2.12 in chips)
Seat 6: LLregs ($13.19 in chips)
coy1e_f1ush: posts small blind $0.01
davidbarrels: posts big blind $0.02
*** HOLE CARDS ***
Dealt to LLregs [Ad 6s]
yanico_0308: folds
232489410: folds
LLregs: folds
Rob Sharona: folds
coy1e_f1ush: calls $0.01
davidbarrels: raises $0.06 to $0.08
coy1e_f1ush: calls $0.06
*** FLOP *** [Kc 8c Qs]
coy1e_f1ush: checks
davidbarrels: bets $0.10
coy1e_f1ush: calls $0.10
*** TURN *** [Kc 8c Qs] [7s]
coy1e_f1ush: checks
davidbarrels: checks
*** RIVER *** [Kc 8c Qs 7s] [2c]
coy1e_f1ush: bets $0.18
davidbarrels: calls $0.18
*** SHOW DOWN ***
coy1e_f1ush: shows [Tc Ah] (high card Ace)
davidbarrels: shows [Qh Ac] (a pair of Queens)
davidbarrels collected $0.69 from pot
*** SUMMARY ***
Total pot $0.72 | Rake $0.03
Board [Kc 8c Qs 7s 2c]
Seat 1: Rob Sharona (button) folded before Flop (didn't bet)
Seat 2: coy1e_f1ush (small blind) showed [Tc Ah] and lost with high card Ace
Seat 3: davidbarrels (big blind) showed [Qh Ac] and won ($0.69) with a pair of Queens
Seat 4: yanico_0308 folded before Flop (didn't bet)
Seat 5: 232489410 folded before Flop (didn't bet)
Seat 6: LLregs folded before Flop (didn't bet)

PokerStars Zoom Hand #247969417055:  Hold'em No Limit ($0.01/$0.02) - 2023/12/30 22:55:32 WET [2023/12/30 17:55:32 ET]
Table 'Halley' 6-max Seat #1 is the button
Seat 1: praznina ($2.26 in chips)
Seat 2: abeech94 ($2.97 in chips)
Seat 3: 888lifeIS ($2.17 in chips)
Seat 4: capuuh ($2.24 in chips)
Seat 5: jbarrios007 ($1.15 in chips)
Seat 6: LLregs ($13.22 in chips)
abeech94: posts small blind $0.01
888lifeIS: posts big blind $0.02
*** HOLE CARDS ***
Dealt to LLregs [8h 6s]
capuuh: folds
jbarrios007: folds
LLregs: folds
praznina: folds
abeech94: raises $0.04 to $0.06
888lifeIS: folds
Uncalled bet ($0.04) returned to abeech94
abeech94 collected $0.04 from pot
abeech94: doesn't show hand
*** SUMMARY ***
Total pot $0.04 | Rake $0
Seat 1: praznina (button) folded before Flop (didn't bet)
Seat 2: abeech94 (small blind) collected ($0.04)
Seat 3: 888lifeIS (big blind) folded before Flop
Seat 4: capuuh folded before Flop (didn't bet)
Seat 5: jbarrios007 folded before Flop (didn't bet)
Seat 6: LLregs folded before Flop (didn't bet)

PokerStars Zoom Hand #247969419714:  Hold'em No Limit ($0.01/$0.02) - 2023/12/30 22:55:42 WET [2023/12/30 17:55:42 ET]
Table 'Halley' 6-max Seat #1 is the button
Seat 1: 1976 T ($1.01 in chips)
Seat 2: eektwomice ($2.48 in chips)
Seat 3: CoverXx ($2 in chips)
Seat 4: roz534 ($3.43 in chips)
Seat 5: LLregs ($13.22 in chips)
Seat 6: dogor73 ($1.30 in chips)
eektwomice: posts small blind $0.01
CoverXx: posts big blind $0.02
*** HOLE CARDS ***
Dealt to LLregs [8d 4d]
roz534: folds
LLregs: folds
dogor73: raises $0.02 to $0.04
1976 T: folds
eektwomice: folds
CoverXx: folds
Uncalled bet ($0.02) returned to dogor73
dogor73 collected $0.05 from pot
dogor73: doesn't show hand
*** SUMMARY ***
Total pot $0.05 | Rake $0
Seat 1: 1976 T (button) folded before Flop (didn't bet)
Seat 2: eektwomice (small blind) folded before Flop
Seat 3: CoverXx (big blind) folded before Flop
Seat 4: roz534 folded before Flop (didn't bet)
Seat 5: LLregs folded before Flop (didn't bet)
Seat 6: dogor73 collected ($0.05)

PokerStars Zoom Hand #247969412490:  Hold'em No Limit ($0.01/$0.02) - 2023/12/30 22:55:15 WET [2023/12/30 17:55:15 ET]
Table 'Halley' 6-max Seat #1 is the button
Seat 1: napoli222 ($5.47 in chips)
Seat 2: Paysii ($1.98 in chips)
Seat 3: CoverXx ($2.59 in chips)
Seat 4: LLregs ($13.20 in chips)
Seat 5: abbi555 ($0.76 in chips)
Seat 6: naruhoka ($6.94 in chips)
Paysii: posts small blind $0.01
CoverXx: posts big blind $0.02
*** HOLE CARDS ***
Dealt to LLregs [3c 8d]
LLregs: folds
abbi555: folds
naruhoka: folds
napoli222: folds
Paysii: raises $0.04 to $0.06
CoverXx: calls $0.04
*** FLOP *** [5c 4c 6h]
Paysii: bets $0.04
CoverXx: calls $0.04
*** TURN *** [5c 4c 6h] [2s]
Paysii: checks
CoverXx: checks
*** RIVER *** [5c 4c 6h 2s] [6c]
Paysii: bets $0.14
CoverXx: raises $0.18 to $0.32
Paysii: calls $0.18
*** SHOW DOWN ***
CoverXx: shows [Ah Tc] (a pair of Sixes)
Paysii: shows [Qc Ac] (a flush, Ace high)
Paysii collected $0.81 from pot
*** SUMMARY ***
Total pot $0.84 | Rake $0.03
Board [5c 4c 6h 2s 6c]
Seat 1: napoli222 (button) folded before Flop (didn't bet)
Seat 2: Paysii (small blind) showed [Qc Ac] and won ($0.81) with a flush, Ace high
Seat 3: CoverXx (big blind) showed [Ah Tc] and lost with a pair of Sixes
Seat 4: LLregs folded before Flop (didn't bet)
Seat 5: abbi555 folded before Flop (didn't bet)
Seat 6: naruhoka folded before Flop (didn't bet)

PokerStars Zoom Hand #247969418629:  Hold'em No Limit ($0.01/$0.02) - 2023/12/30 22:55:38 WET [2023/12/30 17:55:38 ET]
Table 'Halley' 6-max Seat #1 is the button
Seat 1: LLregs ($13.22 in chips)
Seat 2: degelcamus ($2.73 in chips)
Seat 3: omutst ($3.43 in chips)
Seat 4: Wahnsinn24 ($1.42 in chips)
Seat 5: STAROVERchik ($2.44 in chips)
Seat 6: florita cruz ($3.28 in chips)
degelcamus: posts small blind $0.01
omutst: posts big blind $0.02
*** HOLE CARDS ***
Dealt to LLregs [6c Tc]
Wahnsinn24: raises $0.02 to $0.04
STAROVERchik: calls $0.04
florita cruz: folds
LLregs: folds
degelcamus: folds
omutst: calls $0.02
*** FLOP *** [Th Ac Jc]
omutst: checks
Wahnsinn24: bets $0.13
STAROVERchik: calls $0.13
omutst: folds
*** TURN *** [Th Ac Jc] [3c]
Wahnsinn24: bets $0.08
STAROVERchik: raises $0.12 to $0.20
Wahnsinn24: calls $0.12
*** RIVER *** [Th Ac Jc 3c] [6h]
Wahnsinn24: bets $0.06
STAROVERchik: raises $2.01 to $2.07 and is all-in
Wahnsinn24: folds
Uncalled bet ($2.01) returned to STAROVERchik
STAROVERchik collected $0.88 from pot
STAROVERchik: doesn't show hand
*** SUMMARY ***
Total pot $0.91 | Rake $0.03
Board [Th Ac Jc 3c 6h]
Seat 1: LLregs (button) folded before Flop (didn't bet)
Seat 2: degelcamus (small blind) folded before Flop
Seat 3: omutst (big blind) folded on the Flop
Seat 4: Wahnsinn24 folded on the River
Seat 5: STAROVERchik collected ($0.88)
Seat 6: florita cruz folded before Flop (didn't bet)

PokerStars Zoom Hand #247969421006:  Hold'em No Limit ($0.01/$0.02) - 2023/12/30 22:55:47 WET [2023/12/30 17:55:47 ET]
Table 'Halley' 6-max Seat #1 is the button
Seat 1: Holding1994 ($2.84 in chips)
Seat 2: Ukr Troll ($2.57 in chips)
Seat 3: abeech94 ($3.85 in chips)
Seat 4: cr@sh test ($4.05 in chips)
Seat 5: LLregs ($13.22 in chips)
Seat 6: sTIKs21 ($2.08 in chips)
Ukr Troll: posts small blind $0.01
abeech94: posts big blind $0.02
*** HOLE CARDS ***
Dealt to LLregs [Jh Kh]
cr@sh test: folds
LLregs: raises $0.04 to $0.06
sTIKs21: folds
Holding1994: folds
Ukr Troll: folds
abeech94: calls $0.04
*** FLOP *** [2c 5s 8s]
abeech94: checks
LLregs: bets $0.04
abeech94: calls $0.04
*** TURN *** [2c 5s 8s] [2d]
abeech94: checks
LLregs: bets $0.07
abeech94: calls $0.07
*** RIVER *** [2c 5s 8s 2d] [5c]
abeech94: checks
LLregs: checks
*** SHOW DOWN ***
abeech94: shows [4s 4d] (two pair, Fives and Fours)
LLregs: mucks hand
abeech94 collected $0.34 from pot
*** SUMMARY ***
Total pot $0.35 | Rake $0.01
Board [2c 5s 8s 2d 5c]
Seat 1: Holding1994 (button) folded before Flop (didn't bet)
Seat 2: Ukr Troll (small blind) folded before Flop
Seat 3: abeech94 (big blind) showed [4s 4d] and won ($0.34) with two pair, Fives and Fours
Seat 4: cr@sh test folded before Flop (didn't bet)
Seat 5: LLregs mucked [Jh Kh]
Seat 6: sTIKs21 folded before Flop (didn't bet)

PokerStars Zoom Hand #247969435971:  Hold'em No Limit ($0.01/$0.02) - 2023/12/30 22:56:42 WET [2023/12/30 17:56:42 ET]
Table 'Halley' 6-max Seat #1 is the button
Seat 1: marcos15vargass ($3.09 in chips)
Seat 2: irina940 ($1.83 in chips)
Seat 3: LLregs ($13.05 in chips)
Seat 4: Gustaveira ($2 in chips)
Seat 5: NASUM333+333 ($2.30 in chips)
Seat 6: malakat3 ($1.94 in chips)
irina940: posts small blind $0.01
LLregs: posts big blind $0.02
*** HOLE CARDS ***
Dealt to LLregs [2c 2s]
Gustaveira: calls $0.02
NASUM333+333: folds
malakat3: folds
marcos15vargass: raises $0.06 to $0.08
irina940: folds
LLregs: calls $0.06
Gustaveira: calls $0.06
*** FLOP *** [4c 7c Th]
LLregs: checks
Gustaveira: checks
marcos15vargass: checks
*** TURN *** [4c 7c Th] [Qh]
LLregs: checks
Gustaveira: bets $0.24
marcos15vargass: folds
LLregs: folds
Uncalled bet ($0.24) returned to Gustaveira
Gustaveira collected $0.24 from pot
Gustaveira: doesn't show hand
*** SUMMARY ***
Total pot $0.25 | Rake $0.01
Board [4c 7c Th Qh]
Seat 1: marcos15vargass (button) folded on the Turn
Seat 2: irina940 (small blind) folded before Flop
Seat 3: LLregs (big blind) folded on the Turn
Seat 4: Gustaveira collected ($0.24)
Seat 5: NASUM333+333 folded before Flop (didn't bet)
Seat 6: malakat3 folded before Flop (didn't bet)

PokerStars Zoom Hand #247969446378:  Hold'em No Limit ($0.01/$0.02) - 2023/12/30 22:57:20 WET [2023/12/30 17:57:20 ET]
Table 'Halley' 6-max Seat #1 is the button
Seat 1: Tha_Saint7 ($3.92 in chips)
Seat 2: LLregs ($12.97 in chips)
Seat 3: rod992 ($1.75 in chips)
Seat 4: BsbFox ($3.02 in chips)
Seat 5: NoDenyPanda ($2.44 in chips)
Seat 6: roz534 ($3.30 in chips)
LLregs: posts small blind $0.01
rod992: posts big blind $0.02
*** HOLE CARDS ***
Dealt to LLregs [9c 6d]
BsbFox: folds
NoDenyPanda: folds
roz534: folds
Tha_Saint7: folds
LLregs: folds
Uncalled bet ($0.01) returned to rod992
rod992 collected $0.02 from pot
rod992: doesn't show hand
*** SUMMARY ***
Total pot $0.02 | Rake $0
Seat 1: Tha_Saint7 (button) folded before Flop (didn't bet)
Seat 2: LLregs (small blind) folded before Flop
Seat 3: rod992 (big blind) collected ($0.02)
Seat 4: BsbFox folded before Flop (didn't bet)
Seat 5: NoDenyPanda folded before Flop (didn't bet)
Seat 6: roz534 folded before Flop (didn't bet)

PokerStars Zoom Hand #247969448804:  Hold'em No Limit ($0.01/$0.02) - 2023/12/30 22:57:29 WET [2023/12/30 17:57:29 ET]
Table 'Halley' 6-max Seat #1 is the button
Seat 1: omutst ($3.83 in chips)
Seat 2: iggyj86 ($2 in chips)
Seat 3: hybridi ($2 in chips)
Seat 4: qw3306 ($2.05 in chips)
Seat 5: tisuwheel ($3.76 in chips)
Seat 6: LLregs ($12.96 in chips)
iggyj86: posts small blind $0.01
hybridi: posts big blind $0.02
*** HOLE CARDS ***
Dealt to LLregs [8s 9h]
qw3306: folds
tisuwheel: folds
LLregs: folds
omutst: raises $0.02 to $0.04
iggyj86: folds
hybridi: folds
Uncalled bet ($0.02) returned to omutst
omutst collected $0.05 from pot
omutst: doesn't show hand
*** SUMMARY ***
Total pot $0.05 | Rake $0
Seat 1: omutst (button) collected ($0.05)
Seat 2: iggyj86 (small blind) folded before Flop
Seat 3: hybridi (big blind) folded before Flop
Seat 4: qw3306 folded before Flop (didn't bet)
Seat 5: tisuwheel folded before Flop (didn't bet)
Seat 6: LLregs folded before Flop (didn't bet)

PokerStars Zoom Hand #247969449625:  Hold'em No Limit ($0.01/$0.02) - 2023/12/30 22:57:32 WET [2023/12/30 17:57:32 ET]
Table 'Halley' 6-max Seat #1 is the button
Seat 1: monkmeleon ($1.98 in chips)
Seat 2: Raymond322 ($3.49 in chips)
Seat 3: ZiggyBoy90 ($6.84 in chips)
Seat 4: LLregs ($12.96 in chips)
Seat 5: conspy84 ($3.18 in chips)
Seat 6: MrMole235 ($2 in chips)
Raymond322: posts small blind $0.01
ZiggyBoy90: posts big blind $0.02
*** HOLE CARDS ***
Dealt to LLregs [Ah Th]
LLregs: raises $0.04 to $0.06
conspy84: folds
MrMole235: folds
monkmeleon: folds
Raymond322: folds
ZiggyBoy90: calls $0.04
*** FLOP *** [Jd 4c 3d]
ZiggyBoy90: checks
LLregs: checks
*** TURN *** [Jd 4c 3d] [Js]
ZiggyBoy90: bets $0.07
LLregs: folds
Uncalled bet ($0.07) returned to ZiggyBoy90
ZiggyBoy90 collected $0.13 from pot
ZiggyBoy90: doesn't show hand
*** SUMMARY ***
Total pot $0.13 | Rake $0
Board [Jd 4c 3d Js]
Seat 1: monkmeleon (button) folded before Flop (didn't bet)
Seat 2: Raymond322 (small blind) folded before Flop
Seat 3: ZiggyBoy90 (big blind) collected ($0.13)
Seat 4: LLregs folded on the Turn
Seat 5: conspy84 folded before Flop (didn't bet)
Seat 6: MrMole235 folded before Flop (didn't bet)

PokerStars Zoom Hand #247969447485:  Hold'em No Limit ($0.01/$0.02) - 2023/12/30 22:57:24 WET [2023/12/30 17:57:24 ET]
Table 'Halley' 6-max Seat #1 is the button
Seat 1: LLregs ($12.96 in chips)
Seat 2: ChessMaster2002 ($2.60 in chips)
Seat 3: Draconiel ($4.60 in chips)
Seat 4: DropIceoleito ($2.69 in chips)
Seat 5: 888lifeIS ($2 in chips)
Seat 6: HarryHaller77 ($2 in chips)
ChessMaster2002: posts small blind $0.01
Draconiel: posts big blind $0.02
*** HOLE CARDS ***
Dealt to LLregs [7h 2h]
DropIceoleito: raises $0.02 to $0.04
888lifeIS: folds
HarryHaller77: folds
LLregs: folds
ChessMaster2002: calls $0.03
Draconiel: calls $0.02
*** FLOP *** [Ac 4h 5c]
ChessMaster2002: checks
Draconiel: checks
DropIceoleito: checks
*** TURN *** [Ac 4h 5c] [Jh]
ChessMaster2002: bets $0.04
Draconiel: calls $0.04
DropIceoleito: folds
*** RIVER *** [Ac 4h 5c Jh] [2d]
ChessMaster2002: bets $0.02
Draconiel: calls $0.02
*** SHOW DOWN ***
ChessMaster2002: shows [8h Ah] (a pair of Aces)
Draconiel: mucks hand
ChessMaster2002 collected $0.23 from pot
*** SUMMARY ***
Total pot $0.24 | Rake $0.01
Board [Ac 4h 5c Jh 2d]
Seat 1: LLregs (button) folded before Flop (didn't bet)
Seat 2: ChessMaster2002 (small blind) showed [8h Ah] and won ($0.23) with a pair of Aces
Seat 3: Draconiel (big blind) mucked [Tc Qs]
Seat 4: DropIceoleito folded on the Turn
Seat 5: 888lifeIS folded before Flop (didn't bet)
Seat 6: HarryHaller77 folded before Flop (didn't bet)

PokerStars Zoom Hand #247969456432:  Hold'em No Limit ($0.01/$0.02) - 2023/12/30 22:57:57 WET [2023/12/30 17:57:57 ET]
Table 'Halley' 6-max Seat #1 is the button
Seat 1: Dinostzi ($1.11 in chips)
Seat 2: jbarrios007 ($4.30 in chips)
Seat 3: LLregs ($12.90 in chips)
Seat 4: Ilikefossil ($2.42 in chips)
Seat 5: praznina ($2.29 in chips)
Seat 6: ilb571 ($3.17 in chips)
jbarrios007: posts small blind $0.01
LLregs: posts big blind $0.02
*** HOLE CARDS ***
Dealt to LLregs [9d Th]
Ilikefossil: raises $0.03 to $0.05
praznina: folds
ilb571: folds
Dinostzi: folds
jbarrios007: folds
LLregs: calls $0.03
*** FLOP *** [6c 8s 3s]
LLregs: checks
Ilikefossil: bets $0.09
LLregs: calls $0.09
*** TURN *** [6c 8s 3s] [4s]
LLregs: checks
Ilikefossil: bets $0.23
LLregs: folds
Uncalled bet ($0.23) returned to Ilikefossil
Ilikefossil collected $0.28 from pot
Ilikefossil: doesn't show hand
*** SUMMARY ***
Total pot $0.29 | Rake $0.01
Board [6c 8s 3s 4s]
Seat 1: Dinostzi (button) folded before Flop (didn't bet)
Seat 2: jbarrios007 (small blind) folded before Flop
Seat 3: LLregs (big blind) folded on the Turn
Seat 4: Ilikefossil collected ($0.28)
Seat 5: praznina folded before Flop (didn't bet)
Seat 6: ilb571 folded before Flop (didn't bet)

PokerStars Zoom Hand #247969466670:  Hold'em No Limit ($0.01/$0.02) - 2023/12/30 22:58:34 WET [2023/12/30 17:58:34 ET]
Table 'Halley' 6-max Seat #1 is the button
Seat 1: Holding1994 ($2.69 in chips)
Seat 2: LLregs ($12.76 in chips)
Seat 3: NASUM333+333 ($2.23 in chips)
Seat 4: hybridi ($3.67 in chips)
Seat 5: TSCardinals ($2.04 in chips)
Seat 6: jbarrios007 ($1.15 in chips)
LLregs: posts small blind $0.01
NASUM333+333: posts big blind $0.02
*** HOLE CARDS ***
Dealt to LLregs [7s Qs]
hybridi: raises $0.04 to $0.06
TSCardinals: calls $0.06
jbarrios007: folds
Holding1994: folds
LLregs: calls $0.05
NASUM333+333: folds
*** FLOP *** [Js 9d 8c]
LLregs: checks
hybridi: checks
TSCardinals: checks
*** TURN *** [Js 9d 8c] [6d]
LLregs: bets $0.04
hybridi: folds
TSCardinals: calls $0.04
*** RIVER *** [Js 9d 8c 6d] [5h]
LLregs: bets $0.21
TSCardinals: folds
Uncalled bet ($0.21) returned to LLregs
LLregs collected $0.27 from pot
LLregs: doesn't show hand
*** SUMMARY ***
Total pot $0.28 | Rake $0.01
Board [Js 9d 8c 6d 5h]
Seat 1: Holding1994 (button) folded before Flop (didn't bet)
Seat 2: LLregs (small blind) collected ($0.27)
Seat 3: NASUM333+333 (big blind) folded before Flop
Seat 4: hybridi folded on the Turn
Seat 5: TSCardinals folded on the River
Seat 6: jbarrios007 folded before Flop (didn't bet)

PokerStars Zoom Hand #247969479510:  Hold'em No Limit ($0.01/$0.02) - 2023/12/30 22:59:21 WET [2023/12/30 17:59:21 ET]
Table 'Halley' 6-max Seat #1 is the button
Seat 1: ONIPIKA ($2.30 in chips)
Seat 2: NASUM333+333 ($2.21 in chips)
Seat 3: IanMacDaddy ($4 in chips)
Seat 4: andre8276 ($3.66 in chips)
Seat 5: ChessMaster2002 ($2.73 in chips)
Seat 6: LLregs ($12.93 in chips)
NASUM333+333: posts small blind $0.01
IanMacDaddy: posts big blind $0.02
*** HOLE CARDS ***
Dealt to LLregs [4s 7d]
andre8276: folds
ChessMaster2002: folds
LLregs: folds
ONIPIKA: raises $0.04 to $0.06
NASUM333+333: folds
IanMacDaddy: folds
Uncalled bet ($0.04) returned to ONIPIKA
ONIPIKA collected $0.05 from pot
ONIPIKA: doesn't show hand
*** SUMMARY ***
Total pot $0.05 | Rake $0
Seat 1: ONIPIKA (button) collected ($0.05)
Seat 2: NASUM333+333 (small blind) folded before Flop
Seat 3: IanMacDaddy (big blind) folded before Flop
Seat 4: andre8276 folded before Flop (didn't bet)
Seat 5: ChessMaster2002 folded before Flop (didn't bet)
Seat 6: LLregs folded before Flop (didn't bet)

PokerStars Zoom Hand #247969603246:  Hold'em No Limit ($0.01/$0.02) - 2023/12/30 23:05:36 WET [2023/12/30 18:05:36 ET]
Table 'Halley' 6-max Seat #1 is the button
Seat 1: klapish ($1.28 in chips)
Seat 2: mataski ($2.15 in chips)
Seat 3: Rikko6688 ($3.32 in chips)
Seat 4: vomhof.F ($2.06 in chips)
Seat 5: LLregs ($12.93 in chips)
Seat 6: 888lifeIS ($2 in chips)
mataski: posts small blind $0.01
Rikko6688: posts big blind $0.02
*** HOLE CARDS ***
Dealt to LLregs [5d 4h]
vomhof.F: folds
LLregs: folds
888lifeIS: folds
klapish: folds
mataski: folds
Uncalled bet ($0.01) returned to Rikko6688
Rikko6688 collected $0.02 from pot
Rikko6688: doesn't show hand
*** SUMMARY ***
Total pot $0.02 | Rake $0
Seat 1: klapish (button) folded before Flop (didn't bet)
Seat 2: mataski (small blind) folded before Flop
Seat 3: Rikko6688 (big blind) collected ($0.02)
Seat 4: vomhof.F folded before Flop (didn't bet)
Seat 5: LLregs folded before Flop (didn't bet)
Seat 6: 888lifeIS folded before Flop (didn't bet)

PokerStars Zoom Hand #247969605027:  Hold'em No Limit ($0.01/$0.02) - 2023/12/30 23:05:41 WET [2023/12/30 18:05:41 ET]
Table 'Halley' 6-max Seat #1 is the button
Seat 1: jwoww56 ($0.41 in chips)
Seat 2: aricast19 ($2 in chips)
Seat 3: cr@sh test ($4.56 in chips)
Seat 4: LLregs ($12.93 in chips)
Seat 5: Mary_D_1973 ($1.94 in chips)
Seat 6: Ilikefossil ($2 in chips)
aricast19: posts small blind $0.01
cr@sh test: posts big blind $0.02
*** HOLE CARDS ***
Dealt to LLregs [2d Js]
LLregs: folds
Mary_D_1973: raises $0.08 to $0.10
Ilikefossil: folds
jwoww56: calls $0.10
aricast19: calls $0.09
cr@sh test: raises $0.40 to $0.50
Mary_D_1973: folds
jwoww56: folds
aricast19: folds
Uncalled bet ($0.40) returned to cr@sh test
cr@sh test collected $0.40 from pot
cr@sh test: doesn't show hand
*** SUMMARY ***
Total pot $0.40 | Rake $0
Seat 1: jwoww56 (button) folded before Flop
Seat 2: aricast19 (small blind) folded before Flop
Seat 3: cr@sh test (big blind) collected ($0.40)
Seat 4: LLregs folded before Flop (didn't bet)
Seat 5: Mary_D_1973 folded before Flop
Seat 6: Ilikefossil folded before Flop (didn't bet)

PokerStars Zoom Hand #247969606073:  Hold'em No Limit ($0.01/$0.02) - 2023/12/30 23:05:44 WET [2023/12/30 18:05:44 ET]
Table 'Halley' 6-max Seat #1 is the button
Seat 1: LLregs ($12.93 in chips)
Seat 2: FEROIZ ($1.79 in chips)
Seat 3: ARES_312 ($2 in chips)
Seat 4: Crisium B ($3 in chips)
Seat 5: Rikko6688 ($3.33 in chips)
Seat 6: DropIceoleito ($4.55 in chips)
FEROIZ: posts small blind $0.01
ARES_312: posts big blind $0.02
*** HOLE CARDS ***
Dealt to LLregs [6s Kh]
Crisium B: folds
Rikko6688: raises $0.04 to $0.06
DropIceoleito: folds
LLregs: folds
FEROIZ: folds
ARES_312: folds
Uncalled bet ($0.04) returned to Rikko6688
Rikko6688 collected $0.05 from pot
Rikko6688: doesn't show hand
*** SUMMARY ***
Total pot $0.05 | Rake $0
Seat 1: LLregs (button) folded before Flop (didn't bet)
Seat 2: FEROIZ (small blind) folded before Flop
Seat 3: ARES_312 (big blind) folded before Flop
Seat 4: Crisium B folded before Flop (didn't bet)
Seat 5: Rikko6688 collected ($0.05)
Seat 6: DropIceoleito folded before Flop (didn't bet)

PokerStars Zoom Hand #247969611327:  Hold'em No Limit ($0.01/$0.02) - 2023/12/30 23:05:59 WET [2023/12/30 18:05:59 ET]
Table 'Halley' 6-max Seat #1 is the button
Seat 1: Compagno26 ($1.98 in chips)
Seat 2: ONIPIKA ($2.01 in chips)
Seat 3: mcqueen3370 ($1.50 in chips)
Seat 4: mataski ($2.14 in chips)
Seat 5: LLregs ($12.93 in chips)
Seat 6: chatmonster026 ($1.98 in chips)
ONIPIKA: posts small blind $0.01
mcqueen3370: posts big blind $0.02
*** HOLE CARDS ***
Dealt to LLregs [Ad 3s]
mataski: folds
LLregs: folds
chatmonster026: folds
Compagno26: folds
ONIPIKA: folds
Uncalled bet ($0.01) returned to mcqueen3370
mcqueen3370 collected $0.02 from pot
mcqueen3370: doesn't show hand
*** SUMMARY ***
Total pot $0.02 | Rake $0
Seat 1: Compagno26 (button) folded before Flop (didn't bet)
Seat 2: ONIPIKA (small blind) folded before Flop
Seat 3: mcqueen3370 (big blind) collected ($0.02)
Seat 4: mataski folded before Flop (didn't bet)
Seat 5: LLregs folded before Flop (didn't bet)
Seat 6: chatmonster026 folded before Flop (didn't bet)

PokerStars Zoom Hand #247969613119:  Hold'em No Limit ($0.01/$0.02) - 2023/12/30 23:06:04 WET [2023/12/30 18:06:04 ET]
Table 'Halley' 6-max Seat #1 is the button
Seat 1: Quantum771 ($2.26 in chips)
Seat 2: igorrocha111 ($1.30 in chips)
Seat 3: LLregs ($12.93 in chips)
Seat 4: jwoww56 ($0.31 in chips)
Seat 5: g0nia ($2 in chips)
Seat 6: abeech94 ($2.60 in chips)
igorrocha111: posts small blind $0.01
LLregs: posts big blind $0.02
*** HOLE CARDS ***
Dealt to LLregs [Ah Ks]
jwoww56: folds
g0nia: folds
abeech94: raises $0.04 to $0.06
Quantum771: calls $0.06
igorrocha111: calls $0.05
LLregs: raises $0.20 to $0.26
abeech94: folds
Quantum771: folds
igorrocha111: folds
Uncalled bet ($0.20) returned to LLregs
LLregs collected $0.24 from pot
LLregs: doesn't show hand
*** SUMMARY ***
Total pot $0.24 | Rake $0
Seat 1: Quantum771 (button) folded before Flop
Seat 2: igorrocha111 (small blind) folded before Flop
Seat 3: LLregs (big blind) collected ($0.24)
Seat 4: jwoww56 folded before Flop (didn't bet)
Seat 5: g0nia folded before Flop (didn't bet)
Seat 6: abeech94 folded before Flop

PokerStars Zoom Hand #247969626609:  Hold'em No Limit ($0.01/$0.02) - 2023/12/30 23:06:42 WET [2023/12/30 18:06:42 ET]
Table 'Halley' 6-max Seat #1 is the button
Seat 1: NoDenyPanda ($3.58 in chips)
Seat 2: LLregs ($13.11 in chips)
Seat 3: Harold_Seven ($2.20 in chips)
Seat 4: Nikand999 ($1.68 in chips)
Seat 5: NASUM333+333 ($2.02 in chips)
Seat 6: bassman526 ($2.13 in chips)
LLregs: posts small blind $0.01
Harold_Seven: posts big blind $0.02
*** HOLE CARDS ***
Dealt to LLregs [8d 7d]
Nikand999: folds
NASUM333+333: folds
bassman526: calls $0.02
NoDenyPanda: folds
LLregs: calls $0.01
Harold_Seven: checks
*** FLOP *** [As Td 9c]
LLregs: checks
Harold_Seven: checks
bassman526: bets $0.04
LLregs: calls $0.04
Harold_Seven: folds
*** TURN *** [As Td 9c] [2d]
LLregs: checks
bassman526: bets $0.04
LLregs: calls $0.04
*** RIVER *** [As Td 9c 2d] [4s]
LLregs: checks
bassman526: checks
*** SHOW DOWN ***
LLregs: shows [8d 7d] (high card Ace)
bassman526: shows [Ad 8c] (a pair of Aces)
bassman526 collected $0.21 from pot
*** SUMMARY ***
Total pot $0.22 | Rake $0.01
Board [As Td 9c 2d 4s]
Seat 1: NoDenyPanda (button) folded before Flop (didn't bet)
Seat 2: LLregs (small blind) showed [8d 7d] and lost with high card Ace
Seat 3: Harold_Seven (big blind) folded on the Flop
Seat 4: Nikand999 folded before Flop (didn't bet)
Seat 5: NASUM333+333 folded before Flop (didn't bet)
Seat 6: bassman526 showed [Ad 8c] and won ($0.21) with a pair of Aces

PokerStars Zoom Hand #247969651304:  Hold'em No Limit ($0.01/$0.02) - 2023/12/30 23:07:52 WET [2023/12/30 18:07:52 ET]
Table 'Halley' 6-max Seat #1 is the button
Seat 1: LLregs ($13.01 in chips)
Seat 2: jamam333 ($4.27 in chips)
Seat 3: ImpEdGard ($3.26 in chips)
Seat 4: boduaco ($1.11 in chips)
Seat 5: bassman526 ($2.24 in chips)
Seat 6: HooliganBasher ($11.57 in chips)
jamam333: posts small blind $0.01
ImpEdGard: posts big blind $0.02
*** HOLE CARDS ***
Dealt to LLregs [Ac Qc]
boduaco: calls $0.02
bassman526: calls $0.02
HooliganBasher: folds
LLregs: raises $0.04 to $0.06
jamam333: folds
ImpEdGard: folds
boduaco: calls $0.04
bassman526: calls $0.04
*** FLOP *** [8s 4d 8c]
boduaco: checks
bassman526: checks
LLregs: checks
*** TURN *** [8s 4d 8c] [Ks]
boduaco: checks
bassman526: checks
LLregs: checks
*** RIVER *** [8s 4d 8c Ks] [4h]
boduaco: bets $0.20
bassman526: folds
LLregs: calls $0.20
*** SHOW DOWN ***
boduaco: shows [6d Kc] (two pair, Kings and Eights)
LLregs: mucks hand
boduaco collected $0.59 from pot
*** SUMMARY ***
Total pot $0.61 | Rake $0.02
Board [8s 4d 8c Ks 4h]
Seat 1: LLregs (button) mucked [Ac Qc]
Seat 2: jamam333 (small blind) folded before Flop
Seat 3: ImpEdGard (big blind) folded before Flop
Seat 4: boduaco showed [6d Kc] and won ($0.59) with two pair, Kings and Eights
Seat 5: bassman526 folded on the River
Seat 6: HooliganBasher folded before Flop (didn't bet)

PokerStars Zoom Hand #247969673322:  Hold'em No Limit ($0.01/$0.02) - 2023/12/30 23:08:55 WET [2023/12/30 18:08:55 ET]
Table 'Halley' 6-max Seat #1 is the button
Seat 1: 5ars33r ($1.39 in chips)
Seat 2: vimpu ($2.03 in chips)
Seat 3: zeroelegante ($15.55 in chips)
Seat 4: TITIRITERO223 ($2.57 in chips)
Seat 5: no1hamster ($2.28 in chips)
Seat 6: LLregs ($12.75 in chips)
vimpu: posts small blind $0.01
zeroelegante: posts big blind $0.02
*** HOLE CARDS ***
Dealt to LLregs [3c As]
TITIRITERO223: raises $0.04 to $0.06
no1hamster: folds
LLregs: folds
5ars33r: folds
vimpu: folds
zeroelegante: folds
Uncalled bet ($0.04) returned to TITIRITERO223
TITIRITERO223 collected $0.05 from pot
TITIRITERO223: doesn't show hand
*** SUMMARY ***
Total pot $0.05 | Rake $0
Seat 1: 5ars33r (button) folded before Flop (didn't bet)
Seat 2: vimpu (small blind) folded before Flop
Seat 3: zeroelegante (big blind) folded before Flop
Seat 4: TITIRITERO223 collected ($0.05)
Seat 5: no1hamster folded before Flop (didn't bet)
Seat 6: LLregs folded before Flop (didn't bet)

PokerStars Zoom Hand #247969674682:  Hold'em No Limit ($0.01/$0.02) - 2023/12/30 23:08:59 WET [2023/12/30 18:08:59 ET]
Table 'Halley' 6-max Seat #1 is the button
Seat 1: Rikko6688 ($3.23 in chips)
Seat 2: 2plateado2 ($4.14 in chips)
Seat 3: ZiggyBoy90 ($3.70 in chips)
Seat 4: LLregs ($12.75 in chips)
Seat 5: Bergländer ($1.56 in chips)
Seat 6: degelcamus ($4.61 in chips)
2plateado2: posts small blind $0.01
ZiggyBoy90: posts big blind $0.02
*** HOLE CARDS ***
Dealt to LLregs [5h Kd]
LLregs: folds
Bergländer: folds
degelcamus: folds
Rikko6688: folds
2plateado2: folds
Uncalled bet ($0.01) returned to ZiggyBoy90
ZiggyBoy90 collected $0.02 from pot
ZiggyBoy90: doesn't show hand
*** SUMMARY ***
Total pot $0.02 | Rake $0
Seat 1: Rikko6688 (button) folded before Flop (didn't bet)
Seat 2: 2plateado2 (small blind) folded before Flop
Seat 3: ZiggyBoy90 (big blind) collected ($0.02)
Seat 4: LLregs folded before Flop (didn't bet)
Seat 5: Bergländer folded before Flop (didn't bet)
Seat 6: degelcamus folded before Flop (didn't bet)

PokerStars Zoom Hand #247969675784:  Hold'em No Limit ($0.01/$0.02) - 2023/12/30 23:09:02 WET [2023/12/30 18:09:02 ET]
Table 'Halley' 6-max Seat #1 is the button
Seat 1: freefrolloff ($3.99 in chips)
Seat 2: shovetoi ($2 in chips)
Seat 3: Nikand999 ($1.45 in chips)
Seat 4: Pedroreidelas ($0.45 in chips)
Seat 5: LLregs ($12.75 in chips)
Seat 6: praznina ($2.16 in chips)
shovetoi: posts small blind $0.01
Nikand999: posts big blind $0.02
*** HOLE CARDS ***
Dealt to LLregs [Kh As]
Pedroreidelas: calls $0.02
LLregs: raises $0.04 to $0.06
praznina: folds
freefrolloff: calls $0.06
shovetoi: folds
Nikand999: folds
Pedroreidelas: calls $0.04
*** FLOP *** [6c Qh 7h]
Pedroreidelas: checks
LLregs: checks
freefrolloff: bets $0.04
Pedroreidelas: calls $0.04
LLregs: calls $0.04
*** TURN *** [6c Qh 7h] [Qc]
Pedroreidelas: checks
LLregs: checks
freefrolloff: bets $0.16
Pedroreidelas: calls $0.16
LLregs: folds
*** RIVER *** [6c Qh 7h Qc] [6d]
Pedroreidelas: bets $0.10
freefrolloff: raises $0.10 to $0.20
Pedroreidelas: folds
Uncalled bet ($0.10) returned to freefrolloff
freefrolloff collected $0.82 from pot
freefrolloff: doesn't show hand
*** SUMMARY ***
Total pot $0.85 | Rake $0.03
Board [6c Qh 7h Qc 6d]
Seat 1: freefrolloff (button) collected ($0.82)
Seat 2: shovetoi (small blind) folded before Flop
Seat 3: Nikand999 (big blind) folded before Flop
Seat 4: Pedroreidelas folded on the River
Seat 5: LLregs folded on the Turn
Seat 6: praznina folded before Flop (didn't bet)

PokerStars Zoom Hand #247969692815:  Hold'em No Limit ($0.01/$0.02) - 2023/12/30 23:09:50 WET [2023/12/30 18:09:50 ET]
Table 'Halley' 6-max Seat #1 is the button
Seat 1: AWiseGuyEh ($2.26 in chips)
Seat 2: Deny0403 ($1.91 in chips)
Seat 3: LLregs ($12.65 in chips)
Seat 4: leonardoobsb ($2.15 in chips)
Seat 5: graves80 ($2.33 in chips)
Seat 6: OLKOG ($0.55 in chips)
Deny0403: posts small blind $0.01
LLregs: posts big blind $0.02
*** HOLE CARDS ***
Dealt to LLregs [Ac 8s]
leonardoobsb: raises $0.02 to $0.04
graves80: folds
OLKOG: calls $0.04
AWiseGuyEh: folds
Deny0403: folds
LLregs: calls $0.02
*** FLOP *** [As 9c Td]
LLregs: checks
leonardoobsb: checks
OLKOG: bets $0.07
LLregs: raises $0.15 to $0.22
leonardoobsb: folds
OLKOG: calls $0.15
*** TURN *** [As 9c Td] [7c]
LLregs: checks
OLKOG: bets $0.29 and is all-in
LLregs: calls $0.29
*** RIVER *** [As 9c Td 7c] [7s]
*** SHOW DOWN ***
LLregs: shows [Ac 8s] (two pair, Aces and Sevens)
OLKOG: shows [9d 8d] (two pair, Nines and Sevens)
LLregs collected $1.11 from pot
*** SUMMARY ***
Total pot $1.15 | Rake $0.04
Board [As 9c Td 7c 7s]
Seat 1: AWiseGuyEh (button) folded before Flop (didn't bet)
Seat 2: Deny0403 (small blind) folded before Flop
Seat 3: LLregs (big blind) showed [Ac 8s] and won ($1.11) with two pair, Aces and Sevens
Seat 4: leonardoobsb folded on the Flop
Seat 5: graves80 folded before Flop (didn't bet)
Seat 6: OLKOG showed [9d 8d] and lost with two pair, Nines and Sevens

PokerStars Zoom Hand #247969707984:  Hold'em No Limit ($0.01/$0.02) - 2023/12/30 23:10:32 WET [2023/12/30 18:10:32 ET]
Table 'Halley' 6-max Seat #1 is the button
Seat 1: jjuul ($1.67 in chips)
Seat 2: LLregs ($13.21 in chips)
Seat 3: Shmatrixs ($2 in chips)
Seat 4: jammylad ($1.80 in chips)
Seat 5: ONIPIKA ($2 in chips)
Seat 6: leonardoobsb ($2.11 in chips)
LLregs: posts small blind $0.01
Shmatrixs: posts big blind $0.02
*** HOLE CARDS ***
Dealt to LLregs [7h 5d]
jammylad: folds
ONIPIKA: folds
leonardoobsb: folds
jjuul: folds
LLregs: raises $0.04 to $0.06
Shmatrixs: raises $0.16 to $0.22
LLregs: folds
Uncalled bet ($0.16) returned to Shmatrixs
Shmatrixs collected $0.12 from pot
Shmatrixs: doesn't show hand
*** SUMMARY ***
Total pot $0.12 | Rake $0
Seat 1: jjuul (button) folded before Flop (didn't bet)
Seat 2: LLregs (small blind) folded before Flop
Seat 3: Shmatrixs (big blind) collected ($0.12)
Seat 4: jammylad folded before Flop (didn't bet)
Seat 5: ONIPIKA folded before Flop (didn't bet)
Seat 6: leonardoobsb folded before Flop (didn't bet)

PokerStars Zoom Hand #247969716758:  Hold'em No Limit ($0.01/$0.02) - 2023/12/30 23:10:57 WET [2023/12/30 18:10:57 ET]
Table 'Halley' 6-max Seat #1 is the button
Seat 1: NoDenyPanda ($2.66 in chips)
Seat 2: Giocrik ($1.94 in chips)
Seat 3: batya1212 ($2.27 in chips)
Seat 4: LLregs ($13.15 in chips)
Seat 5: manoblack51 ($2 in chips)
Seat 6: vomhof.F ($2.02 in chips)
Giocrik: posts small blind $0.01
batya1212: posts big blind $0.02
*** HOLE CARDS ***
Dealt to LLregs [4d 6s]
LLregs: folds
manoblack51: folds
vomhof.F: raises $0.04 to $0.06
NoDenyPanda: folds
Giocrik: calls $0.05
batya1212: folds
*** FLOP *** [Ks 3d 2d]
Giocrik: checks
vomhof.F: bets $0.07
Giocrik: folds
Uncalled bet ($0.07) returned to vomhof.F
vomhof.F collected $0.14 from pot
vomhof.F: doesn't show hand
*** SUMMARY ***
Total pot $0.14 | Rake $0
Board [Ks 3d 2d]
Seat 1: NoDenyPanda (button) folded before Flop (didn't bet)
Seat 2: Giocrik (small blind) folded on the Flop
Seat 3: batya1212 (big blind) folded before Flop
Seat 4: LLregs folded before Flop (didn't bet)
Seat 5: manoblack51 folded before Flop (didn't bet)
Seat 6: vomhof.F collected ($0.14)

PokerStars Zoom Hand #247969720219:  Hold'em No Limit ($0.01/$0.02) - 2023/12/30 23:11:07 WET [2023/12/30 18:11:07 ET]
Table 'Halley' 6-max Seat #1 is the button
Seat 1: LLregs ($13.15 in chips)
Seat 2: bassman526 ($2.42 in chips)
Seat 3: Shturakov ($2.66 in chips)
Seat 4: omutst ($5.54 in chips)
Seat 5: Shmatrixs ($4.82 in chips)
Seat 6: AugereDivus ($2.03 in chips)
bassman526: posts small blind $0.01
Shturakov: posts big blind $0.02
*** HOLE CARDS ***
Dealt to LLregs [Jh Qs]
omutst: raises $0.03 to $0.05
Shmatrixs: folds
AugereDivus: folds
LLregs: calls $0.05
bassman526: calls $0.04
Shturakov: calls $0.03
*** FLOP *** [2d 3c 8c]
bassman526: bets $0.02
Shturakov: folds
omutst: folds
LLregs: calls $0.02
*** TURN *** [2d 3c 8c] [6h]
bassman526: bets $0.04
LLregs: folds
Uncalled bet ($0.04) returned to bassman526
bassman526 collected $0.23 from pot
bassman526: doesn't show hand
*** SUMMARY ***
Total pot $0.24 | Rake $0.01
Board [2d 3c 8c 6h]
Seat 1: LLregs (button) folded on the Turn
Seat 2: bassman526 (small blind) collected ($0.23)
Seat 3: Shturakov (big blind) folded on the Flop
Seat 4: omutst folded on the Flop
Seat 5: Shmatrixs folded before Flop (didn't bet)
Seat 6: AugereDivus folded before Flop (didn't bet)

PokerStars Zoom Hand #247969733269:  Hold'em No Limit ($0.01/$0.02) - 2023/12/30 23:11:44 WET [2023/12/30 18:11:44 ET]
Table 'Halley' 6-max Seat #1 is the button
Seat 1: Crisium B ($3.36 in chips)
Seat 2: shavarun ($1.03 in chips)
Seat 3: Lakatare ($2 in chips)
Seat 4: LLregs ($13.08 in chips)
Seat 5: micro0401 ($2 in chips)
Seat 6: AkulaPS ($1.90 in chips)
shavarun: posts small blind $0.01
Lakatare: posts big blind $0.02
*** HOLE CARDS ***
Dealt to LLregs [6h Qs]
LLregs: folds
micro0401: raises $0.04 to $0.06
AkulaPS: folds
Crisium B: folds
shavarun: folds
Lakatare: folds
Uncalled bet ($0.04) returned to micro0401
micro0401 collected $0.05 from pot
micro0401: doesn't show hand
*** SUMMARY ***
Total pot $0.05 | Rake $0
Seat 1: Crisium B (button) folded before Flop (didn't bet)
Seat 2: shavarun (small blind) folded before Flop
Seat 3: Lakatare (big blind) folded before Flop
Seat 4: LLregs folded before Flop (didn't bet)
Seat 5: micro0401 collected ($0.05)
Seat 6: AkulaPS folded before Flop (didn't bet)

PokerStars Zoom Hand #247969734885:  Hold'em No Limit ($0.01/$0.02) - 2023/12/30 23:11:49 WET [2023/12/30 18:11:49 ET]
Table 'Halley' 6-max Seat #1 is the button
Seat 1: batya1212 ($2.33 in chips)
Seat 2: karagua7 ($0.68 in chips)
Seat 3: LLregs ($13.08 in chips)
Seat 4: Cygnus X1b ($1.99 in chips)
Seat 5: Dinkusbaby37 ($2.34 in chips)
Seat 6: manoblack51 ($2 in chips)
karagua7: posts small blind $0.01
LLregs: posts big blind $0.02
*** HOLE CARDS ***
Dealt to LLregs [As Ad]
Cygnus X1b: raises $0.04 to $0.06
Dinkusbaby37: folds
manoblack51: folds
batya1212: calls $0.06
karagua7: folds
LLregs: raises $0.12 to $0.18
Cygnus X1b: raises $0.22 to $0.40
batya1212: folds
LLregs: raises $12.68 to $13.08 and is all-in
Cygnus X1b: calls $1.59 and is all-in
Uncalled bet ($11.09) returned to LLregs
*** FLOP *** [7d 3c Js]
*** TURN *** [7d 3c Js] [3d]
*** RIVER *** [7d 3c Js 3d] [Jc]
*** SHOW DOWN ***
LLregs: shows [As Ad] (two pair, Aces and Jacks)
Cygnus X1b: shows [Ac Kd] (two pair, Jacks and Threes)
LLregs collected $3.91 from pot
*** SUMMARY ***
Total pot $4.05 | Rake $0.14
Board [7d 3c Js 3d Jc]
Seat 1: batya1212 (button) folded before Flop
Seat 2: karagua7 (small blind) folded before Flop
Seat 3: LLregs (big blind) showed [As Ad] and won ($3.91) with two pair, Aces and Jacks
Seat 4: Cygnus X1b showed [Ac Kd] and lost with two pair, Jacks and Threes
Seat 5: Dinkusbaby37 folded before Flop (didn't bet)
Seat 6: manoblack51 folded before Flop (didn't bet)

PokerStars Zoom Hand #247969747308:  Hold'em No Limit ($0.01/$0.02) - 2023/12/30 23:12:24 WET [2023/12/30 18:12:24 ET]
Table 'Halley' 6-max Seat #1 is the button
Seat 1: aricast19 ($2.38 in chips)
Seat 2: 2plateado2 ($3.94 in chips)
Seat 3: Cygnus X1b ($2 in chips)
Seat 4: 3ener ($2.75 in chips)
Seat 5: Mary_D_1973 ($1.35 in chips)
Seat 6: LLregs ($15 in chips)
2plateado2: posts small blind $0.01
Cygnus X1b: posts big blind $0.02
*** HOLE CARDS ***
Dealt to LLregs [Qs 5h]
3ener: folds
Mary_D_1973: folds
LLregs: folds
aricast19: folds
2plateado2: folds
Uncalled bet ($0.01) returned to Cygnus X1b
Cygnus X1b collected $0.02 from pot
Cygnus X1b: doesn't show hand
*** SUMMARY ***
Total pot $0.02 | Rake $0
Seat 1: aricast19 (button) folded before Flop (didn't bet)
Seat 2: 2plateado2 (small blind) folded before Flop
Seat 3: Cygnus X1b (big blind) collected ($0.02)
Seat 4: 3ener folded before Flop (didn't bet)
Seat 5: Mary_D_1973 folded before Flop (didn't bet)
Seat 6: LLregs folded before Flop (didn't bet)

PokerStars Zoom Hand #247969748686:  Hold'em No Limit ($0.01/$0.02) - 2023/12/30 23:12:28 WET [2023/12/30 18:12:28 ET]
Table 'Halley' 6-max Seat #1 is the button
Seat 1: usmanbutt23 ($1 in chips)
Seat 2: LLregs ($15 in chips)
Seat 3: emopokera ($1.01 in chips)
Seat 4: ChessMaster2002 ($8.40 in chips)
Seat 5: STAROVERchik ($2.99 in chips)
Seat 6: bigrob31988 ($1.04 in chips)
LLregs: posts small blind $0.01
emopokera: posts big blind $0.02
*** HOLE CARDS ***
Dealt to LLregs [Ac 2d]
ChessMaster2002: folds
STAROVERchik: folds
bigrob31988: calls $0.02
usmanbutt23: folds
LLregs: folds
emopokera: checks
*** FLOP *** [Ts Th Jc]
emopokera: checks
bigrob31988: bets $0.02
emopokera: folds
Uncalled bet ($0.02) returned to bigrob31988
bigrob31988 collected $0.05 from pot
bigrob31988: doesn't show hand
*** SUMMARY ***
Total pot $0.05 | Rake $0
Board [Ts Th Jc]
Seat 1: usmanbutt23 (button) folded before Flop (didn't bet)
Seat 2: LLregs (small blind) folded before Flop
Seat 3: emopokera (big blind) folded on the Flop
Seat 4: ChessMaster2002 folded before Flop (didn't bet)
Seat 5: STAROVERchik folded before Flop (didn't bet)
Seat 6: bigrob31988 collected ($0.05)

PokerStars Zoom Hand #247969754726:  Hold'em No Limit ($0.01/$0.02) - 2023/12/30 23:12:45 WET [2023/12/30 18:12:45 ET]
Table 'Halley' 6-max Seat #1 is the button
Seat 1: LLregs ($14.99 in chips)
Seat 2: NoDenyPanda ($3.63 in chips)
Seat 3: Shmatrixs ($4.03 in chips)
Seat 4: farfel99 ($2 in chips)
Seat 5: Lic.Notario ($3.15 in chips)
Seat 6: KV24E ($1.81 in chips)
NoDenyPanda: posts small blind $0.01
Shmatrixs: posts big blind $0.02
*** HOLE CARDS ***
Dealt to LLregs [Kh Jh]
farfel99: calls $0.02
Lic.Notario: calls $0.02
KV24E: raises $0.04 to $0.06
LLregs: calls $0.06
NoDenyPanda: folds
Shmatrixs: folds
farfel99: calls $0.04
Lic.Notario: folds
*** FLOP *** [4c Ks 2h]
farfel99: checks
KV24E: checks
LLregs: bets $0.06
farfel99: calls $0.06
KV24E: calls $0.06
*** TURN *** [4c Ks 2h] [5c]
farfel99: checks
KV24E: bets $0.20
LLregs: calls $0.20
farfel99: calls $0.20
*** RIVER *** [4c Ks 2h 5c] [Js]
farfel99: checks
KV24E: checks
LLregs: bets $1.10
farfel99: folds
KV24E: folds
Uncalled bet ($1.10) returned to LLregs
LLregs collected $0.97 from pot
LLregs: doesn't show hand
*** SUMMARY ***
Total pot $1.01 | Rake $0.04
Board [4c Ks 2h 5c Js]
Seat 1: LLregs (button) collected ($0.97)
Seat 2: NoDenyPanda (small blind) folded before Flop
Seat 3: Shmatrixs (big blind) folded before Flop
Seat 4: farfel99 folded on the River
Seat 5: Lic.Notario folded before Flop
Seat 6: KV24E folded on the River

PokerStars Zoom Hand #247969792668:  Hold'em No Limit ($0.01/$0.02) - 2023/12/30 23:14:32 WET [2023/12/30 18:14:32 ET]
Table 'Halley' 6-max Seat #1 is the button
Seat 1: AugereDivus ($3.86 in chips)
Seat 2: The_Pie83 ($0.92 in chips)
Seat 3: ChessMaster2002 ($8.57 in chips)
Seat 4: Dinostzi ($1.22 in chips)
Seat 5: LLregs ($15.64 in chips)
Seat 6: Dimoni797979 ($3.52 in chips)
The_Pie83: posts small blind $0.01
ChessMaster2002: posts big blind $0.02
*** HOLE CARDS ***
Dealt to LLregs [5d 7s]
Dinostzi: folds
LLregs: folds
Dimoni797979: folds
AugereDivus: folds
The_Pie83: folds
Uncalled bet ($0.01) returned to ChessMaster2002
ChessMaster2002 collected $0.02 from pot
ChessMaster2002: doesn't show hand
*** SUMMARY ***
Total pot $0.02 | Rake $0
Seat 1: AugereDivus (button) folded before Flop (didn't bet)
Seat 2: The_Pie83 (small blind) folded before Flop
Seat 3: ChessMaster2002 (big blind) collected ($0.02)
Seat 4: Dinostzi folded before Flop (didn't bet)
Seat 5: LLregs folded before Flop (didn't bet)
Seat 6: Dimoni797979 folded before Flop (didn't bet)

PokerStars Zoom Hand #247969794368:  Hold'em No Limit ($0.01/$0.02) - 2023/12/30 23:14:37 WET [2023/12/30 18:14:37 ET]
Table 'Halley' 6-max Seat #1 is the button
Seat 1: emopokera ($2.36 in chips)
Seat 2: NoDenyPanda ($2.99 in chips)
Seat 3: Paysii ($2 in chips)
Seat 4: LLregs ($15.64 in chips)
Seat 5: manoblack51 ($2 in chips)
Seat 6: JuanChu070 ($1.94 in chips)
NoDenyPanda: posts small blind $0.01
Paysii: posts big blind $0.02
*** HOLE CARDS ***
Dealt to LLregs [3s Kh]
LLregs: folds
manoblack51: folds
JuanChu070: folds
emopokera: folds
NoDenyPanda: raises $0.04 to $0.06
Paysii: folds
Uncalled bet ($0.04) returned to NoDenyPanda
NoDenyPanda collected $0.04 from pot
NoDenyPanda: doesn't show hand
*** SUMMARY ***
Total pot $0.04 | Rake $0
Seat 1: emopokera (button) folded before Flop (didn't bet)
Seat 2: NoDenyPanda (small blind) collected ($0.04)
Seat 3: Paysii (big blind) folded before Flop
Seat 4: LLregs folded before Flop (didn't bet)
Seat 5: manoblack51 folded before Flop (didn't bet)
Seat 6: JuanChu070 folded before Flop (didn't bet)

PokerStars Zoom Hand #247969799410:  Hold'em No Limit ($0.01/$0.02) - 2023/12/30 23:14:51 WET [2023/12/30 18:14:51 ET]
Table 'Halley' 6-max Seat #1 is the button
Seat 1: Blue_wh4le ($1.71 in chips)
Seat 2: AugereDivus ($3.84 in chips)
Seat 3: Odysseia ($1.61 in chips)
Seat 4: LLregs ($15.64 in chips)
Seat 5: mataski ($2.09 in chips)
Seat 6: ilb571 ($2.65 in chips)
AugereDivus: posts small blind $0.01
Odysseia: posts big blind $0.02
*** HOLE CARDS ***
Dealt to LLregs [5h 5c]
LLregs: raises $0.04 to $0.06
mataski: folds
ilb571: folds
Blue_wh4le: folds
AugereDivus: folds
Odysseia: folds
Uncalled bet ($0.04) returned to LLregs
LLregs collected $0.05 from pot
LLregs: doesn't show hand
*** SUMMARY ***
Total pot $0.05 | Rake $0
Seat 1: Blue_wh4le (button) folded before Flop (didn't bet)
Seat 2: AugereDivus (small blind) folded before Flop
Seat 3: Odysseia (big blind) folded before Flop
Seat 4: LLregs collected ($0.05)
Seat 5: mataski folded before Flop (didn't bet)
Seat 6: ilb571 folded before Flop (didn't bet)

PokerStars Zoom Hand #247969797616:  Hold'em No Limit ($0.01/$0.02) - 2023/12/30 23:14:46 WET [2023/12/30 18:14:46 ET]
Table 'Halley' 6-max Seat #1 is the button
Seat 1: Dinostzi ($1.21 in chips)
Seat 2: xink3r7 ($1.35 in chips)
Seat 3: jamam333 ($5.19 in chips)
Seat 4: ilb571 ($2.65 in chips)
Seat 5: andre8276 ($2 in chips)
Seat 6: LLregs ($15.64 in chips)
xink3r7: posts small blind $0.01
jamam333: posts big blind $0.02
*** HOLE CARDS ***
Dealt to LLregs [Th 6d]
ilb571: folds
andre8276: raises $0.04 to $0.06
LLregs: folds
Dinostzi: folds
xink3r7: calls $0.05
jamam333: folds
*** FLOP *** [8d 3c Ac]
xink3r7: bets $0.02
andre8276: folds
Uncalled bet ($0.02) returned to xink3r7
xink3r7 collected $0.14 from pot
xink3r7: doesn't show hand
*** SUMMARY ***
Total pot $0.14 | Rake $0
Board [8d 3c Ac]
Seat 1: Dinostzi (button) folded before Flop (didn't bet)
Seat 2: xink3r7 (small blind) collected ($0.14)
Seat 3: jamam333 (big blind) folded before Flop
Seat 4: ilb571 folded before Flop (didn't bet)
Seat 5: andre8276 folded on the Flop
Seat 6: LLregs folded before Flop (didn't bet)

PokerStars Zoom Hand #247969802813:  Hold'em No Limit ($0.01/$0.02) - 2023/12/30 23:15:00 WET [2023/12/30 18:15:00 ET]
Table 'Halley' 6-max Seat #1 is the button
Seat 1: ricske68 ($2 in chips)
Seat 2: buakaw1180 ($1.97 in chips)
Seat 3: LLregs ($15.67 in chips)
Seat 4: shavarun ($0.82 in chips)
Seat 5: döuble ägent ($2.89 in chips)
Seat 6: Compagno26 ($1.66 in chips)
buakaw1180: posts small blind $0.01
LLregs: posts big blind $0.02
*** HOLE CARDS ***
Dealt to LLregs [As Ac]
shavarun: raises $0.04 to $0.06
döuble ägent: raises $0.15 to $0.21
Compagno26: folds
ricske68: folds
buakaw1180: calls $0.20
LLregs: raises $15.46 to $15.67 and is all-in
shavarun: calls $0.76 and is all-in
döuble ägent: folds
buakaw1180: calls $1.76 and is all-in
Uncalled bet ($13.70) returned to LLregs
*** FLOP *** [6c 3d 8c]
*** TURN *** [6c 3d 8c] [3s]
*** RIVER *** [6c 3d 8c 3s] [Th]
*** SHOW DOWN ***
buakaw1180: shows [8d 7d] (two pair, Eights and Threes)
LLregs: shows [As Ac] (two pair, Aces and Threes)
LLregs collected $2.22 from side pot
shavarun: shows [Js Ks] (a pair of Threes)
LLregs collected $2.58 from main pot
*** SUMMARY ***
Total pot $4.97 Main pot $2.58. Side pot $2.22. | Rake $0.17
Board [6c 3d 8c 3s Th]
Seat 1: ricske68 (button) folded before Flop (didn't bet)
Seat 2: buakaw1180 (small blind) showed [8d 7d] and lost with two pair, Eights and Threes
Seat 3: LLregs (big blind) showed [As Ac] and won ($4.80) with two pair, Aces and Threes
Seat 4: shavarun showed [Js Ks] and lost with a pair of Threes
Seat 5: döuble ägent folded before Flop
Seat 6: Compagno26 folded before Flop (didn't bet)

PokerStars Zoom Hand #247969815300:  Hold'em No Limit ($0.01/$0.02) - 2023/12/30 23:15:36 WET [2023/12/30 18:15:36 ET]
Table 'Halley' 6-max Seat #1 is the button
Seat 1: IanMacDaddy ($4.76 in chips)
Seat 2: LLregs ($18.50 in chips)
Seat 3: AFB1975 ($2.04 in chips)
Seat 4: Sty7ebuff1 ($1.99 in chips)
Seat 5: micro0401 ($2.06 in chips)
Seat 6: Ilikefossil ($2.06 in chips)
LLregs: posts small blind $0.01
AFB1975: posts big blind $0.02
*** HOLE CARDS ***
Dealt to LLregs [9h Ks]
Sty7ebuff1: folds
micro0401: folds
Ilikefossil: raises $0.03 to $0.05
IanMacDaddy: folds
LLregs: folds
AFB1975: folds
Uncalled bet ($0.03) returned to Ilikefossil
Ilikefossil collected $0.05 from pot
Ilikefossil: doesn't show hand
*** SUMMARY ***
Total pot $0.05 | Rake $0
Seat 1: IanMacDaddy (button) folded before Flop (didn't bet)
Seat 2: LLregs (small blind) folded before Flop
Seat 3: AFB1975 (big blind) folded before Flop
Seat 4: Sty7ebuff1 folded before Flop (didn't bet)
Seat 5: micro0401 folded before Flop (didn't bet)
Seat 6: Ilikefossil collected ($0.05)

PokerStars Zoom Hand #247969826632:  Hold'em No Limit ($0.01/$0.02) - 2023/12/30 23:16:08 WET [2023/12/30 18:16:08 ET]
Table 'Halley' 6-max Seat #1 is the button
Seat 1: TITIRITERO223 ($3.29 in chips)
Seat 2: ricske68 ($2 in chips)
Seat 3: 42Oedipius ($5.24 in chips)
Seat 4: Leka69420 ($2.33 in chips)
Seat 5: LLregs ($18.49 in chips)
Seat 6: greyman34940 ($6.99 in chips)
ricske68: posts small blind $0.01
42Oedipius: posts big blind $0.02
*** HOLE CARDS ***
Dealt to LLregs [4d Qs]
Leka69420: folds
LLregs: folds
greyman34940: folds
TITIRITERO223: folds
ricske68: raises $0.04 to $0.06
42Oedipius: folds
Uncalled bet ($0.04) returned to ricske68
ricske68 collected $0.04 from pot
ricske68: doesn't show hand
*** SUMMARY ***
Total pot $0.04 | Rake $0
Seat 1: TITIRITERO223 (button) folded before Flop (didn't bet)
Seat 2: ricske68 (small blind) collected ($0.04)
Seat 3: 42Oedipius (big blind) folded before Flop
Seat 4: Leka69420 folded before Flop (didn't bet)
Seat 5: LLregs folded before Flop (didn't bet)
Seat 6: greyman34940 folded before Flop (didn't bet)

PokerStars Zoom Hand #247969824176:  Hold'em No Limit ($0.01/$0.02) - 2023/12/30 23:16:01 WET [2023/12/30 18:16:01 ET]
Table 'Halley' 6-max Seat #1 is the button
Seat 1: LLregs ($18.49 in chips)
Seat 2: Fig0uu ($2.07 in chips)
Seat 3: Communist654 ($2.05 in chips)
Seat 4: degelcamus ($3.79 in chips)
Seat 5: Quantum771 ($2.35 in chips)
Seat 6: lewisrevo ($4.52 in chips)
Fig0uu: posts small blind $0.01
Communist654: posts big blind $0.02
*** HOLE CARDS ***
Dealt to LLregs [4c 9s]
degelcamus: folds
Quantum771: raises $0.04 to $0.06
lewisrevo: calls $0.06
LLregs: folds
Fig0uu: folds
Communist654: folds
*** FLOP *** [8c 7d Ah]
Quantum771: checks
lewisrevo: bets $0.07
Quantum771: calls $0.07
*** TURN *** [8c 7d Ah] [4h]
Quantum771: checks
lewisrevo: bets $0.14
Quantum771: calls $0.14
*** RIVER *** [8c 7d Ah 4h] [5c]
Quantum771: checks
lewisrevo: bets $4.25 and is all-in
Quantum771: folds
Uncalled bet ($4.25) returned to lewisrevo
lewisrevo collected $0.55 from pot
lewisrevo: doesn't show hand
*** SUMMARY ***
Total pot $0.57 | Rake $0.02
Board [8c 7d Ah 4h 5c]
Seat 1: LLregs (button) folded before Flop (didn't bet)
Seat 2: Fig0uu (small blind) folded before Flop
Seat 3: Communist654 (big blind) folded before Flop
Seat 4: degelcamus folded before Flop (didn't bet)
Seat 5: Quantum771 folded on the River
Seat 6: lewisrevo collected ($0.55)

PokerStars Zoom Hand #247969836578:  Hold'em No Limit ($0.01/$0.02) - 2023/12/30 23:16:36 WET [2023/12/30 18:16:36 ET]
Table 'Halley' 6-max Seat #1 is the button
Seat 1: Jungl3 Julia ($2.94 in chips)
Seat 2: ChessMaster2002 ($4.66 in chips)
Seat 3: Dinostzi ($1 in chips)
Seat 4: eduardo feijó ($0.99 in chips)
Seat 5: mataski ($3.07 in chips)
Seat 6: LLregs ($18.47 in chips)
ChessMaster2002: posts small blind $0.01
Dinostzi: posts big blind $0.02
*** HOLE CARDS ***
Dealt to LLregs [7c 9d]
eduardo feijó: folds
mataski: folds
LLregs: folds
Jungl3 Julia: folds
ChessMaster2002: raises $0.04 to $0.06
Dinostzi: folds
Uncalled bet ($0.04) returned to ChessMaster2002
ChessMaster2002 collected $0.04 from pot
ChessMaster2002: doesn't show hand
*** SUMMARY ***
Total pot $0.04 | Rake $0
Seat 1: Jungl3 Julia (button) folded before Flop (didn't bet)
Seat 2: ChessMaster2002 (small blind) collected ($0.04)
Seat 3: Dinostzi (big blind) folded before Flop
Seat 4: eduardo feijó folded before Flop (didn't bet)
Seat 5: mataski folded before Flop (didn't bet)
Seat 6: LLregs folded before Flop (didn't bet)

PokerStars Zoom Hand #247969828063:  Hold'em No Limit ($0.01/$0.02) - 2023/12/30 23:16:12 WET [2023/12/30 18:16:12 ET]
Table 'Halley' 6-max Seat #1 is the button
Seat 1: my sapphire ($3.55 in chips)
Seat 2: capuuh ($2.23 in chips)
Seat 3: LLregs ($18.49 in chips)
Seat 4: AkulaPS ($1.76 in chips)
Seat 5: Puma, die ($2.31 in chips)
Seat 6: koukou234551 ($2.16 in chips)
capuuh: posts small blind $0.01
LLregs: posts big blind $0.02
*** HOLE CARDS ***
Dealt to LLregs [Td 5h]
AkulaPS: folds
Puma, die: raises $0.04 to $0.06
koukou234551: calls $0.06
my sapphire: folds
capuuh: folds
LLregs: folds
*** FLOP *** [Ah Ad 9c]
Puma, die: bets $0.07
koukou234551: calls $0.07
*** TURN *** [Ah Ad 9c] [5d]
Puma, die: checks
koukou234551: bets $0.14
Puma, die: folds
Uncalled bet ($0.14) returned to koukou234551
koukou234551 collected $0.28 from pot
koukou234551: doesn't show hand
*** SUMMARY ***
Total pot $0.29 | Rake $0.01
Board [Ah Ad 9c 5d]
Seat 1: my sapphire (button) folded before Flop (didn't bet)
Seat 2: capuuh (small blind) folded before Flop
Seat 3: LLregs (big blind) folded before Flop
Seat 4: AkulaPS folded before Flop (didn't bet)
Seat 5: Puma, die folded on the Turn
Seat 6: koukou234551 collected ($0.28)

PokerStars Zoom Hand #247969846038:  Hold'em No Limit ($0.01/$0.02) - 2023/12/30 23:17:03 WET [2023/12/30 18:17:03 ET]
Table 'Halley' 6-max Seat #1 is the button
Seat 1: cr@sh test ($3.97 in chips)
Seat 2: LLregs ($18.47 in chips)
Seat 3: Compagno26 ($1.44 in chips)
Seat 4: manoblack51 ($2.21 in chips)
Seat 5: enilno rats ($13.52 in chips)
Seat 6: Fig0uu ($2.05 in chips)
LLregs: posts small blind $0.01
Compagno26: posts big blind $0.02
*** HOLE CARDS ***
Dealt to LLregs [As Ad]
manoblack51: folds
enilno rats: folds
Fig0uu: folds
cr@sh test: folds
LLregs: raises $0.04 to $0.06
Compagno26: folds
Uncalled bet ($0.04) returned to LLregs
LLregs collected $0.04 from pot
LLregs: doesn't show hand
*** SUMMARY ***
Total pot $0.04 | Rake $0
Seat 1: cr@sh test (button) folded before Flop (didn't bet)
Seat 2: LLregs (small blind) collected ($0.04)
Seat 3: Compagno26 (big blind) folded before Flop
Seat 4: manoblack51 folded before Flop (didn't bet)
Seat 5: enilno rats folded before Flop (didn't bet)
Seat 6: Fig0uu folded before Flop (didn't bet)

PokerStars Zoom Hand #247969839337:  Hold'em No Limit ($0.01/$0.02) - 2023/12/30 23:16:44 WET [2023/12/30 18:16:44 ET]
Table 'Halley' 6-max Seat #1 is the button
Seat 1: LLregs ($18.47 in chips)
Seat 2: Dimoni797979 ($3.26 in chips)
Seat 3: frankquanki ($2.37 in chips)
Seat 4: leonardoobsb ($2.29 in chips)
Seat 5: micro0401 ($2.08 in chips)
Seat 6: Wahnsinn24 ($1.33 in chips)
Dimoni797979: posts small blind $0.01
frankquanki: posts big blind $0.02
*** HOLE CARDS ***
Dealt to LLregs [8s 5c]
leonardoobsb: raises $0.02 to $0.04
micro0401: folds
Wahnsinn24: folds
LLregs: folds
Dimoni797979: folds
frankquanki: calls $0.02
*** FLOP *** [Jd Qd 4c]
frankquanki: checks
leonardoobsb: bets $0.03
frankquanki: folds
Uncalled bet ($0.03) returned to leonardoobsb
leonardoobsb collected $0.09 from pot
leonardoobsb: doesn't show hand
*** SUMMARY ***
Total pot $0.09 | Rake $0
Board [Jd Qd 4c]
Seat 1: LLregs (button) folded before Flop (didn't bet)
Seat 2: Dimoni797979 (small blind) folded before Flop
Seat 3: frankquanki (big blind) folded on the Flop
Seat 4: leonardoobsb collected ($0.09)
Seat 5: micro0401 folded before Flop (didn't bet)
Seat 6: Wahnsinn24 folded before Flop (didn't bet)

PokerStars Zoom Hand #247969852092:  Hold'em No Limit ($0.01/$0.02) - 2023/12/30 23:17:20 WET [2023/12/30 18:17:20 ET]
Table 'Halley' 6-max Seat #1 is the button
Seat 1: conspy84 ($4.71 in chips)
Seat 2: degelcamus ($2.09 in chips)
Seat 3: 888lifeIS ($2 in chips)
Seat 4: Paysii ($1.98 in chips)
Seat 5: STAROVERchik ($2.96 in chips)
Seat 6: LLregs ($18.49 in chips)
degelcamus: posts small blind $0.01
888lifeIS: posts big blind $0.02
*** HOLE CARDS ***
Dealt to LLregs [Qd 9s]
Paysii: folds
STAROVERchik: raises $0.02 to $0.04
LLregs: folds
conspy84: folds
degelcamus: folds
888lifeIS: folds
Uncalled bet ($0.02) returned to STAROVERchik
STAROVERchik collected $0.05 from pot
STAROVERchik: doesn't show hand
*** SUMMARY ***
Total pot $0.05 | Rake $0
Seat 1: conspy84 (button) folded before Flop (didn't bet)
Seat 2: degelcamus (small blind) folded before Flop
Seat 3: 888lifeIS (big blind) folded before Flop
Seat 4: Paysii folded before Flop (didn't bet)
Seat 5: STAROVERchik collected ($0.05)
Seat 6: LLregs folded before Flop (didn't bet)

PokerStars Zoom Hand #247969854663:  Hold'em No Limit ($0.01/$0.02) - 2023/12/30 23:17:27 WET [2023/12/30 18:17:27 ET]
Table 'Halley' 6-max Seat #1 is the button
Seat 1: rustyrst01 ($2.04 in chips)
Seat 2: SupaGuri ($1.25 in chips)
Seat 3: AugereDivus ($4.04 in chips)
Seat 4: LLregs ($18.49 in chips)
Seat 5: Sty7ebuff1 ($2 in chips)
Seat 6: MrMole235 ($3.33 in chips)
SupaGuri: posts small blind $0.01
AugereDivus: posts big blind $0.02
*** HOLE CARDS ***
Dealt to LLregs [Th 3s]
LLregs: folds
Sty7ebuff1: folds
MrMole235: folds
rustyrst01: folds
SupaGuri: calls $0.01
AugereDivus: checks
*** FLOP *** [Qc 2h Td]
SupaGuri: checks
AugereDivus: bets $0.03
SupaGuri: folds
Uncalled bet ($0.03) returned to AugereDivus
AugereDivus collected $0.04 from pot
AugereDivus: doesn't show hand
*** SUMMARY ***
Total pot $0.04 | Rake $0
Board [Qc 2h Td]
Seat 1: rustyrst01 (button) folded before Flop (didn't bet)
Seat 2: SupaGuri (small blind) folded on the Flop
Seat 3: AugereDivus (big blind) collected ($0.04)
Seat 4: LLregs folded before Flop (didn't bet)
Seat 5: Sty7ebuff1 folded before Flop (didn't bet)
Seat 6: MrMole235 folded before Flop (didn't bet)

PokerStars Zoom Hand #247969855904:  Hold'em No Limit ($0.01/$0.02) - 2023/12/30 23:17:31 WET [2023/12/30 18:17:31 ET]
Table 'Halley' 6-max Seat #1 is the button
Seat 1: Argani619 ($3.58 in chips)
Seat 2: GeRA XG ($1.98 in chips)
Seat 3: Skelter_AAA ($2 in chips)
Seat 4: AugereDivus ($2.01 in chips)
Seat 5: LLregs ($18.49 in chips)
Seat 6: SKOY3631 ($2.16 in chips)
GeRA XG: posts small blind $0.01
Skelter_AAA: posts big blind $0.02
*** HOLE CARDS ***
Dealt to LLregs [Ts 9s]
AugereDivus: folds
LLregs: raises $0.04 to $0.06
SKOY3631: folds
Argani619: folds
GeRA XG: folds
Skelter_AAA: calls $0.04
*** FLOP *** [9h Jd Ks]
Skelter_AAA: checks
LLregs: checks
*** TURN *** [9h Jd Ks] [8d]
Skelter_AAA: checks
LLregs: bets $0.06
Skelter_AAA: calls $0.06
*** RIVER *** [9h Jd Ks 8d] [Ac]
Skelter_AAA: checks
LLregs: checks
*** SHOW DOWN ***
Skelter_AAA: shows [Ah Th] (a pair of Aces)
LLregs: mucks hand
Skelter_AAA collected $0.24 from pot
*** SUMMARY ***
Total pot $0.25 | Rake $0.01
Board [9h Jd Ks 8d Ac]
Seat 1: Argani619 (button) folded before Flop (didn't bet)
Seat 2: GeRA XG (small blind) folded before Flop
Seat 3: Skelter_AAA (big blind) showed [Ah Th] and won ($0.24) with a pair of Aces
Seat 4: AugereDivus folded before Flop (didn't bet)
Seat 5: LLregs mucked [Ts 9s]
Seat 6: SKOY3631 folded before Flop (didn't bet)

PokerStars Zoom Hand #247969849959:  Hold'em No Limit ($0.01/$0.02) - 2023/12/30 23:17:14 WET [2023/12/30 18:17:14 ET]
Table 'Halley' 6-max Seat #1 is the button
Seat 1: omutst ($2.02 in chips)
Seat 2: freefrolloff ($4.32 in chips)
Seat 3: danival2 ($2.89 in chips)
Seat 4: MetalStorm07 ($3.24 in chips)
Seat 5: LLregs ($18.49 in chips)
Seat 6: NoDenyPanda ($3.25 in chips)
freefrolloff: posts small blind $0.01
danival2: posts big blind $0.02
*** HOLE CARDS ***
Dealt to LLregs [7d 4h]
MetalStorm07: folds
LLregs: folds
NoDenyPanda: folds
omutst: raises $0.02 to $0.04
freefrolloff: calls $0.03
danival2: raises $0.16 to $0.20
omutst: folds
freefrolloff: calls $0.16
*** FLOP *** [9s Jh 2h]
freefrolloff: checks
danival2: bets $0.50
freefrolloff: folds
Uncalled bet ($0.50) returned to danival2
danival2 collected $0.42 from pot
danival2: doesn't show hand
*** SUMMARY ***
Total pot $0.44 | Rake $0.02
Board [9s Jh 2h]
Seat 1: omutst (button) folded before Flop
Seat 2: freefrolloff (small blind) folded on the Flop
Seat 3: danival2 (big blind) collected ($0.42)
Seat 4: MetalStorm07 folded before Flop (didn't bet)
Seat 5: LLregs folded before Flop (didn't bet)
Seat 6: NoDenyPanda folded before Flop (didn't bet)

PokerStars Zoom Hand #247969866323:  Hold'em No Limit ($0.01/$0.02) - 2023/12/30 23:18:01 WET [2023/12/30 18:18:01 ET]
Table 'Halley' 6-max Seat #1 is the button
Seat 1: caioaspinelli ($2.20 in chips)
Seat 2: leedsrounder ($2.17 in chips)
Seat 3: LLregs ($18.37 in chips)
Seat 4: Skelter_AAA ($3.59 in chips)
Seat 5: NASUM333+333 ($0.85 in chips)
Seat 6: MacacoRJ ($10.73 in chips)
leedsrounder: posts small blind $0.01
LLregs: posts big blind $0.02
*** HOLE CARDS ***
Dealt to LLregs [Kd 6h]
Skelter_AAA: folds
NASUM333+333: folds
MacacoRJ: folds
caioaspinelli: raises $0.05 to $0.07
leedsrounder: folds
LLregs: folds
Uncalled bet ($0.05) returned to caioaspinelli
caioaspinelli collected $0.05 from pot
caioaspinelli: doesn't show hand
*** SUMMARY ***
Total pot $0.05 | Rake $0
Seat 1: caioaspinelli (button) collected ($0.05)
Seat 2: leedsrounder (small blind) folded before Flop
Seat 3: LLregs (big blind) folded before Flop
Seat 4: Skelter_AAA folded before Flop (didn't bet)
Seat 5: NASUM333+333 folded before Flop (didn't bet)
Seat 6: MacacoRJ folded before Flop (didn't bet)

PokerStars Zoom Hand #247969872614:  Hold'em No Limit ($0.01/$0.02) - 2023/12/30 23:18:19 WET [2023/12/30 18:18:19 ET]
Table 'Halley' 6-max Seat #1 is the button
Seat 1: LLregs ($18.35 in chips)
Seat 2: matzmaron ($1.94 in chips)
Seat 3: HooliganBasher ($2 in chips)
Seat 4: akarickyy ($2.09 in chips)
Seat 5: tisuwheel ($4.54 in chips)
Seat 6: rrociioo ($1.04 in chips)
matzmaron: posts small blind $0.01
HooliganBasher: posts big blind $0.02
*** HOLE CARDS ***
Dealt to LLregs [8h 3d]
akarickyy: folds
tisuwheel: folds
rrociioo: raises $0.03 to $0.05
LLregs: folds
matzmaron: folds
HooliganBasher: raises $0.15 to $0.20
rrociioo: calls $0.15
*** FLOP *** [8d Ts 8c]
HooliganBasher: bets $0.13
rrociioo: calls $0.13
*** TURN *** [8d Ts 8c] [Jd]
HooliganBasher: checks
rrociioo: bets $0.71 and is all-in
HooliganBasher: calls $0.71
*** RIVER *** [8d Ts 8c Jd] [6d]
*** SHOW DOWN ***
HooliganBasher: shows [Kc Qh] (a pair of Eights)
rrociioo: shows [Jh Ah] (two pair, Jacks and Eights)
rrociioo cashed out the hand for $1.39 | Cash Out Fee $0.03
*** SUMMARY ***
Total pot $2.09 | Rake $0.07
Board [8d Ts 8c Jd 6d]
Seat 1: LLregs (button) folded before Flop (didn't bet)
Seat 2: matzmaron (small blind) folded before Flop
Seat 3: HooliganBasher (big blind) showed [Kc Qh] and lost with a pair of Eights
Seat 4: akarickyy folded before Flop (didn't bet)
Seat 5: tisuwheel folded before Flop (didn't bet)
Seat 6: rrociioo showed [Jh Ah] and won ($2.02) with two pair, Jacks and Eights (pot not awarded as player cashed out)

PokerStars Zoom Hand #247969877495:  Hold'em No Limit ($0.01/$0.02) - 2023/12/30 23:18:33 WET [2023/12/30 18:18:33 ET]
Table 'Halley' 6-max Seat #1 is the button
Seat 1: TimiiiGuss ($1.98 in chips)
Seat 2: LLregs ($18.35 in chips)
Seat 3: Carlinko10 ($2.52 in chips)
Seat 4: Jungl3 Julia ($2.89 in chips)
Seat 5: OkadaVictor ($1.88 in chips)
Seat 6: 888lifeIS ($2.13 in chips)
LLregs: posts small blind $0.01
Carlinko10: posts big blind $0.02
*** HOLE CARDS ***
Dealt to LLregs [4c Ac]
Jungl3 Julia: folds
OkadaVictor: folds
888lifeIS: folds
TimiiiGuss: folds
LLregs: raises $0.04 to $0.06
Carlinko10: folds
Uncalled bet ($0.04) returned to LLregs
LLregs collected $0.04 from pot
LLregs: doesn't show hand
*** SUMMARY ***
Total pot $0.04 | Rake $0
Seat 1: TimiiiGuss (button) folded before Flop (didn't bet)
Seat 2: LLregs (small blind) collected ($0.04)
Seat 3: Carlinko10 (big blind) folded before Flop
Seat 4: Jungl3 Julia folded before Flop (didn't bet)
Seat 5: OkadaVictor folded before Flop (didn't bet)
Seat 6: 888lifeIS folded before Flop (didn't bet)

PokerStars Zoom Hand #247969873913:  Hold'em No Limit ($0.01/$0.02) - 2023/12/30 23:18:23 WET [2023/12/30 18:18:23 ET]
Table 'Halley' 6-max Seat #1 is the button
Seat 1: my sapphire ($3.59 in chips)
Seat 2: AugereDivus ($2.48 in chips)
Seat 3: Gomez224 ($2 in chips)
Seat 4: LLregs ($18.35 in chips)
Seat 5: THXforFoldin ($2.13 in chips)
Seat 6: degelcamus ($3.93 in chips)
AugereDivus: posts small blind $0.01
Gomez224: posts big blind $0.02
*** HOLE CARDS ***
Dealt to LLregs [Th Jd]
LLregs: folds
THXforFoldin: raises $0.04 to $0.06
degelcamus: folds
my sapphire: folds
AugereDivus: calls $0.05
Gomez224: raises $0.24 to $0.30
THXforFoldin: raises $0.32 to $0.62
AugereDivus: raises $1.86 to $2.48 and is all-in
Gomez224: folds
THXforFoldin: calls $1.51 and is all-in
Uncalled bet ($0.35) returned to AugereDivus
*** FLOP *** [8h 4s 7s]
*** TURN *** [8h 4s 7s] [7d]
*** RIVER *** [8h 4s 7s 7d] [6c]
*** SHOW DOWN ***
AugereDivus: shows [Ad Kh] (a pair of Sevens)
THXforFoldin: shows [Jh Js] (two pair, Jacks and Sevens)
THXforFoldin collected $4.36 from pot
*** SUMMARY ***
Total pot $4.56 | Rake $0.20
Board [8h 4s 7s 7d 6c]
Seat 1: my sapphire (button) folded before Flop (didn't bet)
Seat 2: AugereDivus (small blind) showed [Ad Kh] and lost with a pair of Sevens
Seat 3: Gomez224 (big blind) folded before Flop
Seat 4: LLregs folded before Flop (didn't bet)
Seat 5: THXforFoldin showed [Jh Js] and won ($4.36) with two pair, Jacks and Sevens
Seat 6: degelcamus folded before Flop (didn't bet)

PokerStars Zoom Hand #247969892428:  Hold'em No Limit ($0.01/$0.02) - 2023/12/30 23:19:16 WET [2023/12/30 18:19:16 ET]
Table 'Halley' 6-max Seat #1 is the button
Seat 1: eduardo feijó ($1.05 in chips)
Seat 2: 3ldickson ($1.29 in chips)
Seat 3: RobynSteel_420 ($2.08 in chips)
Seat 4: capuuh ($4.72 in chips)
Seat 5: LLregs ($18.37 in chips)
Seat 6: flipflop434 ($0.87 in chips)
3ldickson: posts small blind $0.01
RobynSteel_420: posts big blind $0.02
*** HOLE CARDS ***
Dealt to LLregs [Kc Qd]
capuuh: folds
LLregs: raises $0.04 to $0.06
flipflop434: folds
eduardo feijó: folds
3ldickson: folds
RobynSteel_420: folds
Uncalled bet ($0.04) returned to LLregs
LLregs collected $0.05 from pot
LLregs: doesn't show hand
*** SUMMARY ***
Total pot $0.05 | Rake $0
Seat 1: eduardo feijó (button) folded before Flop (didn't bet)
Seat 2: 3ldickson (small blind) folded before Flop
Seat 3: RobynSteel_420 (big blind) folded before Flop
Seat 4: capuuh folded before Flop (didn't bet)
Seat 5: LLregs collected ($0.05)
Seat 6: flipflop434 folded before Flop (didn't bet)

PokerStars Zoom Hand #247969901198:  Hold'em No Limit ($0.01/$0.02) - 2023/12/30 23:19:41 WET [2023/12/30 18:19:41 ET]
Table 'Halley' 6-max Seat #1 is the button
Seat 1: AugereDivus ($2 in chips)
Seat 2: ilb571 ($4.06 in chips)
Seat 3: LLregs ($18.40 in chips)
Seat 4: Argani619 ($3.69 in chips)
Seat 5: sebastiaosj ($0.61 in chips)
Seat 6: 3ldickson ($1.28 in chips)
ilb571: posts small blind $0.01
LLregs: posts big blind $0.02
*** HOLE CARDS ***
Dealt to LLregs [Th 9s]
Argani619: folds
sebastiaosj: folds
3ldickson: folds
AugereDivus: folds
ilb571: folds
Uncalled bet ($0.01) returned to LLregs
LLregs collected $0.02 from pot
LLregs: doesn't show hand
*** SUMMARY ***
Total pot $0.02 | Rake $0
Seat 1: AugereDivus (button) folded before Flop (didn't bet)
Seat 2: ilb571 (small blind) folded before Flop
Seat 3: LLregs (big blind) collected ($0.02)
Seat 4: Argani619 folded before Flop (didn't bet)
Seat 5: sebastiaosj folded before Flop (didn't bet)
Seat 6: 3ldickson folded before Flop (didn't bet)

PokerStars Zoom Hand #247969899774:  Hold'em No Limit ($0.01/$0.02) - 2023/12/30 23:19:37 WET [2023/12/30 18:19:37 ET]
Table 'Halley' 6-max Seat #1 is the button
Seat 1: LLregs ($18.40 in chips)
Seat 2: JuanChu070 ($1.12 in chips)
Seat 3: Southview71 ($2 in chips)
Seat 4: CRAZY KEFKA ($3.16 in chips)
Seat 5: 3ldickson ($1.28 in chips)
Seat 6: manoblack51 ($2.10 in chips)
JuanChu070: posts small blind $0.01
Southview71: posts big blind $0.02
*** HOLE CARDS ***
Dealt to LLregs [Kd 5d]
CRAZY KEFKA: folds
3ldickson: folds
manoblack51: folds
LLregs: folds
JuanChu070: raises $0.04 to $0.06
Southview71: folds
Uncalled bet ($0.04) returned to JuanChu070
JuanChu070 collected $0.04 from pot
JuanChu070: doesn't show hand
*** SUMMARY ***
Total pot $0.04 | Rake $0
Seat 1: LLregs (button) folded before Flop (didn't bet)
Seat 2: JuanChu070 (small blind) collected ($0.04)
Seat 3: Southview71 (big blind) folded before Flop
Seat 4: CRAZY KEFKA folded before Flop (didn't bet)
Seat 5: 3ldickson folded before Flop (didn't bet)
Seat 6: manoblack51 folded before Flop (didn't bet)

PokerStars Zoom Hand #247969904693:  Hold'em No Limit ($0.01/$0.02) - 2023/12/30 23:19:51 WET [2023/12/30 18:19:51 ET]
Table 'Halley' 6-max Seat #1 is the button
Seat 1: 888lifeIS ($2.10 in chips)
Seat 2: cr@sh test ($6.15 in chips)
Seat 3: Tha_Saint7 ($6.13 in chips)
Seat 4: 2plateado2 ($3.92 in chips)
Seat 5: capuuh ($4.45 in chips)
Seat 6: LLregs ($18.41 in chips)
cr@sh test: posts small blind $0.01
Tha_Saint7: posts big blind $0.02
*** HOLE CARDS ***
Dealt to LLregs [Jd Jc]
2plateado2: folds
capuuh: folds
LLregs: raises $0.04 to $0.06
888lifeIS: raises $0.12 to $0.18
cr@sh test: folds
Tha_Saint7: folds
LLregs: calls $0.12
*** FLOP *** [Ts Ad 5h]
LLregs: checks
888lifeIS: checks
*** TURN *** [Ts Ad 5h] [6s]
LLregs: checks
888lifeIS: bets $0.19
LLregs: calls $0.19
*** RIVER *** [Ts Ad 5h 6s] [Th]
LLregs: checks
888lifeIS: bets $0.37
LLregs: folds
Uncalled bet ($0.37) returned to 888lifeIS
888lifeIS collected $0.74 from pot
888lifeIS: doesn't show hand
*** SUMMARY ***
Total pot $0.77 | Rake $0.03
Board [Ts Ad 5h 6s Th]
Seat 1: 888lifeIS (button) collected ($0.74)
Seat 2: cr@sh test (small blind) folded before Flop
Seat 3: Tha_Saint7 (big blind) folded before Flop
Seat 4: 2plateado2 folded before Flop (didn't bet)
Seat 5: capuuh folded before Flop (didn't bet)
Seat 6: LLregs folded on the River

PokerStars Zoom Hand #247969923340:  Hold'em No Limit ($0.01/$0.02) - 2023/12/30 23:20:45 WET [2023/12/30 18:20:45 ET]
Table 'Halley' 6-max Seat #1 is the button
Seat 1: RafkeProost ($3.76 in chips)
Seat 2: r3v3rs3f3r3t ($2.01 in chips)
Seat 3: 3ldickson ($1.21 in chips)
Seat 4: 888lifeIS ($2.12 in chips)
Seat 5: LLregs ($18.03 in chips)
Seat 6: Casinoca$h ($3.67 in chips)
r3v3rs3f3r3t: posts small blind $0.01
3ldickson: posts big blind $0.02
*** HOLE CARDS ***
Dealt to LLregs [Qc 2h]
888lifeIS: folds
LLregs: folds
Casinoca$h: folds
RafkeProost: folds
r3v3rs3f3r3t: folds
Uncalled bet ($0.01) returned to 3ldickson
3ldickson collected $0.02 from pot
3ldickson: doesn't show hand
*** SUMMARY ***
Total pot $0.02 | Rake $0
Seat 1: RafkeProost (button) folded before Flop (didn't bet)
Seat 2: r3v3rs3f3r3t (small blind) folded before Flop
Seat 3: 3ldickson (big blind) collected ($0.02)
Seat 4: 888lifeIS folded before Flop (didn't bet)
Seat 5: LLregs folded before Flop (didn't bet)
Seat 6: Casinoca$h folded before Flop (didn't bet)

PokerStars Zoom Hand #247969920594:  Hold'em No Limit ($0.01/$0.02) - 2023/12/30 23:20:37 WET [2023/12/30 18:20:37 ET]
Table 'Halley' 6-max Seat #1 is the button
Seat 1: conspy84 ($1.84 in chips)
Seat 2: naruhoka ($6.82 in chips)
Seat 3: Southview71 ($1.92 in chips)
Seat 4: F1sh4UrCh1p5 ($2.06 in chips)
Seat 5: Dinostzi ($1.16 in chips)
Seat 6: LLregs ($18.04 in chips)
naruhoka: posts small blind $0.01
Southview71: posts big blind $0.02
*** HOLE CARDS ***
Dealt to LLregs [5d 9d]
F1sh4UrCh1p5: raises $0.04 to $0.06
Dinostzi: folds
LLregs: folds
conspy84: folds
naruhoka: raises $0.16 to $0.22
Southview71: folds
F1sh4UrCh1p5: calls $0.16
*** FLOP *** [6d Qs 5c]
naruhoka: bets $0.15
F1sh4UrCh1p5: calls $0.15
*** TURN *** [6d Qs 5c] [8s]
naruhoka: bets $0.37
F1sh4UrCh1p5: folds
Uncalled bet ($0.37) returned to naruhoka
naruhoka collected $0.72 from pot
naruhoka: doesn't show hand
*** SUMMARY ***
Total pot $0.76 | Rake $0.04
Board [6d Qs 5c 8s]
Seat 1: conspy84 (button) folded before Flop (didn't bet)
Seat 2: naruhoka (small blind) collected ($0.72)
Seat 3: Southview71 (big blind) folded before Flop
Seat 4: F1sh4UrCh1p5 folded on the Turn
Seat 5: Dinostzi folded before Flop (didn't bet)
Seat 6: LLregs folded before Flop (didn't bet)

PokerStars Zoom Hand #247969922283:  Hold'em No Limit ($0.01/$0.02) - 2023/12/30 23:20:42 WET [2023/12/30 18:20:42 ET]
Table 'Halley' 6-max Seat #1 is the button
Seat 1: Quantum771 ($2.10 in chips)
Seat 2: LLregs ($18.04 in chips)
Seat 3: MFanderson ($4.35 in chips)
Seat 4: ItWasDuke ($2 in chips)
Seat 5: Paysii ($2.24 in chips)
Seat 6: pehota1311 ($1.57 in chips)
LLregs: posts small blind $0.01
MFanderson: posts big blind $0.02
*** HOLE CARDS ***
Dealt to LLregs [7c 2h]
ItWasDuke: folds
Paysii: raises $0.03 to $0.05
pehota1311: folds
Quantum771: calls $0.05
LLregs: folds
MFanderson: calls $0.03
*** FLOP *** [9s 2s Ks]
MFanderson: checks
Paysii: bets $0.05
Quantum771: folds
MFanderson: folds
Uncalled bet ($0.05) returned to Paysii
Paysii collected $0.15 from pot
Paysii: doesn't show hand
*** SUMMARY ***
Total pot $0.16 | Rake $0.01
Board [9s 2s Ks]
Seat 1: Quantum771 (button) folded on the Flop
Seat 2: LLregs (small blind) folded before Flop
Seat 3: MFanderson (big blind) folded on the Flop
Seat 4: ItWasDuke folded before Flop (didn't bet)
Seat 5: Paysii collected ($0.15)
Seat 6: pehota1311 folded before Flop (didn't bet)

PokerStars Zoom Hand #247969919747:  Hold'em No Limit ($0.01/$0.02) - 2023/12/30 23:20:34 WET [2023/12/30 18:20:34 ET]
Table 'Halley' 6-max Seat #1 is the button
Seat 1: lemmy2719 ($2.09 in chips)
Seat 2: RobynSteel_420 ($2.06 in chips)
Seat 3: Communist654 ($2.10 in chips)
Seat 4: LLregs ($18.04 in chips)
Seat 5: Deucestr ($2.19 in chips)
Seat 6: batya1212 ($2.10 in chips)
RobynSteel_420: posts small blind $0.01
Communist654: posts big blind $0.02
*** HOLE CARDS ***
Dealt to LLregs [9h Js]
LLregs: folds
Deucestr: folds
batya1212: folds
lemmy2719: folds
RobynSteel_420: raises $0.04 to $0.06
Communist654: calls $0.04
*** FLOP *** [Ks Ad 3h]
RobynSteel_420: bets $0.08
Communist654: calls $0.08
*** TURN *** [Ks Ad 3h] [4h]
RobynSteel_420: bets $0.20
Communist654: calls $0.20
*** RIVER *** [Ks Ad 3h 4h] [6s]
RobynSteel_420: bets $1.72 and is all-in
Communist654: folds
Uncalled bet ($1.72) returned to RobynSteel_420
RobynSteel_420 collected $0.66 from pot
RobynSteel_420: doesn't show hand
*** SUMMARY ***
Total pot $0.68 | Rake $0.02
Board [Ks Ad 3h 4h 6s]
Seat 1: lemmy2719 (button) folded before Flop (didn't bet)
Seat 2: RobynSteel_420 (small blind) collected ($0.66)
Seat 3: Communist654 (big blind) folded on the River
Seat 4: LLregs folded before Flop (didn't bet)
Seat 5: Deucestr folded before Flop (didn't bet)
Seat 6: batya1212 folded before Flop (didn't bet)

PokerStars Zoom Hand #247969924561:  Hold'em No Limit ($0.01/$0.02) - 2023/12/30 23:20:48 WET [2023/12/30 18:20:48 ET]
Table 'Halley' 6-max Seat #1 is the button
Seat 1: mataski ($2.11 in chips)
Seat 2: emopokera ($3.62 in chips)
Seat 3: LLregs ($18.03 in chips)
Seat 4: Xabitpoker ($1.89 in chips)
Seat 5: conspy84 ($4.46 in chips)
Seat 6: Puma, die ($3.28 in chips)
emopokera: posts small blind $0.01
LLregs: posts big blind $0.02
*** HOLE CARDS ***
Dealt to LLregs [5s As]
Xabitpoker: folds
conspy84: folds
Puma, die: folds
mataski: raises $0.02 to $0.04
emopokera: folds
LLregs: calls $0.02
*** FLOP *** [Jh 8d 5d]
LLregs: bets $0.04
mataski: calls $0.04
*** TURN *** [Jh 8d 5d] [6s]
LLregs: checks
mataski: checks
*** RIVER *** [Jh 8d 5d 6s] [Kh]
LLregs: checks
mataski: checks
*** SHOW DOWN ***
LLregs: shows [5s As] (a pair of Fives)
mataski: mucks hand
LLregs collected $0.16 from pot
*** SUMMARY ***
Total pot $0.17 | Rake $0.01
Board [Jh 8d 5d 6s Kh]
Seat 1: mataski (button) mucked [4d Ad]
Seat 2: emopokera (small blind) folded before Flop
Seat 3: LLregs (big blind) showed [5s As] and won ($0.16) with a pair of Fives
Seat 4: Xabitpoker folded before Flop (didn't bet)
Seat 5: conspy84 folded before Flop (didn't bet)
Seat 6: Puma, die folded before Flop (didn't bet)

PokerStars Zoom Hand #247969939076:  Hold'em No Limit ($0.01/$0.02) - 2023/12/30 23:21:29 WET [2023/12/30 18:21:29 ET]
Table 'Halley' 6-max Seat #1 is the button
Seat 1: LLregs ($18.11 in chips)
Seat 2: Sw4nsan ($2.33 in chips)
Seat 3: zeroelegante ($15.16 in chips)
Seat 4: Sty7ebuff1 ($2.09 in chips)
Seat 5: JORDYLEON ($2.09 in chips)
Seat 6: KV24E ($2.29 in chips)
Sw4nsan: posts small blind $0.01
zeroelegante: posts big blind $0.02
*** HOLE CARDS ***
Dealt to LLregs [As 5h]
Sty7ebuff1: folds
JORDYLEON: raises $0.04 to $0.06
KV24E: folds
LLregs: folds
Sw4nsan: folds
zeroelegante: folds
Uncalled bet ($0.04) returned to JORDYLEON
JORDYLEON collected $0.05 from pot
JORDYLEON: doesn't show hand
*** SUMMARY ***
Total pot $0.05 | Rake $0
Seat 1: LLregs (button) folded before Flop (didn't bet)
Seat 2: Sw4nsan (small blind) folded before Flop
Seat 3: zeroelegante (big blind) folded before Flop
Seat 4: Sty7ebuff1 folded before Flop (didn't bet)
Seat 5: JORDYLEON collected ($0.05)
Seat 6: KV24E folded before Flop (didn't bet)

PokerStars Zoom Hand #247969941313:  Hold'em No Limit ($0.01/$0.02) - 2023/12/30 23:21:36 WET [2023/12/30 18:21:36 ET]
Table 'Halley' 6-max Seat #1 is the button
Seat 1: HooliganBasher ($3.44 in chips)
Seat 2: LLregs ($18.11 in chips)
Seat 3: MrMole235 ($2.11 in chips)
Seat 4: Dinkusbaby37 ($2.55 in chips)
Seat 5: POKERSMAN89 ($0.96 in chips)
Seat 6: Pierruet ($1.19 in chips)
LLregs: posts small blind $0.01
MrMole235: posts big blind $0.02
*** HOLE CARDS ***
Dealt to LLregs [9s 5d]
Dinkusbaby37: folds
POKERSMAN89: folds
Pierruet: raises $0.02 to $0.04
HooliganBasher: folds
LLregs: folds
MrMole235: raises $0.12 to $0.16
Pierruet: calls $0.12
*** FLOP *** [2h Td 7h]
MrMole235: bets $0.10
Pierruet: raises $0.10 to $0.20
MrMole235: folds
Uncalled bet ($0.10) returned to Pierruet
Pierruet collected $0.51 from pot
Pierruet: doesn't show hand
*** SUMMARY ***
Total pot $0.53 | Rake $0.02
Board [2h Td 7h]
Seat 1: HooliganBasher (button) folded before Flop (didn't bet)
Seat 2: LLregs (small blind) folded before Flop
Seat 3: MrMole235 (big blind) folded on the Flop
Seat 4: Dinkusbaby37 folded before Flop (didn't bet)
Seat 5: POKERSMAN89 folded before Flop (didn't bet)
Seat 6: Pierruet collected ($0.51)

PokerStars Zoom Hand #247969949960:  Hold'em No Limit ($0.01/$0.02) - 2023/12/30 23:22:00 WET [2023/12/30 18:22:00 ET]
Table 'Halley' 6-max Seat #1 is the button
Seat 1: graves80 ($2 in chips)
Seat 2: Pedroreidelas ($0.35 in chips)
Seat 3: NeckCarp ($1.09 in chips)
Seat 4: Hamodii86 ($3.01 in chips)
Seat 5: Tribun_753 ($1.57 in chips)
Seat 6: LLregs ($18.04 in chips)
Pedroreidelas: posts small blind $0.01
NeckCarp: posts big blind $0.02
*** HOLE CARDS ***
Dealt to LLregs [8s Th]
Hamodii86: raises $0.04 to $0.06
Tribun_753: folds
LLregs: folds
graves80: folds
Pedroreidelas: folds
NeckCarp: folds
Uncalled bet ($0.04) returned to Hamodii86
Hamodii86 collected $0.05 from pot
Hamodii86: doesn't show hand
*** SUMMARY ***
Total pot $0.05 | Rake $0
Seat 1: graves80 (button) folded before Flop (didn't bet)
Seat 2: Pedroreidelas (small blind) folded before Flop
Seat 3: NeckCarp (big blind) folded before Flop
Seat 4: Hamodii86 collected ($0.05)
Seat 5: Tribun_753 folded before Flop (didn't bet)
Seat 6: LLregs folded before Flop (didn't bet)

PokerStars Zoom Hand #247969942857:  Hold'em No Limit ($0.01/$0.02) - 2023/12/30 23:21:41 WET [2023/12/30 18:21:41 ET]
Table 'Halley' 6-max Seat #1 is the button
Seat 1: Triippy ($1.85 in chips)
Seat 2: batya1212 ($2 in chips)
Seat 3: Quantum771 ($2.20 in chips)
Seat 4: LLregs ($18.10 in chips)
Seat 5: 2plateado2 ($4.18 in chips)
Seat 6: AARON2491 ($1.43 in chips)
batya1212: posts small blind $0.01
Quantum771: posts big blind $0.02
*** HOLE CARDS ***
Dealt to LLregs [Ts Tc]
LLregs: raises $0.04 to $0.06
2plateado2: folds
AARON2491: calls $0.06
Triippy: calls $0.06
batya1212: folds
Quantum771: folds
*** FLOP *** [Qh Kd 4s]
LLregs: checks
AARON2491: bets $0.20
Triippy: calls $0.20
LLregs: folds
*** TURN *** [Qh Kd 4s] [3c]
AARON2491: bets $0.59
Triippy: calls $0.59
*** RIVER *** [Qh Kd 4s 3c] [4c]
AARON2491: bets $0.58 and is all-in
Triippy: folds
Uncalled bet ($0.58) returned to AARON2491
AARON2491 collected $1.73 from pot
AARON2491: doesn't show hand
*** SUMMARY ***
Total pot $1.79 | Rake $0.06
Board [Qh Kd 4s 3c 4c]
Seat 1: Triippy (button) folded on the River
Seat 2: batya1212 (small blind) folded before Flop
Seat 3: Quantum771 (big blind) folded before Flop
Seat 4: LLregs folded on the Flop
Seat 5: 2plateado2 folded before Flop (didn't bet)
Seat 6: AARON2491 collected ($1.73)

PokerStars Zoom Hand #247969951465:  Hold'em No Limit ($0.01/$0.02) - 2023/12/30 23:22:04 WET [2023/12/30 18:22:04 ET]
Table 'Halley' 6-max Seat #1 is the button
Seat 1: degelcamus ($6.37 in chips)
Seat 2: GeRA XG ($1.79 in chips)
Seat 3: ilb571 ($2 in chips)
Seat 4: Ninjafuturo123 ($1.86 in chips)
Seat 5: LLregs ($18.04 in chips)
Seat 6: rrociioo ($0.71 in chips)
GeRA XG: posts small blind $0.01
ilb571: posts big blind $0.02
*** HOLE CARDS ***
Dealt to LLregs [Qc Ah]
Ninjafuturo123: folds
LLregs: raises $0.04 to $0.06
rrociioo: folds
degelcamus: folds
GeRA XG: folds
ilb571: calls $0.04
*** FLOP *** [Kd 5s 8c]
ilb571: checks
LLregs: bets $0.04
ilb571: calls $0.04
*** TURN *** [Kd 5s 8c] [Qd]
ilb571: checks
LLregs: checks
*** RIVER *** [Kd 5s 8c Qd] [Jh]
ilb571: checks
LLregs: bets $0.06
ilb571: folds
Uncalled bet ($0.06) returned to LLregs
LLregs collected $0.20 from pot
LLregs: doesn't show hand
*** SUMMARY ***
Total pot $0.21 | Rake $0.01
Board [Kd 5s 8c Qd Jh]
Seat 1: degelcamus (button) folded before Flop (didn't bet)
Seat 2: GeRA XG (small blind) folded before Flop
Seat 3: ilb571 (big blind) folded on the River
Seat 4: Ninjafuturo123 folded before Flop (didn't bet)
Seat 5: LLregs collected ($0.20)
Seat 6: rrociioo folded before Flop (didn't bet)

PokerStars Zoom Hand #247969962636:  Hold'em No Limit ($0.01/$0.02) - 2023/12/30 23:22:37 WET [2023/12/30 18:22:37 ET]
Table 'Halley' 6-max Seat #1 is the button
Seat 1: LLregs ($18.14 in chips)
Seat 2: my sapphire ($4.57 in chips)
Seat 3: Shmatrixs ($4.48 in chips)
Seat 4: xd00 ($1.81 in chips)
Seat 5: JuanChu070 ($2.38 in chips)
Seat 6: MacacoRJ ($10.03 in chips)
my sapphire: posts small blind $0.01
Shmatrixs: posts big blind $0.02
*** HOLE CARDS ***
Dealt to LLregs [6d Jd]
xd00: folds
JuanChu070: folds
MacacoRJ: folds
LLregs: raises $0.04 to $0.06
my sapphire: folds
Shmatrixs: folds
Uncalled bet ($0.04) returned to LLregs
LLregs collected $0.05 from pot
LLregs: doesn't show hand
*** SUMMARY ***
Total pot $0.05 | Rake $0
Seat 1: LLregs (button) collected ($0.05)
Seat 2: my sapphire (small blind) folded before Flop
Seat 3: Shmatrixs (big blind) folded before Flop
Seat 4: xd00 folded before Flop (didn't bet)
Seat 5: JuanChu070 folded before Flop (didn't bet)
Seat 6: MacacoRJ folded before Flop (didn't bet)

PokerStars Zoom Hand #247969966493:  Hold'em No Limit ($0.01/$0.02) - 2023/12/30 23:22:48 WET [2023/12/30 18:22:48 ET]
Table 'Halley' 6-max Seat #1 is the button
Seat 1: ggnavarrovaz ($4.76 in chips)
Seat 2: robbie_cox ($1.59 in chips)
Seat 3: LLregs ($18.17 in chips)
Seat 4: rrociioo ($0.73 in chips)
Seat 5: OuzoMan101 ($1.45 in chips)
Seat 6: Ilikefossil ($2 in chips)
robbie_cox: posts small blind $0.01
LLregs: posts big blind $0.02
*** HOLE CARDS ***
Dealt to LLregs [Kh 8h]
rrociioo: folds
OuzoMan101: folds
Ilikefossil: folds
ggnavarrovaz: calls $0.02
robbie_cox: folds
LLregs: checks
*** FLOP *** [As Td 6c]
LLregs: checks
ggnavarrovaz: checks
*** TURN *** [As Td 6c] [3c]
LLregs: checks
ggnavarrovaz: checks
*** RIVER *** [As Td 6c 3c] [2h]
LLregs: bets $0.02
ggnavarrovaz: folds
Uncalled bet ($0.02) returned to LLregs
LLregs collected $0.05 from pot
LLregs: doesn't show hand
*** SUMMARY ***
Total pot $0.05 | Rake $0
Board [As Td 6c 3c 2h]
Seat 1: ggnavarrovaz (button) folded on the River
Seat 2: robbie_cox (small blind) folded before Flop
Seat 3: LLregs (big blind) collected ($0.05)
Seat 4: rrociioo folded before Flop (didn't bet)
Seat 5: OuzoMan101 folded before Flop (didn't bet)
Seat 6: Ilikefossil folded before Flop (didn't bet)

PokerStars Zoom Hand #247969974884:  Hold'em No Limit ($0.01/$0.02) - 2023/12/30 23:23:12 WET [2023/12/30 18:23:12 ET]
Table 'Halley' 6-max Seat #1 is the button
Seat 1: GFB1941 ($3.66 in chips)
Seat 2: pkrgrl04 ($1.96 in chips)
Seat 3: AugereDivus ($2.32 in chips)
Seat 4: LLregs ($18.19 in chips)
Seat 5: JORDYLEON ($2 in chips)
Seat 6: my sapphire ($2.90 in chips)
pkrgrl04: posts small blind $0.01
AugereDivus: posts big blind $0.02
*** HOLE CARDS ***
Dealt to LLregs [Td 8c]
LLregs: folds
JORDYLEON: folds
my sapphire: folds
GFB1941: folds
pkrgrl04: raises $0.04 to $0.06
AugereDivus: folds
Uncalled bet ($0.04) returned to pkrgrl04
pkrgrl04 collected $0.04 from pot
pkrgrl04: doesn't show hand
*** SUMMARY ***
Total pot $0.04 | Rake $0
Seat 1: GFB1941 (button) folded before Flop (didn't bet)
Seat 2: pkrgrl04 (small blind) collected ($0.04)
Seat 3: AugereDivus (big blind) folded before Flop
Seat 4: LLregs folded before Flop (didn't bet)
Seat 5: JORDYLEON folded before Flop (didn't bet)
Seat 6: my sapphire folded before Flop (didn't bet)

PokerStars Zoom Hand #247969976330:  Hold'em No Limit ($0.01/$0.02) - 2023/12/30 23:23:16 WET [2023/12/30 18:23:16 ET]
Table 'Halley' 6-max Seat #1 is the button
Seat 1: Beskar405 ($2.15 in chips)
Seat 2: lottokahe2 ($0.85 in chips)
Seat 3: my sapphire ($4.69 in chips)
Seat 4: tooloco ($1.17 in chips)
Seat 5: Bily Bo ($2 in chips)
Seat 6: LLregs ($18.19 in chips)
lottokahe2: posts small blind $0.01
my sapphire: posts big blind $0.02
*** HOLE CARDS ***
Dealt to LLregs [2c 2s]
tooloco: folds
Bily Bo: folds
LLregs: folds
Beskar405: folds
lottokahe2: raises $0.02 to $0.04
my sapphire: folds
Uncalled bet ($0.02) returned to lottokahe2
lottokahe2 collected $0.04 from pot
lottokahe2: doesn't show hand
*** SUMMARY ***
Total pot $0.04 | Rake $0
Seat 1: Beskar405 (button) folded before Flop (didn't bet)
Seat 2: lottokahe2 (small blind) collected ($0.04)
Seat 3: my sapphire (big blind) folded before Flop
Seat 4: tooloco folded before Flop (didn't bet)
Seat 5: Bily Bo folded before Flop (didn't bet)
Seat 6: LLregs folded before Flop (didn't bet)

PokerStars Zoom Hand #247969973474:  Hold'em No Limit ($0.01/$0.02) - 2023/12/30 23:23:08 WET [2023/12/30 18:23:08 ET]
Table 'Halley' 6-max Seat #1 is the button
Seat 1: 5ars33r ($1.32 in chips)
Seat 2: LLregs ($18.20 in chips)
Seat 3: Ninjafuturo123 ($1.89 in chips)
Seat 4: Southview71 ($2.14 in chips)
Seat 5: VezzzYN ($0.82 in chips)
Seat 6: ricske68 ($2.37 in chips)
LLregs: posts small blind $0.01
Ninjafuturo123: posts big blind $0.02
*** HOLE CARDS ***
Dealt to LLregs [5d 3s]
Southview71: calls $0.02
VezzzYN: folds
ricske68: folds
5ars33r: folds
LLregs: folds
Ninjafuturo123: checks
*** FLOP *** [6h 4s 3h]
Ninjafuturo123: checks
Southview71: bets $0.03
Ninjafuturo123: calls $0.03
*** TURN *** [6h 4s 3h] [Kd]
Ninjafuturo123: checks
Southview71: checks
*** RIVER *** [6h 4s 3h Kd] [9c]
Ninjafuturo123: checks
Southview71: checks
*** SHOW DOWN ***
Ninjafuturo123: shows [7d 8h] (high card King)
Southview71: shows [Ad 2d] (high card Ace)
Southview71 collected $0.11 from pot
*** SUMMARY ***
Total pot $0.11 | Rake $0
Board [6h 4s 3h Kd 9c]
Seat 1: 5ars33r (button) folded before Flop (didn't bet)
Seat 2: LLregs (small blind) folded before Flop
Seat 3: Ninjafuturo123 (big blind) showed [7d 8h] and lost with high card King
Seat 4: Southview71 showed [Ad 2d] and won ($0.11) with high card Ace
Seat 5: VezzzYN folded before Flop (didn't bet)
Seat 6: ricske68 folded before Flop (didn't bet)

PokerStars Zoom Hand #247969980307:  Hold'em No Limit ($0.01/$0.02) - 2023/12/30 23:23:27 WET [2023/12/30 18:23:27 ET]
Table 'Halley' 6-max Seat #1 is the button
Seat 1: matzmaron ($1.74 in chips)
Seat 2: 232489410 ($4.97 in chips)
Seat 3: MamzerSatlan ($0.99 in chips)
Seat 4: LLregs ($18.19 in chips)
Seat 5: MrMole235 ($3.38 in chips)
Seat 6: Mamirox ($2.24 in chips)
232489410: posts small blind $0.01
MamzerSatlan: posts big blind $0.02
*** HOLE CARDS ***
Dealt to LLregs [2s Js]
LLregs: folds
MrMole235: folds
Mamirox: folds
matzmaron: calls $0.02
232489410: folds
MamzerSatlan: checks
*** FLOP *** [6c Jd Tc]
MamzerSatlan: bets $0.05
matzmaron: calls $0.05
*** TURN *** [6c Jd Tc] [7d]
MamzerSatlan: bets $0.14
matzmaron: folds
Uncalled bet ($0.14) returned to MamzerSatlan
MamzerSatlan collected $0.14 from pot
MamzerSatlan: doesn't show hand
*** SUMMARY ***
Total pot $0.15 | Rake $0.01
Board [6c Jd Tc 7d]
Seat 1: matzmaron (button) folded on the Turn
Seat 2: 232489410 (small blind) folded before Flop
Seat 3: MamzerSatlan (big blind) collected ($0.14)
Seat 4: LLregs folded before Flop (didn't bet)
Seat 5: MrMole235 folded before Flop (didn't bet)
Seat 6: Mamirox folded before Flop (didn't bet)

PokerStars Zoom Hand #247969981484:  Hold'em No Limit ($0.01/$0.02) - 2023/12/30 23:23:31 WET [2023/12/30 18:23:31 ET]
Table 'Halley' 6-max Seat #1 is the button
Seat 1: karagua7 ($1.09 in chips)
Seat 2: el pulento ($2.06 in chips)
Seat 3: LLregs ($18.19 in chips)
Seat 4: ItWasDuke ($2.03 in chips)
Seat 5: Fig0uu ($1.99 in chips)
Seat 6: Gambleatze ($0.88 in chips)
el pulento: posts small blind $0.01
LLregs: posts big blind $0.02
*** HOLE CARDS ***
Dealt to LLregs [7h 3d]
ItWasDuke: folds
Fig0uu: raises $0.04 to $0.06
Gambleatze: folds
karagua7: folds
el pulento: folds
LLregs: folds
Uncalled bet ($0.04) returned to Fig0uu
Fig0uu collected $0.05 from pot
Fig0uu: doesn't show hand
*** SUMMARY ***
Total pot $0.05 | Rake $0
Seat 1: karagua7 (button) folded before Flop (didn't bet)
Seat 2: el pulento (small blind) folded before Flop
Seat 3: LLregs (big blind) folded before Flop
Seat 4: ItWasDuke folded before Flop (didn't bet)
Seat 5: Fig0uu collected ($0.05)
Seat 6: Gambleatze folded before Flop (didn't bet)

PokerStars Zoom Hand #247969989711:  Hold'em No Limit ($0.01/$0.02) - 2023/12/30 23:23:54 WET [2023/12/30 18:23:54 ET]
Table 'Halley' 6-max Seat #1 is the button
Seat 1: lottokahe2 ($0.88 in chips)
Seat 2: LLregs ($18.17 in chips)
Seat 3: matzmaron ($1.66 in chips)
Seat 4: TimiiiGuss ($3.71 in chips)
Seat 5: abbi555 ($3.58 in chips)
Seat 6: ChessMaster2002 ($2.46 in chips)
LLregs: posts small blind $0.01
matzmaron: posts big blind $0.02
*** HOLE CARDS ***
Dealt to LLregs [8h Ac]
TimiiiGuss: folds
abbi555: folds
ChessMaster2002: folds
lottokahe2: folds
LLregs: raises $0.06 to $0.08
matzmaron: folds
Uncalled bet ($0.06) returned to LLregs
LLregs collected $0.04 from pot
LLregs: doesn't show hand
*** SUMMARY ***
Total pot $0.04 | Rake $0
Seat 1: lottokahe2 (button) folded before Flop (didn't bet)
Seat 2: LLregs (small blind) collected ($0.04)
Seat 3: matzmaron (big blind) folded before Flop
Seat 4: TimiiiGuss folded before Flop (didn't bet)
Seat 5: abbi555 folded before Flop (didn't bet)
Seat 6: ChessMaster2002 folded before Flop (didn't bet)

PokerStars Zoom Hand #247969997345:  Hold'em No Limit ($0.01/$0.02) - 2023/12/30 23:24:16 WET [2023/12/30 18:24:16 ET]
Table 'Halley' 6-max Seat #1 is the button
Seat 1: Hamodii86 ($2.97 in chips)
Seat 2: my sapphire ($4.49 in chips)
Seat 3: vomhof.F ($2.05 in chips)
Seat 4: mataski ($2.02 in chips)
Seat 5: JORDYLEON ($3.42 in chips)
Seat 6: LLregs ($18.19 in chips)
my sapphire: posts small blind $0.01
vomhof.F: posts big blind $0.02
*** HOLE CARDS ***
Dealt to LLregs [7s Qh]
mataski: folds
JORDYLEON: folds
LLregs: folds
Hamodii86: folds
my sapphire: folds
Uncalled bet ($0.01) returned to vomhof.F
vomhof.F collected $0.02 from pot
vomhof.F: doesn't show hand
*** SUMMARY ***
Total pot $0.02 | Rake $0
Seat 1: Hamodii86 (button) folded before Flop (didn't bet)
Seat 2: my sapphire (small blind) folded before Flop
Seat 3: vomhof.F (big blind) collected ($0.02)
Seat 4: mataski folded before Flop (didn't bet)
Seat 5: JORDYLEON folded before Flop (didn't bet)
Seat 6: LLregs folded before Flop (didn't bet)

PokerStars Zoom Hand #247969977626:  Hold'em No Limit ($0.01/$0.02) - 2023/12/30 23:23:20 WET [2023/12/30 18:23:20 ET]
Table 'Halley' 6-max Seat #1 is the button
Seat 1: DMPK1 ($1.95 in chips)
Seat 2: virojoto ($1.07 in chips)
Seat 3: pedroph3ks ($2.64 in chips)
Seat 4: Doragon38 ($1.51 in chips)
Seat 5: LLregs ($18.19 in chips)
Seat 6: Beskar405 ($2.15 in chips)
virojoto: posts small blind $0.01
pedroph3ks: posts big blind $0.02
*** HOLE CARDS ***
Dealt to LLregs [Jh Qd]
Doragon38: raises $0.02 to $0.04
LLregs: folds
Beskar405: raises $0.08 to $0.12
DMPK1: calls $0.12
virojoto: folds
pedroph3ks: folds
Doragon38: folds
*** FLOP *** [Kh 6c Jc]
Beskar405: checks
DMPK1: checks
*** TURN *** [Kh 6c Jc] [5d]
Beskar405: checks
DMPK1: checks
*** RIVER *** [Kh 6c Jc 5d] [3d]
Beskar405: checks
DMPK1: checks
*** SHOW DOWN ***
Beskar405: shows [8h Ah] (high card Ace)
DMPK1: mucks hand
Beskar405 collected $0.30 from pot
*** SUMMARY ***
Total pot $0.31 | Rake $0.01
Board [Kh 6c Jc 5d 3d]
Seat 1: DMPK1 (button) mucked [2s Ts]
Seat 2: virojoto (small blind) folded before Flop
Seat 3: pedroph3ks (big blind) folded before Flop
Seat 4: Doragon38 folded before Flop
Seat 5: LLregs folded before Flop (didn't bet)
Seat 6: Beskar405 showed [8h Ah] and won ($0.30) with high card Ace

PokerStars Zoom Hand #247969988539:  Hold'em No Limit ($0.01/$0.02) - 2023/12/30 23:23:51 WET [2023/12/30 18:23:51 ET]
Table 'Halley' 6-max Seat #1 is the button
Seat 1: LLregs ($18.17 in chips)
Seat 2: ChessMaster2002 ($2.47 in chips)
Seat 3: conspy84 ($2.46 in chips)
Seat 4: manoblack51 ($2 in chips)
Seat 5: el pulento ($2.05 in chips)
Seat 6: 2plateado2 ($5.07 in chips)
ChessMaster2002: posts small blind $0.01
conspy84: posts big blind $0.02
*** HOLE CARDS ***
Dealt to LLregs [8c 7d]
manoblack51: raises $0.03 to $0.05
el pulento: calls $0.05
2plateado2: folds
LLregs: folds
ChessMaster2002: folds
conspy84: folds
*** FLOP *** [9s 9c Jd]
manoblack51: checks
el pulento: checks
*** TURN *** [9s 9c Jd] [Tc]
manoblack51: checks
el pulento: bets $0.13
manoblack51: calls $0.13
*** RIVER *** [9s 9c Jd Tc] [2s]
manoblack51: checks
el pulento: checks
*** SHOW DOWN ***
manoblack51: shows [Ah Jh] (two pair, Jacks and Nines)
el pulento: mucks hand
manoblack51 collected $0.38 from pot
*** SUMMARY ***
Total pot $0.39 | Rake $0.01
Board [9s 9c Jd Tc 2s]
Seat 1: LLregs (button) folded before Flop (didn't bet)
Seat 2: ChessMaster2002 (small blind) folded before Flop
Seat 3: conspy84 (big blind) folded before Flop
Seat 4: manoblack51 showed [Ah Jh] and won ($0.38) with two pair, Jacks and Nines
Seat 5: el pulento mucked [As Td]
Seat 6: 2plateado2 folded before Flop (didn't bet)

PokerStars Zoom Hand #247969999114:  Hold'em No Limit ($0.01/$0.02) - 2023/12/30 23:24:21 WET [2023/12/30 18:24:21 ET]
Table 'Halley' 6-max Seat #1 is the button
Seat 1: enilno rats ($12.06 in chips)
Seat 2: TONILUCCE ($2.69 in chips)
Seat 3: NineHi72 ($16.33 in chips)
Seat 4: LLregs ($18.19 in chips)
Seat 5: Blue_wh4le ($2.02 in chips)
Seat 6: ilb571 ($2.03 in chips)
TONILUCCE: posts small blind $0.01
NineHi72: posts big blind $0.02
*** HOLE CARDS ***
Dealt to LLregs [4s 6d]
LLregs: folds
Blue_wh4le: raises $0.08 to $0.10
ilb571: folds
enilno rats: folds
TONILUCCE: folds
NineHi72: folds
Uncalled bet ($0.08) returned to Blue_wh4le
Blue_wh4le collected $0.05 from pot
Blue_wh4le: doesn't show hand
*** SUMMARY ***
Total pot $0.05 | Rake $0
Seat 1: enilno rats (button) folded before Flop (didn't bet)
Seat 2: TONILUCCE (small blind) folded before Flop
Seat 3: NineHi72 (big blind) folded before Flop
Seat 4: LLregs folded before Flop (didn't bet)
Seat 5: Blue_wh4le collected ($0.05)
Seat 6: ilb571 folded before Flop (didn't bet)

PokerStars Zoom Hand #247970000520:  Hold'em No Limit ($0.01/$0.02) - 2023/12/30 23:24:25 WET [2023/12/30 18:24:25 ET]
Table 'Halley' 6-max Seat #1 is the button
Seat 1: gamma720 ($1.73 in chips)
Seat 2: Quorthon_Zei ($2 in chips)
Seat 3: LLregs ($18.19 in chips)
Seat 4: Hamodii86 ($2.97 in chips)
Seat 5: Sty7ebuff1 ($2.33 in chips)
Seat 6: pedroph3ks ($3.32 in chips)
Quorthon_Zei: posts small blind $0.01
LLregs: posts big blind $0.02
*** HOLE CARDS ***
Dealt to LLregs [6d Kd]
Hamodii86: folds
Sty7ebuff1: raises $0.04 to $0.06
pedroph3ks: folds
gamma720: folds
Quorthon_Zei: folds
LLregs: calls $0.04
*** FLOP *** [5d 3h Th]
LLregs: checks
Sty7ebuff1: bets $0.04
LLregs: calls $0.04
*** TURN *** [5d 3h Th] [2d]
LLregs: checks
Sty7ebuff1: bets $0.07
LLregs: calls $0.07
*** RIVER *** [5d 3h Th 2d] [5h]
LLregs: checks
Sty7ebuff1: checks
*** SHOW DOWN ***
LLregs: shows [6d Kd] (a pair of Fives)
Sty7ebuff1: shows [As Qc] (a pair of Fives - Ace kicker)
Sty7ebuff1 collected $0.34 from pot
*** SUMMARY ***
Total pot $0.35 | Rake $0.01
Board [5d 3h Th 2d 5h]
Seat 1: gamma720 (button) folded before Flop (didn't bet)
Seat 2: Quorthon_Zei (small blind) folded before Flop
Seat 3: LLregs (big blind) showed [6d Kd] and lost with a pair of Fives
Seat 4: Hamodii86 folded before Flop (didn't bet)
Seat 5: Sty7ebuff1 showed [As Qc] and won ($0.34) with a pair of Fives
Seat 6: pedroph3ks folded before Flop (didn't bet)

PokerStars Zoom Hand #247970025408:  Hold'em No Limit ($0.01/$0.02) - 2023/12/30 23:25:37 WET [2023/12/30 18:25:37 ET]
Table 'Halley' 6-max Seat #1 is the button
Seat 1: GarotoMaroto#1 ($0.97 in chips)
Seat 2: tooloco ($1.02 in chips)
Seat 3: caioaspinelli ($2.27 in chips)
Seat 4: omutst ($3.29 in chips)
Seat 5: LLregs ($18.02 in chips)
Seat 6: dogor73 ($2.61 in chips)
tooloco: posts small blind $0.01
caioaspinelli: posts big blind $0.02
*** HOLE CARDS ***
Dealt to LLregs [Qh 4h]
omutst: folds
LLregs: folds
dogor73: folds
GarotoMaroto#1: folds
tooloco: folds
Uncalled bet ($0.01) returned to caioaspinelli
caioaspinelli collected $0.02 from pot
caioaspinelli: doesn't show hand
*** SUMMARY ***
Total pot $0.02 | Rake $0
Seat 1: GarotoMaroto#1 (button) folded before Flop (didn't bet)
Seat 2: tooloco (small blind) folded before Flop
Seat 3: caioaspinelli (big blind) collected ($0.02)
Seat 4: omutst folded before Flop (didn't bet)
Seat 5: LLregs folded before Flop (didn't bet)
Seat 6: dogor73 folded before Flop (didn't bet)

PokerStars Zoom Hand #247970023328:  Hold'em No Limit ($0.01/$0.02) - 2023/12/30 23:25:31 WET [2023/12/30 18:25:31 ET]
Table 'Halley' 6-max Seat #1 is the button
Seat 1: LLregs ($18.02 in chips)
Seat 2: r3v3rs3f3r3t ($2.09 in chips)
Seat 3: emopokera ($7.77 in chips)
Seat 4: Leka69420 ($2.29 in chips)
Seat 5: ChessMaster2002 ($6.50 in chips)
Seat 6: g0nia ($2.31 in chips)
r3v3rs3f3r3t: posts small blind $0.01
emopokera: posts big blind $0.02
*** HOLE CARDS ***
Dealt to LLregs [2h Ad]
Leka69420: raises $0.04 to $0.06
ChessMaster2002: folds
g0nia: folds
LLregs: folds
r3v3rs3f3r3t: folds
emopokera: folds
Uncalled bet ($0.04) returned to Leka69420
Leka69420 collected $0.05 from pot
Leka69420: doesn't show hand
*** SUMMARY ***
Total pot $0.05 | Rake $0
Seat 1: LLregs (button) folded before Flop (didn't bet)
Seat 2: r3v3rs3f3r3t (small blind) folded before Flop
Seat 3: emopokera (big blind) folded before Flop
Seat 4: Leka69420 collected ($0.05)
Seat 5: ChessMaster2002 folded before Flop (didn't bet)
Seat 6: g0nia folded before Flop (didn't bet)

PokerStars Zoom Hand #247970028846:  Hold'em No Limit ($0.01/$0.02) - 2023/12/30 23:25:47 WET [2023/12/30 18:25:47 ET]
Table 'Halley' 6-max Seat #1 is the button
Seat 1: caioaspinelli ($2.28 in chips)
Seat 2: FEROIZ ($1.92 in chips)
Seat 3: NASUM333+333 ($2.15 in chips)
Seat 4: my sapphire ($2.86 in chips)
Seat 5: cagigas ($2.01 in chips)
Seat 6: LLregs ($18.02 in chips)
FEROIZ: posts small blind $0.01
NASUM333+333: posts big blind $0.02
*** HOLE CARDS ***
Dealt to LLregs [7h 6h]
my sapphire: folds
cagigas: folds
LLregs: folds
caioaspinelli: folds
FEROIZ: folds
Uncalled bet ($0.01) returned to NASUM333+333
NASUM333+333 collected $0.02 from pot
NASUM333+333: doesn't show hand
*** SUMMARY ***
Total pot $0.02 | Rake $0
Seat 1: caioaspinelli (button) folded before Flop (didn't bet)
Seat 2: FEROIZ (small blind) folded before Flop
Seat 3: NASUM333+333 (big blind) collected ($0.02)
Seat 4: my sapphire folded before Flop (didn't bet)
Seat 5: cagigas folded before Flop (didn't bet)
Seat 6: LLregs folded before Flop (didn't bet)

PokerStars Zoom Hand #247970027133:  Hold'em No Limit ($0.01/$0.02) - 2023/12/30 23:25:42 WET [2023/12/30 18:25:42 ET]
Table 'Halley' 6-max Seat #1 is the button
Seat 1: rustyrst01 ($1.94 in chips)
Seat 2: DIRTOJAU1985 ($1.31 in chips)
Seat 3: tooloco ($1.01 in chips)
Seat 4: LLregs ($18.02 in chips)
Seat 5: pkrgrl04 ($1.90 in chips)
Seat 6: HooliganBasher ($3.36 in chips)
DIRTOJAU1985: posts small blind $0.01
tooloco: posts big blind $0.02
*** HOLE CARDS ***
Dealt to LLregs [Th Ac]
LLregs: folds
pkrgrl04: folds
HooliganBasher: folds
rustyrst01: raises $0.04 to $0.06
DIRTOJAU1985: calls $0.05
tooloco: calls $0.04
*** FLOP *** [3d 6s 8c]
DIRTOJAU1985: bets $1.25 and is all-in
tooloco: folds
rustyrst01: folds
Uncalled bet ($1.25) returned to DIRTOJAU1985
DIRTOJAU1985 collected $0.17 from pot
DIRTOJAU1985: doesn't show hand
*** SUMMARY ***
Total pot $0.18 | Rake $0.01
Board [3d 6s 8c]
Seat 1: rustyrst01 (button) folded on the Flop
Seat 2: DIRTOJAU1985 (small blind) collected ($0.17)
Seat 3: tooloco (big blind) folded on the Flop
Seat 4: LLregs folded before Flop (didn't bet)
Seat 5: pkrgrl04 folded before Flop (didn't bet)
Seat 6: HooliganBasher folded before Flop (didn't bet)

PokerStars Zoom Hand #247970029863:  Hold'em No Limit ($0.01/$0.02) - 2023/12/30 23:25:50 WET [2023/12/30 18:25:50 ET]
Table 'Halley' 6-max Seat #1 is the button
Seat 1: Gomez224 ($2.30 in chips)
Seat 2: LLregs ($18.02 in chips)
Seat 3: Lakatare ($3.85 in chips)
Seat 4: Puma, die ($3.53 in chips)
Seat 5: HooliganBasher ($3.36 in chips)
Seat 6: micro0401 ($2 in chips)
LLregs: posts small blind $0.01
Lakatare: posts big blind $0.02
*** HOLE CARDS ***
Dealt to LLregs [7d Qh]
Puma, die: folds
HooliganBasher: folds
micro0401: folds
Gomez224: raises $0.04 to $0.06
LLregs: folds
Lakatare: calls $0.04
*** FLOP *** [5c 8h Qs]
Lakatare: checks
Gomez224: bets $0.04
Lakatare: calls $0.04
*** TURN *** [5c 8h Qs] [7s]
Lakatare: checks
Gomez224: bets $0.06
Lakatare: calls $0.06
*** RIVER *** [5c 8h Qs 7s] [2h]
Lakatare: checks
Gomez224: checks
*** SHOW DOWN ***
Lakatare: shows [Td Qc] (a pair of Queens)
Gomez224: mucks hand
Lakatare collected $0.32 from pot
*** SUMMARY ***
Total pot $0.33 | Rake $0.01
Board [5c 8h Qs 7s 2h]
Seat 1: Gomez224 (button) mucked [8c Ac]
Seat 2: LLregs (small blind) folded before Flop
Seat 3: Lakatare (big blind) showed [Td Qc] and won ($0.32) with a pair of Queens
Seat 4: Puma, die folded before Flop (didn't bet)
Seat 5: HooliganBasher folded before Flop (didn't bet)
Seat 6: micro0401 folded before Flop (didn't bet)

PokerStars Zoom Hand #247970035413:  Hold'em No Limit ($0.01/$0.02) - 2023/12/30 23:26:06 WET [2023/12/30 18:26:06 ET]
Table 'Halley' 6-max Seat #1 is the button
Seat 1: LLregs ($18.01 in chips)
Seat 2: Shmatrixs ($3.13 in chips)
Seat 3: shovetoi ($2.44 in chips)
Seat 4: GeRA XG ($1.33 in chips)
Seat 5: Ricardo Girardi ($1.06 in chips)
Seat 6: enixblr ($3 in chips)
Shmatrixs: posts small blind $0.01
shovetoi: posts big blind $0.02
*** HOLE CARDS ***
Dealt to LLregs [7s 6s]
GeRA XG: folds
Ricardo Girardi: raises $0.02 to $0.04
enixblr: folds
LLregs: calls $0.04
Shmatrixs: folds
shovetoi: folds
*** FLOP *** [8c 7c 6h]
Ricardo Girardi: bets $0.02
LLregs: calls $0.02
*** TURN *** [8c 7c 6h] [Kd]
Ricardo Girardi: checks
LLregs: bets $0.06
Ricardo Girardi: calls $0.06
*** RIVER *** [8c 7c 6h Kd] [Qh]
Ricardo Girardi: checks
LLregs: bets $1.06
Ricardo Girardi: folds
Uncalled bet ($1.06) returned to LLregs
LLregs collected $0.26 from pot
LLregs: doesn't show hand
*** SUMMARY ***
Total pot $0.27 | Rake $0.01
Board [8c 7c 6h Kd Qh]
Seat 1: LLregs (button) collected ($0.26)
Seat 2: Shmatrixs (small blind) folded before Flop
Seat 3: shovetoi (big blind) folded before Flop
Seat 4: GeRA XG folded before Flop (didn't bet)
Seat 5: Ricardo Girardi folded on the River
Seat 6: enixblr folded before Flop (didn't bet)

PokerStars Zoom Hand #247970056491:  Hold'em No Limit ($0.01/$0.02) - 2023/12/30 23:27:08 WET [2023/12/30 18:27:08 ET]
Table 'Halley' 6-max Seat #1 is the button
Seat 1: tooloco ($0.92 in chips)
Seat 2: frankquanki ($8.17 in chips)
Seat 3: LLregs ($18.15 in chips)
Seat 4: 232489410 ($4.93 in chips)
Seat 5: ilb571 ($2 in chips)
Seat 6: conspy84 ($2.26 in chips)
frankquanki: posts small blind $0.01
LLregs: posts big blind $0.02
*** HOLE CARDS ***
Dealt to LLregs [Ks 7s]
232489410: folds
ilb571: folds
conspy84: folds
tooloco: raises $0.05 to $0.07
frankquanki: folds
LLregs: calls $0.05
*** FLOP *** [Ac 6s 4h]
LLregs: checks
tooloco: bets $0.10
LLregs: folds
Uncalled bet ($0.10) returned to tooloco
tooloco collected $0.14 from pot
tooloco: doesn't show hand
*** SUMMARY ***
Total pot $0.15 | Rake $0.01
Board [Ac 6s 4h]
Seat 1: tooloco (button) collected ($0.14)
Seat 2: frankquanki (small blind) folded before Flop
Seat 3: LLregs (big blind) folded on the Flop
Seat 4: 232489410 folded before Flop (didn't bet)
Seat 5: ilb571 folded before Flop (didn't bet)
Seat 6: conspy84 folded before Flop (didn't bet)

PokerStars Zoom Hand #247970072144:  Hold'em No Limit ($0.01/$0.02) - 2023/12/30 23:27:54 WET [2023/12/30 18:27:54 ET]
Table 'Halley' 6-max Seat #1 is the button
Seat 1: conspy84 ($1.45 in chips)
Seat 2: bigrob31988 ($1.57 in chips)
Seat 3: FEROIZ ($1.94 in chips)
Seat 4: Fig0uu ($2.21 in chips)
Seat 5: LLregs ($18.08 in chips)
Seat 6: STAROVERchik ($2.80 in chips)
bigrob31988: posts small blind $0.01
FEROIZ: posts big blind $0.02
*** HOLE CARDS ***
Dealt to LLregs [Ac 2c]
Fig0uu: folds
LLregs: folds
STAROVERchik: raises $0.03 to $0.05
conspy84: folds
bigrob31988: folds
FEROIZ: folds
Uncalled bet ($0.03) returned to STAROVERchik
STAROVERchik collected $0.05 from pot
STAROVERchik: doesn't show hand
*** SUMMARY ***
Total pot $0.05 | Rake $0
Seat 1: conspy84 (button) folded before Flop (didn't bet)
Seat 2: bigrob31988 (small blind) folded before Flop
Seat 3: FEROIZ (big blind) folded before Flop
Seat 4: Fig0uu folded before Flop (didn't bet)
Seat 5: LLregs folded before Flop (didn't bet)
Seat 6: STAROVERchik collected ($0.05)

PokerStars Zoom Hand #247970070792:  Hold'em No Limit ($0.01/$0.02) - 2023/12/30 23:27:50 WET [2023/12/30 18:27:50 ET]
Table 'Halley' 6-max Seat #1 is the button
Seat 1: cagigas ($3.96 in chips)
Seat 2: IanMacDaddy ($5.06 in chips)
Seat 3: 5ars33r ($2.34 in chips)
Seat 4: rustyrst01 ($1.86 in chips)
Seat 5: jjuul ($2.07 in chips)
Seat 6: LLregs ($18.08 in chips)
IanMacDaddy: posts small blind $0.01
5ars33r: posts big blind $0.02
*** HOLE CARDS ***
Dealt to LLregs [5h 7s]
rustyrst01: folds
jjuul: raises $0.03 to $0.05
LLregs: folds
cagigas: calls $0.05
IanMacDaddy: folds
5ars33r: folds
*** FLOP *** [7c Qd 4d]
jjuul: checks
cagigas: checks
*** TURN *** [7c Qd 4d] [2h]
jjuul: bets $0.04
cagigas: folds
Uncalled bet ($0.04) returned to jjuul
jjuul collected $0.13 from pot
jjuul: doesn't show hand
*** SUMMARY ***
Total pot $0.13 | Rake $0
Board [7c Qd 4d 2h]
Seat 1: cagigas (button) folded on the Turn
Seat 2: IanMacDaddy (small blind) folded before Flop
Seat 3: 5ars33r (big blind) folded before Flop
Seat 4: rustyrst01 folded before Flop (didn't bet)
Seat 5: jjuul collected ($0.13)
Seat 6: LLregs folded before Flop (didn't bet)

PokerStars Zoom Hand #247970069151:  Hold'em No Limit ($0.01/$0.02) - 2023/12/30 23:27:45 WET [2023/12/30 18:27:45 ET]
Table 'Halley' 6-max Seat #1 is the button
Seat 1: Teletups24 ($1.93 in chips)
Seat 2: freefrolloff ($4.11 in chips)
Seat 3: micro0401 ($2 in chips)
Seat 4: Gomez224 ($2.26 in chips)
Seat 5: LLregs ($18.08 in chips)
Seat 6: Pere Ubu ($1.26 in chips)
freefrolloff: posts small blind $0.01
micro0401: posts big blind $0.02
*** HOLE CARDS ***
Dealt to LLregs [Qs 3s]
Gomez224: folds
LLregs: folds
Pere Ubu: folds
Teletups24: calls $0.02
freefrolloff: folds
micro0401: checks
*** FLOP *** [6s Ts 9d]
micro0401: checks
Teletups24: bets $0.02
micro0401: calls $0.02
*** TURN *** [6s Ts 9d] [Ac]
micro0401: checks
Teletups24: bets $0.02
micro0401: calls $0.02
*** RIVER *** [6s Ts 9d Ac] [8s]
micro0401: checks
Teletups24: bets $0.02
micro0401: raises $0.14 to $0.16
Teletups24: folds
Uncalled bet ($0.14) returned to micro0401
micro0401 collected $0.16 from pot
micro0401: doesn't show hand
*** SUMMARY ***
Total pot $0.17 | Rake $0.01
Board [6s Ts 9d Ac 8s]
Seat 1: Teletups24 (button) folded on the River
Seat 2: freefrolloff (small blind) folded before Flop
Seat 3: micro0401 (big blind) collected ($0.16)
Seat 4: Gomez224 folded before Flop (didn't bet)
Seat 5: LLregs folded before Flop (didn't bet)
Seat 6: Pere Ubu folded before Flop (didn't bet)

PokerStars Zoom Hand #247970073968:  Hold'em No Limit ($0.01/$0.02) - 2023/12/30 23:27:59 WET [2023/12/30 18:27:59 ET]
Table 'Halley' 6-max Seat #1 is the button
Seat 1: 5ars33r ($2.32 in chips)
Seat 2: LLregs ($18.08 in chips)
Seat 3: maritokpo ($2.07 in chips)
Seat 4: vomhof.F ($2.24 in chips)
Seat 5: praznina ($1.12 in chips)
Seat 6: emopokera ($3.33 in chips)
LLregs: posts small blind $0.01
maritokpo: posts big blind $0.02
*** HOLE CARDS ***
Dealt to LLregs [As Qd]
vomhof.F: raises $0.04 to $0.06
praznina: folds
emopokera: folds
5ars33r: folds
LLregs: calls $0.05
maritokpo: folds
*** FLOP *** [2h 9d Jc]
LLregs: checks
vomhof.F: bets $0.07
LLregs: calls $0.07
*** TURN *** [2h 9d Jc] [3c]
LLregs: checks
vomhof.F: checks
*** RIVER *** [2h 9d Jc 3c] [6d]
LLregs: bets $0.13
vomhof.F: folds
Uncalled bet ($0.13) returned to LLregs
LLregs collected $0.27 from pot
LLregs: doesn't show hand
*** SUMMARY ***
Total pot $0.28 | Rake $0.01
Board [2h 9d Jc 3c 6d]
Seat 1: 5ars33r (button) folded before Flop (didn't bet)
Seat 2: LLregs (small blind) collected ($0.27)
Seat 3: maritokpo (big blind) folded before Flop
Seat 4: vomhof.F folded on the River
Seat 5: praznina folded before Flop (didn't bet)
Seat 6: emopokera folded before Flop (didn't bet)

PokerStars Zoom Hand #247970088321:  Hold'em No Limit ($0.01/$0.02) - 2023/12/30 23:28:41 WET [2023/12/30 18:28:41 ET]
Table 'Halley' 6-max Seat #1 is the button
Seat 1: LLregs ($18.22 in chips)
Seat 2: gmansilva ($2 in chips)
Seat 3: Benzoor ($1.74 in chips)
Seat 4: sebastiaosj ($3.36 in chips)
Seat 5: Raymond322 ($2.92 in chips)
Seat 6: micro0401 ($2 in chips)
gmansilva: posts small blind $0.01
Benzoor: posts big blind $0.02
*** HOLE CARDS ***
Dealt to LLregs [Ts 5d]
sebastiaosj: folds
Raymond322: folds
micro0401: folds
LLregs: folds
gmansilva: folds
Uncalled bet ($0.01) returned to Benzoor
Benzoor collected $0.02 from pot
Benzoor: doesn't show hand
*** SUMMARY ***
Total pot $0.02 | Rake $0
Seat 1: LLregs (button) folded before Flop (didn't bet)
Seat 2: gmansilva (small blind) folded before Flop
Seat 3: Benzoor (big blind) collected ($0.02)
Seat 4: sebastiaosj folded before Flop (didn't bet)
Seat 5: Raymond322 folded before Flop (didn't bet)
Seat 6: micro0401 folded before Flop (didn't bet)

PokerStars Zoom Hand #247970085966:  Hold'em No Limit ($0.01/$0.02) - 2023/12/30 23:28:34 WET [2023/12/30 18:28:34 ET]
Table 'Halley' 6-max Seat #1 is the button
Seat 1: NoDenyPanda ($2 in chips)
Seat 2: The_Pie83 ($1.52 in chips)
Seat 3: Bergländer ($0.83 in chips)
Seat 4: LLregs ($18.22 in chips)
Seat 5: qw3306 ($2 in chips)
Seat 6: Fig0uu ($2.23 in chips)
The_Pie83: posts small blind $0.01
Bergländer: posts big blind $0.02
*** HOLE CARDS ***
Dealt to LLregs [6c 5h]
LLregs: folds
qw3306: folds
Fig0uu: folds
NoDenyPanda: folds
The_Pie83: calls $0.01
Bergländer: checks
*** FLOP *** [7d Kh 2d]
The_Pie83: checks
Bergländer: checks
*** TURN *** [7d Kh 2d] [Jd]
The_Pie83: bets $0.02
Bergländer: folds
Uncalled bet ($0.02) returned to The_Pie83
The_Pie83 collected $0.04 from pot
The_Pie83: doesn't show hand
*** SUMMARY ***
Total pot $0.04 | Rake $0
Board [7d Kh 2d Jd]
Seat 1: NoDenyPanda (button) folded before Flop (didn't bet)
Seat 2: The_Pie83 (small blind) collected ($0.04)
Seat 3: Bergländer (big blind) folded on the Turn
Seat 4: LLregs folded before Flop (didn't bet)
Seat 5: qw3306 folded before Flop (didn't bet)
Seat 6: Fig0uu folded before Flop (didn't bet)

PokerStars Zoom Hand #247970089755:  Hold'em No Limit ($0.01/$0.02) - 2023/12/30 23:28:45 WET [2023/12/30 18:28:45 ET]
Table 'Halley' 6-max Seat #1 is the button
Seat 1: jjuul ($2.22 in chips)
Seat 2: fafyny ($2.10 in chips)
Seat 3: LLregs ($18.22 in chips)
Seat 4: qw3306 ($2 in chips)
Seat 5: Giocrik ($5.54 in chips)
Seat 6: tooloco ($0.93 in chips)
fafyny: posts small blind $0.01
LLregs: posts big blind $0.02
*** HOLE CARDS ***
Dealt to LLregs [Ts 5h]
qw3306: folds
Giocrik: folds
tooloco: folds
jjuul: folds
fafyny: folds
Uncalled bet ($0.01) returned to LLregs
LLregs collected $0.02 from pot
LLregs: doesn't show hand
*** SUMMARY ***
Total pot $0.02 | Rake $0
Seat 1: jjuul (button) folded before Flop (didn't bet)
Seat 2: fafyny (small blind) folded before Flop
Seat 3: LLregs (big blind) collected ($0.02)
Seat 4: qw3306 folded before Flop (didn't bet)
Seat 5: Giocrik folded before Flop (didn't bet)
Seat 6: tooloco folded before Flop (didn't bet)

PokerStars Zoom Hand #247970096527:  Hold'em No Limit ($0.01/$0.02) - 2023/12/30 23:29:05 WET [2023/12/30 18:29:05 ET]
Table 'Halley' 6-max Seat #1 is the button
Seat 1: Sty7ebuff1 ($2.46 in chips)
Seat 2: LLregs ($18.23 in chips)
Seat 3: Lezcano101 ($2 in chips)
Seat 4: Ilikefossil ($2.54 in chips)
Seat 5: GarotoMaroto#1 ($1 in chips)
Seat 6: emopokera ($7.68 in chips)
LLregs: posts small blind $0.01
Lezcano101: posts big blind $0.02
*** HOLE CARDS ***
Dealt to LLregs [5d Jh]
Ilikefossil: folds
GarotoMaroto#1: folds
emopokera: folds
Sty7ebuff1: folds
LLregs: folds
Uncalled bet ($0.01) returned to Lezcano101
Lezcano101 collected $0.02 from pot
Lezcano101: doesn't show hand
*** SUMMARY ***
Total pot $0.02 | Rake $0
Seat 1: Sty7ebuff1 (button) folded before Flop (didn't bet)
Seat 2: LLregs (small blind) folded before Flop
Seat 3: Lezcano101 (big blind) collected ($0.02)
Seat 4: Ilikefossil folded before Flop (didn't bet)
Seat 5: GarotoMaroto#1 folded before Flop (didn't bet)
Seat 6: emopokera folded before Flop (didn't bet)

PokerStars Zoom Hand #247970095193:  Hold'em No Limit ($0.01/$0.02) - 2023/12/30 23:29:01 WET [2023/12/30 18:29:01 ET]
Table 'Halley' 6-max Seat #1 is the button
Seat 1: LLregs ($18.23 in chips)
Seat 2: conspy84 ($6.02 in chips)
Seat 3: praznina ($1.78 in chips)
Seat 4: shovetoi ($2.18 in chips)
Seat 5: rrociioo ($0.98 in chips)
Seat 6: dogor73 ($2.51 in chips)
conspy84: posts small blind $0.01
praznina: posts big blind $0.02
*** HOLE CARDS ***
Dealt to LLregs [4c 8s]
shovetoi: raises $0.03 to $0.05
rrociioo: calls $0.05
dogor73: folds
LLregs: folds
conspy84: folds
praznina: folds
*** FLOP *** [Ah 2h 3c]
shovetoi: checks
rrociioo: bets $0.93 and is all-in
shovetoi: calls $0.93
*** TURN *** [Ah 2h 3c] [Jh]
*** RIVER *** [Ah 2h 3c Jh] [8h]
*** SHOW DOWN ***
shovetoi: shows [Qd Ac] (a pair of Aces)
rrociioo: shows [Tc Ad] (a pair of Aces - lower kicker)
shovetoi collected $1.92 from pot
*** SUMMARY ***
Total pot $1.99 | Rake $0.07
Board [Ah 2h 3c Jh 8h]
Seat 1: LLregs (button) folded before Flop (didn't bet)
Seat 2: conspy84 (small blind) folded before Flop
Seat 3: praznina (big blind) folded before Flop
Seat 4: shovetoi showed [Qd Ac] and won ($1.92) with a pair of Aces
Seat 5: rrociioo showed [Tc Ad] and lost with a pair of Aces
Seat 6: dogor73 folded before Flop (didn't bet)

PokerStars Zoom Hand #247970101700:  Hold'em No Limit ($0.01/$0.02) - 2023/12/30 23:29:20 WET [2023/12/30 18:29:20 ET]
Table 'Halley' 6-max Seat #1 is the button
Seat 1: conspy84 ($5.86 in chips)
Seat 2: nadd399 ($1.92 in chips)
Seat 3: Puma, die ($3.71 in chips)
Seat 4: NoDenyPanda ($3.60 in chips)
Seat 5: aricast19 ($3.14 in chips)
Seat 6: LLregs ($18.22 in chips)
nadd399: posts small blind $0.01
Puma, die: posts big blind $0.02
*** HOLE CARDS ***
Dealt to LLregs [Tc Kc]
NoDenyPanda: folds
aricast19: raises $0.04 to $0.06
LLregs: calls $0.06
conspy84: calls $0.06
nadd399: folds
Puma, die: calls $0.04
*** FLOP *** [Qd Jd 5s]
Puma, die: checks
aricast19: checks
LLregs: bets $0.12
conspy84: folds
Puma, die: folds
aricast19: folds
Uncalled bet ($0.12) returned to LLregs
LLregs collected $0.24 from pot
LLregs: doesn't show hand
*** SUMMARY ***
Total pot $0.25 | Rake $0.01
Board [Qd Jd 5s]
Seat 1: conspy84 (button) folded on the Flop
Seat 2: nadd399 (small blind) folded before Flop
Seat 3: Puma, die (big blind) folded on the Flop
Seat 4: NoDenyPanda folded before Flop (didn't bet)
Seat 5: aricast19 folded on the Flop
Seat 6: LLregs collected ($0.24)

PokerStars Zoom Hand #247970116244:  Hold'em No Limit ($0.01/$0.02) - 2023/12/30 23:30:03 WET [2023/12/30 18:30:03 ET]
Table 'Halley' 6-max Seat #1 is the button
Seat 1: 3ener ($1.22 in chips)
Seat 2: ItWasDuke ($2.07 in chips)
Seat 3: mcqueen3370 ($4.61 in chips)
Seat 4: Skyter007 ($0.17 in chips)
Seat 5: LLregs ($18.40 in chips)
Seat 6: sebastiaosj ($3.36 in chips)
ItWasDuke: posts small blind $0.01
mcqueen3370: posts big blind $0.02
*** HOLE CARDS ***
Dealt to LLregs [8d 8c]
Skyter007: folds
LLregs: raises $0.04 to $0.06
sebastiaosj: folds
3ener: raises $0.15 to $0.21
ItWasDuke: folds
mcqueen3370: folds
LLregs: calls $0.15
*** FLOP *** [Qh 4d Td]
LLregs: checks
3ener: bets $0.26
LLregs: folds
Uncalled bet ($0.26) returned to 3ener
3ener collected $0.43 from pot
3ener: doesn't show hand
*** SUMMARY ***
Total pot $0.45 | Rake $0.02
Board [Qh 4d Td]
Seat 1: 3ener (button) collected ($0.43)
Seat 2: ItWasDuke (small blind) folded before Flop
Seat 3: mcqueen3370 (big blind) folded before Flop
Seat 4: Skyter007 folded before Flop (didn't bet)
Seat 5: LLregs folded on the Flop
Seat 6: sebastiaosj folded before Flop (didn't bet)

PokerStars Zoom Hand #247970139767:  Hold'em No Limit ($0.01/$0.02) - 2023/12/30 23:31:12 WET [2023/12/30 18:31:12 ET]
Table 'Halley' 6-max Seat #1 is the button
Seat 1: AugereDivus ($2.72 in chips)
Seat 2: LLregs ($18.17 in chips)
Seat 3: Deny0403 ($5.18 in chips)
Seat 4: eduardo feijó ($1.20 in chips)
Seat 5: Wahnsinn24 ($2.16 in chips)
Seat 6: conspy84 ($2.32 in chips)
LLregs: posts small blind $0.01
Deny0403: posts big blind $0.02
*** HOLE CARDS ***
Dealt to LLregs [8s Ad]
eduardo feijó: folds
Wahnsinn24: folds
conspy84: folds
AugereDivus: raises $0.04 to $0.06
LLregs: folds
Deny0403: raises $0.09 to $0.15
AugereDivus: folds
Uncalled bet ($0.09) returned to Deny0403
Deny0403 collected $0.13 from pot
Deny0403: doesn't show hand
*** SUMMARY ***
Total pot $0.13 | Rake $0
Seat 1: AugereDivus (button) folded before Flop
Seat 2: LLregs (small blind) folded before Flop
Seat 3: Deny0403 (big blind) collected ($0.13)
Seat 4: eduardo feijó folded before Flop (didn't bet)
Seat 5: Wahnsinn24 folded before Flop (didn't bet)
Seat 6: conspy84 folded before Flop (didn't bet)

PokerStars Zoom Hand #247970147891:  Hold'em No Limit ($0.01/$0.02) - 2023/12/30 23:31:37 WET [2023/12/30 18:31:37 ET]
Table 'Halley' 6-max Seat #1 is the button
Seat 1: LLregs ($18.16 in chips)
Seat 2: degelcamus ($2.58 in chips)
Seat 3: ricske68 ($2.42 in chips)
Seat 4: Sw4nsan ($2.32 in chips)
Seat 5: JuanChu070 ($2.79 in chips)
Seat 6: lemmy2719 ($3.34 in chips)
degelcamus: posts small blind $0.01
ricske68: posts big blind $0.02
*** HOLE CARDS ***
Dealt to LLregs [7h 6h]
Sw4nsan: folds
JuanChu070: raises $0.04 to $0.06
lemmy2719: folds
LLregs: folds
degelcamus: folds
ricske68: folds
Uncalled bet ($0.04) returned to JuanChu070
JuanChu070 collected $0.05 from pot
JuanChu070: doesn't show hand
*** SUMMARY ***
Total pot $0.05 | Rake $0
Seat 1: LLregs (button) folded before Flop (didn't bet)
Seat 2: degelcamus (small blind) folded before Flop
Seat 3: ricske68 (big blind) folded before Flop
Seat 4: Sw4nsan folded before Flop (didn't bet)
Seat 5: JuanChu070 collected ($0.05)
Seat 6: lemmy2719 folded before Flop (didn't bet)

PokerStars Zoom Hand #247970143088:  Hold'em No Limit ($0.01/$0.02) - 2023/12/30 23:31:22 WET [2023/12/30 18:31:22 ET]
Table 'Halley' 6-max Seat #1 is the button
Seat 1: praznina ($2.52 in chips)
Seat 2: Teletups24 ($1.74 in chips)
Seat 3: qw3306 ($2 in chips)
Seat 4: LLregs ($18.16 in chips)
Seat 5: roydivision1 ($2.84 in chips)
Seat 6: Pere Ubu ($0.59 in chips)
Teletups24: posts small blind $0.01
qw3306: posts big blind $0.02
*** HOLE CARDS ***
Dealt to LLregs [Ts 8s]
LLregs: folds
roydivision1: folds
Pere Ubu: folds
praznina has timed out
praznina: folds
Teletups24: calls $0.01
qw3306: checks
*** FLOP *** [6s 2s Kd]
Teletups24: checks
qw3306: bets $0.02
Teletups24: folds
Uncalled bet ($0.02) returned to qw3306
qw3306 collected $0.04 from pot
qw3306: doesn't show hand
*** SUMMARY ***
Total pot $0.04 | Rake $0
Board [6s 2s Kd]
Seat 1: praznina (button) folded before Flop (didn't bet)
Seat 2: Teletups24 (small blind) folded on the Flop
Seat 3: qw3306 (big blind) collected ($0.04)
Seat 4: LLregs folded before Flop (didn't bet)
Seat 5: roydivision1 folded before Flop (didn't bet)
Seat 6: Pere Ubu folded before Flop (didn't bet)

PokerStars Zoom Hand #247970130600:  Hold'em No Limit ($0.01/$0.02) - 2023/12/30 23:30:46 WET [2023/12/30 18:30:46 ET]
Table 'Halley' 6-max Seat #1 is the button
Seat 1: Mr.Alter3go ($2.83 in chips)
Seat 2: Mojirto01 ($1.58 in chips)
Seat 3: LLregs ($18.19 in chips)
Seat 4: The_Pie83 ($1.55 in chips)
Seat 5: OkadaVictor ($2.20 in chips)
Seat 6: Tombombadillo88 ($1 in chips)
Mojirto01: posts small blind $0.01
LLregs: posts big blind $0.02
*** HOLE CARDS ***
Dealt to LLregs [5h 4c]
The_Pie83: calls $0.02
OkadaVictor: folds
Tombombadillo88: calls $0.02
Mr.Alter3go: folds
Mojirto01: calls $0.01
LLregs: checks
*** FLOP *** [Kd Js 8d]
Mojirto01: bets $0.02
LLregs: folds
The_Pie83: calls $0.02
Tombombadillo88: folds
*** TURN *** [Kd Js 8d] [Qc]
Mojirto01: bets $0.02
The_Pie83: calls $0.02
*** RIVER *** [Kd Js 8d Qc] [5s]
Mojirto01: checks
The_Pie83: checks
*** SHOW DOWN ***
Mojirto01: shows [Jc 9c] (a pair of Jacks)
The_Pie83: shows [Ah Ks] (a pair of Kings)
The_Pie83 collected $0.15 from pot
*** SUMMARY ***
Total pot $0.16 | Rake $0.01
Board [Kd Js 8d Qc 5s]
Seat 1: Mr.Alter3go (button) folded before Flop (didn't bet)
Seat 2: Mojirto01 (small blind) showed [Jc 9c] and lost with a pair of Jacks
Seat 3: LLregs (big blind) folded on the Flop
Seat 4: The_Pie83 showed [Ah Ks] and won ($0.15) with a pair of Kings
Seat 5: OkadaVictor folded before Flop (didn't bet)
Seat 6: Tombombadillo88 folded on the Flop

PokerStars Zoom Hand #247970150599:  Hold'em No Limit ($0.01/$0.02) - 2023/12/30 23:31:45 WET [2023/12/30 18:31:45 ET]
Table 'Halley' 6-max Seat #1 is the button
Seat 1: Ninjafuturo123 ($1.70 in chips)
Seat 2: tisuwheel ($4.43 in chips)
Seat 3: LLregs ($18.16 in chips)
Seat 4: danival2 ($9.86 in chips)
Seat 5: AugereDivus ($2.69 in chips)
Seat 6: gmansilva ($2.02 in chips)
tisuwheel: posts small blind $0.01
LLregs: posts big blind $0.02
*** HOLE CARDS ***
Dealt to LLregs [Qh Tc]
danival2: folds
AugereDivus: folds
gmansilva: folds
Ninjafuturo123: folds
tisuwheel: folds
Uncalled bet ($0.01) returned to LLregs
LLregs collected $0.02 from pot
LLregs: doesn't show hand
*** SUMMARY ***
Total pot $0.02 | Rake $0
Seat 1: Ninjafuturo123 (button) folded before Flop (didn't bet)
Seat 2: tisuwheel (small blind) folded before Flop
Seat 3: LLregs (big blind) collected ($0.02)
Seat 4: danival2 folded before Flop (didn't bet)
Seat 5: AugereDivus folded before Flop (didn't bet)
Seat 6: gmansilva folded before Flop (didn't bet)

PokerStars Zoom Hand #247970149222:  Hold'em No Limit ($0.01/$0.02) - 2023/12/30 23:31:41 WET [2023/12/30 18:31:41 ET]
Table 'Halley' 6-max Seat #1 is the button
Seat 1: ilb571 ($2.12 in chips)
Seat 2: BurningDeath ($2 in chips)
Seat 3: levathon ($2 in chips)
Seat 4: LLregs ($18.16 in chips)
Seat 5: Giocrik ($6.30 in chips)
Seat 6: europe14 ($2.72 in chips)
BurningDeath: posts small blind $0.01
levathon: posts big blind $0.02
*** HOLE CARDS ***
Dealt to LLregs [3h 3d]
LLregs: folds
Giocrik: folds
europe14: folds
ilb571: folds
BurningDeath: raises $0.04 to $0.06
levathon: folds
Uncalled bet ($0.04) returned to BurningDeath
BurningDeath collected $0.04 from pot
BurningDeath: doesn't show hand
*** SUMMARY ***
Total pot $0.04 | Rake $0
Seat 1: ilb571 (button) folded before Flop (didn't bet)
Seat 2: BurningDeath (small blind) collected ($0.04)
Seat 3: levathon (big blind) folded before Flop
Seat 4: LLregs folded before Flop (didn't bet)
Seat 5: Giocrik folded before Flop (didn't bet)
Seat 6: europe14 folded before Flop (didn't bet)

PokerStars Zoom Hand #247970156066:  Hold'em No Limit ($0.01/$0.02) - 2023/12/30 23:32:00 WET [2023/12/30 18:32:00 ET]
Table 'Halley' 6-max Seat #1 is the button
Seat 1: scaley057 ($1.03 in chips)
Seat 2: Hamburg Shark ($2.31 in chips)
Seat 3: TamiSieche ($1.42 in chips)
Seat 4: LLregs ($18.17 in chips)
Seat 5: cagigas ($3.77 in chips)
Seat 6: Deny0403 ($2.39 in chips)
Hamburg Shark: posts small blind $0.01
TamiSieche: posts big blind $0.02
*** HOLE CARDS ***
Dealt to LLregs [9d 7c]
LLregs: folds
cagigas: folds
Deny0403: folds
scaley057: folds
Hamburg Shark: raises $0.04 to $0.06
TamiSieche: folds
Uncalled bet ($0.04) returned to Hamburg Shark
Hamburg Shark collected $0.04 from pot
Hamburg Shark: doesn't show hand
*** SUMMARY ***
Total pot $0.04 | Rake $0
Seat 1: scaley057 (button) folded before Flop (didn't bet)
Seat 2: Hamburg Shark (small blind) collected ($0.04)
Seat 3: TamiSieche (big blind) folded before Flop
Seat 4: LLregs folded before Flop (didn't bet)
Seat 5: cagigas folded before Flop (didn't bet)
Seat 6: Deny0403 folded before Flop (didn't bet)

PokerStars Zoom Hand #247970146849:  Hold'em No Limit ($0.01/$0.02) - 2023/12/30 23:31:33 WET [2023/12/30 18:31:33 ET]
Table 'Halley' 6-max Seat #1 is the button
Seat 1: Shmatrixs ($1.97 in chips)
Seat 2: cagigas ($2.34 in chips)
Seat 3: Wahnsinn24 ($1.19 in chips)
Seat 4: degelcamus ($2.58 in chips)
Seat 5: AugereDivus ($2.97 in chips)
Seat 6: LLregs ($18.16 in chips)
cagigas: posts small blind $0.01
Wahnsinn24: posts big blind $0.02
*** HOLE CARDS ***
Dealt to LLregs [3d 5d]
degelcamus: folds
AugereDivus: folds
LLregs: folds
Shmatrixs: folds
cagigas: calls $0.01
Wahnsinn24: raises $0.06 to $0.08
cagigas: calls $0.06
*** FLOP *** [4h 7s 5h]
cagigas: checks
Wahnsinn24: bets $0.15
cagigas: raises $2.11 to $2.26 and is all-in
Wahnsinn24: folds
Uncalled bet ($2.11) returned to cagigas
cagigas collected $0.44 from pot
cagigas: doesn't show hand
*** SUMMARY ***
Total pot $0.46 | Rake $0.02
Board [4h 7s 5h]
Seat 1: Shmatrixs (button) folded before Flop (didn't bet)
Seat 2: cagigas (small blind) collected ($0.44)
Seat 3: Wahnsinn24 (big blind) folded on the Flop
Seat 4: degelcamus folded before Flop (didn't bet)
Seat 5: AugereDivus folded before Flop (didn't bet)
Seat 6: LLregs folded before Flop (didn't bet)

PokerStars Zoom Hand #247970145452:  Hold'em No Limit ($0.01/$0.02) - 2023/12/30 23:31:29 WET [2023/12/30 18:31:29 ET]
Table 'Halley' 6-max Seat #1 is the button
Seat 1: capuuh ($2.07 in chips)
Seat 2: mcqueen3370 ($4.64 in chips)
Seat 3: olsekpoker ($2.40 in chips)
Seat 4: conspy84 ($1.36 in chips)
Seat 5: LLregs ($18.16 in chips)
Seat 6: frankquanki ($3.59 in chips)
mcqueen3370: posts small blind $0.01
olsekpoker: posts big blind $0.02
*** HOLE CARDS ***
Dealt to LLregs [7h 9d]
conspy84: raises $0.02 to $0.04
LLregs: folds
frankquanki: folds
capuuh: raises $0.11 to $0.15
mcqueen3370: folds
olsekpoker: calls $0.13
conspy84: calls $0.11
*** FLOP *** [As 6c 7c]
olsekpoker: checks
conspy84: checks
capuuh: bets $0.15
olsekpoker: calls $0.15
conspy84: calls $0.15
*** TURN *** [As 6c 7c] [Ah]
olsekpoker: checks
conspy84: checks
capuuh: checks
*** RIVER *** [As 6c 7c Ah] [Td]
olsekpoker: checks
conspy84: bets $0.28
capuuh: calls $0.28
olsekpoker: folds
*** SHOW DOWN ***
conspy84: shows [Ac Js] (three of a kind, Aces)
capuuh: shows [Ad Kc] (three of a kind, Aces - King kicker)
capuuh collected $1.42 from pot
*** SUMMARY ***
Total pot $1.47 | Rake $0.05
Board [As 6c 7c Ah Td]
Seat 1: capuuh (button) showed [Ad Kc] and won ($1.42) with three of a kind, Aces
Seat 2: mcqueen3370 (small blind) folded before Flop
Seat 3: olsekpoker (big blind) folded on the River
Seat 4: conspy84 showed [Ac Js] and lost with three of a kind, Aces
Seat 5: LLregs folded before Flop (didn't bet)
Seat 6: frankquanki folded before Flop (didn't bet)

PokerStars Zoom Hand #247970159542:  Hold'em No Limit ($0.01/$0.02) - 2023/12/30 23:32:11 WET [2023/12/30 18:32:11 ET]
Table 'Halley' 6-max Seat #1 is the button
Seat 1: GeRA XG ($2.24 in chips)
Seat 2: RafkeProost ($5.50 in chips)
Seat 3: frankquanki ($7.97 in chips)
Seat 4: Shmatrixs ($2.09 in chips)
Seat 5: LLregs ($18.16 in chips)
Seat 6: Fig0uu ($2.35 in chips)
RafkeProost: posts small blind $0.01
frankquanki: posts big blind $0.02
*** HOLE CARDS ***
Dealt to LLregs [Qh 8h]
Shmatrixs: folds
LLregs: folds
Fig0uu: folds
GeRA XG: folds
RafkeProost: folds
Uncalled bet ($0.01) returned to frankquanki
frankquanki collected $0.02 from pot
frankquanki: doesn't show hand
*** SUMMARY ***
Total pot $0.02 | Rake $0
Seat 1: GeRA XG (button) folded before Flop (didn't bet)
Seat 2: RafkeProost (small blind) folded before Flop
Seat 3: frankquanki (big blind) collected ($0.02)
Seat 4: Shmatrixs folded before Flop (didn't bet)
Seat 5: LLregs folded before Flop (didn't bet)
Seat 6: Fig0uu folded before Flop (didn't bet)

PokerStars Zoom Hand #247970158193:  Hold'em No Limit ($0.01/$0.02) - 2023/12/30 23:32:07 WET [2023/12/30 18:32:07 ET]
Table 'Halley' 6-max Seat #1 is the button
Seat 1: m4tthaios ($1.35 in chips)
Seat 2: LLregs ($18.17 in chips)
Seat 3: Quorthon_Zei ($2.15 in chips)
Seat 4: Kamozacre ($2.08 in chips)
Seat 5: Ninjafuturo123 ($1.88 in chips)
Seat 6: emopokera ($3.20 in chips)
LLregs: posts small blind $0.01
Quorthon_Zei: posts big blind $0.02
*** HOLE CARDS ***
Dealt to LLregs [9c 4d]
Kamozacre: folds
Ninjafuturo123: folds
emopokera: raises $0.03 to $0.05
m4tthaios: calls $0.05
LLregs: folds
Quorthon_Zei: folds
*** FLOP *** [6c Tc As]
emopokera: bets $0.07
m4tthaios: calls $0.07
*** TURN *** [6c Tc As] [5d]
emopokera: bets $0.15
m4tthaios: calls $0.15
*** RIVER *** [6c Tc As 5d] [5h]
emopokera: bets $0.31
m4tthaios: folds
Uncalled bet ($0.31) returned to emopokera
emopokera collected $0.55 from pot
emopokera: doesn't show hand
*** SUMMARY ***
Total pot $0.57 | Rake $0.02
Board [6c Tc As 5d 5h]
Seat 1: m4tthaios (button) folded on the River
Seat 2: LLregs (small blind) folded before Flop
Seat 3: Quorthon_Zei (big blind) folded before Flop
Seat 4: Kamozacre folded before Flop (didn't bet)
Seat 5: Ninjafuturo123 folded before Flop (didn't bet)
Seat 6: emopokera collected ($0.55)

PokerStars Zoom Hand #247970162499:  Hold'em No Limit ($0.01/$0.02) - 2023/12/30 23:32:20 WET [2023/12/30 18:32:20 ET]
Table 'Halley' 6-max Seat #1 is the button
Seat 1: europe14 ($2.68 in chips)
Seat 2: teletubo ($2.36 in chips)
Seat 3: Ninjafuturo123 ($1.88 in chips)
Seat 4: Deny0403 ($6.06 in chips)
Seat 5: micro0401 ($3.91 in chips)
Seat 6: LLregs ($18.16 in chips)
teletubo: posts small blind $0.01
Ninjafuturo123: posts big blind $0.02
*** HOLE CARDS ***
Dealt to LLregs [Qh Kh]
Deny0403: folds
micro0401: folds
LLregs: raises $0.04 to $0.06
europe14: folds
teletubo: folds
Ninjafuturo123: calls $0.04
*** FLOP *** [Ad 6h 8c]
Ninjafuturo123: checks
LLregs: checks
*** TURN *** [Ad 6h 8c] [3h]
Ninjafuturo123: checks
LLregs: bets $0.04
Ninjafuturo123: folds
Uncalled bet ($0.04) returned to LLregs
LLregs collected $0.13 from pot
LLregs: doesn't show hand
*** SUMMARY ***
Total pot $0.13 | Rake $0
Board [Ad 6h 8c 3h]
Seat 1: europe14 (button) folded before Flop (didn't bet)
Seat 2: teletubo (small blind) folded before Flop
Seat 3: Ninjafuturo123 (big blind) folded on the Turn
Seat 4: Deny0403 folded before Flop (didn't bet)
Seat 5: micro0401 folded before Flop (didn't bet)
Seat 6: LLregs collected ($0.13)

PokerStars Zoom Hand #247970176172:  Hold'em No Limit ($0.01/$0.02) - 2023/12/30 23:33:00 WET [2023/12/30 18:33:00 ET]
Table 'Halley' 6-max Seat #1 is the button
Seat 1: Giocrik ($2.03 in chips)
Seat 2: AugereDivus ($2.81 in chips)
Seat 3: LLregs ($18.23 in chips)
Seat 4: Kamozacre ($2.05 in chips)
Seat 5: RafkeProost ($5.42 in chips)
Seat 6: FEROIZ ($1.83 in chips)
AugereDivus: posts small blind $0.01
LLregs: posts big blind $0.02
*** HOLE CARDS ***
Dealt to LLregs [Ad 9s]
Kamozacre: folds
RafkeProost: folds
FEROIZ: folds
Giocrik: folds
AugereDivus: raises $0.04 to $0.06
LLregs: folds
Uncalled bet ($0.04) returned to AugereDivus
AugereDivus collected $0.04 from pot
AugereDivus: doesn't show hand
*** SUMMARY ***
Total pot $0.04 | Rake $0
Seat 1: Giocrik (button) folded before Flop (didn't bet)
Seat 2: AugereDivus (small blind) collected ($0.04)
Seat 3: LLregs (big blind) folded before Flop
Seat 4: Kamozacre folded before Flop (didn't bet)
Seat 5: RafkeProost folded before Flop (didn't bet)
Seat 6: FEROIZ folded before Flop (didn't bet)

PokerStars Zoom Hand #247970174807:  Hold'em No Limit ($0.01/$0.02) - 2023/12/30 23:32:56 WET [2023/12/30 18:32:56 ET]
Table 'Halley' 6-max Seat #1 is the button
Seat 1: LLregs ($18.23 in chips)
Seat 2: RafkeProost ($5.43 in chips)
Seat 3: aricast19 ($2.80 in chips)
Seat 4: mataski ($2.63 in chips)
Seat 5: micro0401 ($2.28 in chips)
Seat 6: martinshox ($4.47 in chips)
RafkeProost: posts small blind $0.01
aricast19: posts big blind $0.02
*** HOLE CARDS ***
Dealt to LLregs [8s Th]
mataski: raises $0.02 to $0.04
micro0401: folds
martinshox: calls $0.04
LLregs: folds
RafkeProost: folds
aricast19: folds
*** FLOP *** [4h 7c 6d]
mataski: checks
martinshox: bets $0.04
mataski: folds
Uncalled bet ($0.04) returned to martinshox
martinshox collected $0.11 from pot
martinshox: doesn't show hand
*** SUMMARY ***
Total pot $0.11 | Rake $0
Board [4h 7c 6d]
Seat 1: LLregs (button) folded before Flop (didn't bet)
Seat 2: RafkeProost (small blind) folded before Flop
Seat 3: aricast19 (big blind) folded before Flop
Seat 4: mataski folded on the Flop
Seat 5: micro0401 folded before Flop (didn't bet)
Seat 6: martinshox collected ($0.11)

PokerStars Zoom Hand #247970180919:  Hold'em No Limit ($0.01/$0.02) - 2023/12/30 23:33:14 WET [2023/12/30 18:33:14 ET]
Table 'Halley' 6-max Seat #1 is the button
Seat 1: TITIRITERO223 ($2.59 in chips)
Seat 2: Shmatrixs ($2.01 in chips)
Seat 3: 888lifeIS ($2.28 in chips)
Seat 4: ilb571 ($2.10 in chips)
Seat 5: LLregs ($18.21 in chips)
Seat 6: my sapphire ($2 in chips)
Shmatrixs: posts small blind $0.01
888lifeIS: posts big blind $0.02
*** HOLE CARDS ***
Dealt to LLregs [9s 7s]
ilb571: raises $0.04 to $0.06
LLregs: folds
my sapphire: raises $0.12 to $0.18
TITIRITERO223: folds
Shmatrixs: folds
888lifeIS: folds
ilb571: calls $0.12
*** FLOP *** [4c Qs 9h]
ilb571: checks
my sapphire: checks
*** TURN *** [4c Qs 9h] [2s]
ilb571: bets $0.13
my sapphire: calls $0.13
*** RIVER *** [4c Qs 9h 2s] [4s]
ilb571: bets $0.06
my sapphire: calls $0.06
*** SHOW DOWN ***
ilb571: shows [Td Th] (two pair, Tens and Fours)
my sapphire: mucks hand
ilb571 collected $0.74 from pot
*** SUMMARY ***
Total pot $0.77 | Rake $0.03
Board [4c Qs 9h 2s 4s]
Seat 1: TITIRITERO223 (button) folded before Flop (didn't bet)
Seat 2: Shmatrixs (small blind) folded before Flop
Seat 3: 888lifeIS (big blind) folded before Flop
Seat 4: ilb571 showed [Td Th] and won ($0.74) with two pair, Tens and Fours
Seat 5: LLregs folded before Flop (didn't bet)
Seat 6: my sapphire mucked [Ac 2c]

PokerStars Zoom Hand #247970184040:  Hold'em No Limit ($0.01/$0.02) - 2023/12/30 23:33:23 WET [2023/12/30 18:33:23 ET]
Table 'Halley' 6-max Seat #1 is the button
Seat 1: capuuh ($2.91 in chips)
Seat 2: Compagno26 ($1.76 in chips)
Seat 3: martinshox ($2.52 in chips)
Seat 4: LLregs ($18.21 in chips)
Seat 5: Bulti14 ($3.21 in chips)
Seat 6: my sapphire ($1.81 in chips)
Compagno26: posts small blind $0.01
martinshox: posts big blind $0.02
*** HOLE CARDS ***
Dealt to LLregs [2c 9s]
LLregs: folds
Bulti14: raises $0.03 to $0.05
my sapphire: folds
capuuh: folds
Compagno26: calls $0.04
martinshox: calls $0.03
*** FLOP *** [8s Ad 3c]
Compagno26: checks
martinshox: checks
Bulti14: checks
*** TURN *** [8s Ad 3c] [Qh]
Compagno26: checks
martinshox: checks
Bulti14: checks
*** RIVER *** [8s Ad 3c Qh] [3d]
Compagno26: checks
martinshox: checks
Bulti14: checks
*** SHOW DOWN ***
Compagno26: shows [5h 5d] (two pair, Fives and Threes)
martinshox: mucks hand
Bulti14: mucks hand
Compagno26 collected $0.14 from pot
*** SUMMARY ***
Total pot $0.15 | Rake $0.01
Board [8s Ad 3c Qh 3d]
Seat 1: capuuh (button) folded before Flop (didn't bet)
Seat 2: Compagno26 (small blind) showed [5h 5d] and won ($0.14) with two pair, Fives and Threes
Seat 3: martinshox (big blind) mucked [Jd 6d]
Seat 4: LLregs folded before Flop (didn't bet)
Seat 5: Bulti14 mucked [Ks 7s]
Seat 6: my sapphire folded before Flop (didn't bet)

PokerStars Zoom Hand #247970185717:  Hold'em No Limit ($0.01/$0.02) - 2023/12/30 23:33:28 WET [2023/12/30 18:33:28 ET]
Table 'Halley' 6-max Seat #1 is the button
Seat 1: frankquanki ($2.41 in chips)
Seat 2: LLregs ($18.21 in chips)
Seat 3: AugereDivus ($4.98 in chips)
Seat 4: shovetoi ($2.25 in chips)
Seat 5: radin125 ($3.19 in chips)
Seat 6: lemmy2719 ($3.21 in chips)
LLregs: posts small blind $0.01
AugereDivus: posts big blind $0.02
*** HOLE CARDS ***
Dealt to LLregs [4s Js]
shovetoi: raises $0.03 to $0.05
radin125 has timed out
radin125: folds
lemmy2719: folds
frankquanki: folds
LLregs: folds
AugereDivus: folds
Uncalled bet ($0.03) returned to shovetoi
shovetoi collected $0.05 from pot
shovetoi: doesn't show hand
*** SUMMARY ***
Total pot $0.05 | Rake $0
Seat 1: frankquanki (button) folded before Flop (didn't bet)
Seat 2: LLregs (small blind) folded before Flop
Seat 3: AugereDivus (big blind) folded before Flop
Seat 4: shovetoi collected ($0.05)
Seat 5: radin125 folded before Flop (didn't bet)
Seat 6: lemmy2719 folded before Flop (didn't bet)

PokerStars Zoom Hand #247970202306:  Hold'em No Limit ($0.01/$0.02) - 2023/12/30 23:34:17 WET [2023/12/30 18:34:17 ET]
Table 'Halley' 6-max Seat #1 is the button
Seat 1: LLregs ($18.20 in chips)
Seat 2: KV24E ($1.81 in chips)
Seat 3: pedroph3ks ($3.11 in chips)
Seat 4: Agneobr ($2.81 in chips)
Seat 5: Ninjafuturo123 ($1.84 in chips)
Seat 6: 3ener ($0.32 in chips)
KV24E: posts small blind $0.01
pedroph3ks: posts big blind $0.02
*** HOLE CARDS ***
Dealt to LLregs [8c 2s]
Agneobr: folds
Ninjafuturo123: folds
3ener has timed out
3ener: folds
LLregs: folds
KV24E: folds
Uncalled bet ($0.01) returned to pedroph3ks
pedroph3ks collected $0.02 from pot
pedroph3ks: doesn't show hand
*** SUMMARY ***
Total pot $0.02 | Rake $0
Seat 1: LLregs (button) folded before Flop (didn't bet)
Seat 2: KV24E (small blind) folded before Flop
Seat 3: pedroph3ks (big blind) collected ($0.02)
Seat 4: Agneobr folded before Flop (didn't bet)
Seat 5: Ninjafuturo123 folded before Flop (didn't bet)
Seat 6: 3ener folded before Flop (didn't bet)

PokerStars Zoom Hand #247970204698:  Hold'em No Limit ($0.01/$0.02) - 2023/12/30 23:34:24 WET [2023/12/30 18:34:24 ET]
Table 'Halley' 6-max Seat #1 is the button
Seat 1: AmatorGiga ($2.35 in chips)
Seat 2: NoDenyPanda ($7.02 in chips)
Seat 3: LLregs ($18.20 in chips)
Seat 4: leedsrounder ($3.74 in chips)
Seat 5: ItWasDuke ($3.17 in chips)
Seat 6: tisuwheel ($4.29 in chips)
NoDenyPanda: posts small blind $0.01
LLregs: posts big blind $0.02
*** HOLE CARDS ***
Dealt to LLregs [Qc 7c]
leedsrounder: folds
ItWasDuke: folds
tisuwheel: raises $0.02 to $0.04
AmatorGiga: folds
NoDenyPanda: folds
LLregs: calls $0.02
*** FLOP *** [9s Jc 4d]
LLregs: checks
tisuwheel: checks
*** TURN *** [9s Jc 4d] [Qd]
LLregs: checks
tisuwheel: checks
*** RIVER *** [9s Jc 4d Qd] [6h]
LLregs: bets $0.02
tisuwheel: calls $0.02
*** SHOW DOWN ***
LLregs: shows [Qc 7c] (a pair of Queens)
tisuwheel: mucks hand
LLregs collected $0.13 from pot
*** SUMMARY ***
Total pot $0.13 | Rake $0
Board [9s Jc 4d Qd 6h]
Seat 1: AmatorGiga (button) folded before Flop (didn't bet)
Seat 2: NoDenyPanda (small blind) folded before Flop
Seat 3: LLregs (big blind) showed [Qc 7c] and won ($0.13) with a pair of Queens
Seat 4: leedsrounder folded before Flop (didn't bet)
Seat 5: ItWasDuke folded before Flop (didn't bet)
Seat 6: tisuwheel mucked [5d 5h]

PokerStars Zoom Hand #247970200573:  Hold'em No Limit ($0.01/$0.02) - 2023/12/30 23:34:12 WET [2023/12/30 18:34:12 ET]
Table 'Halley' 6-max Seat #1 is the button
Seat 1: levathon ($1.93 in chips)
Seat 2: Ukr Troll ($1.98 in chips)
Seat 3: WEBOO1 ($2.89 in chips)
Seat 4: emopokera ($1.59 in chips)
Seat 5: badbeteador ($2.02 in chips)
Seat 6: LLregs ($18.20 in chips)
Ukr Troll: posts small blind $0.01
WEBOO1: posts big blind $0.02
*** HOLE CARDS ***
Dealt to LLregs [3h 2d]
emopokera: folds
badbeteador: folds
LLregs: folds
levathon: folds
Ukr Troll: raises $0.02 to $0.04
WEBOO1: raises $0.14 to $0.18
Ukr Troll: calls $0.14
*** FLOP *** [5h Js Qd]
Ukr Troll: checks
WEBOO1: bets $0.12
Ukr Troll: calls $0.12
*** TURN *** [5h Js Qd] [2h]
Ukr Troll: checks
WEBOO1: bets $0.41
Ukr Troll: calls $0.41
*** RIVER *** [5h Js Qd 2h] [Qs]
Ukr Troll: checks
WEBOO1: bets $2.18 and is all-in
Ukr Troll: folds
Uncalled bet ($2.18) returned to WEBOO1
WEBOO1 collected $1.37 from pot
WEBOO1: doesn't show hand
*** SUMMARY ***
Total pot $1.42 | Rake $0.05
Board [5h Js Qd 2h Qs]
Seat 1: levathon (button) folded before Flop (didn't bet)
Seat 2: Ukr Troll (small blind) folded on the River
Seat 3: WEBOO1 (big blind) collected ($1.37)
Seat 4: emopokera folded before Flop (didn't bet)
Seat 5: badbeteador folded before Flop (didn't bet)
Seat 6: LLregs folded before Flop (didn't bet)

PokerStars Zoom Hand #247970203659:  Hold'em No Limit ($0.01/$0.02) - 2023/12/30 23:34:21 WET [2023/12/30 18:34:21 ET]
Table 'Halley' 6-max Seat #1 is the button
Seat 1: ilb571 ($2.36 in chips)
Seat 2: Ninjafuturo123 ($1.84 in chips)
Seat 3: KV24E ($1.80 in chips)
Seat 4: Josip1119 ($2 in chips)
Seat 5: MrGeorgekish ($4.71 in chips)
Seat 6: LLregs ($18.20 in chips)
Ninjafuturo123: posts small blind $0.01
KV24E: posts big blind $0.02
*** HOLE CARDS ***
Dealt to LLregs [6s 8h]
Josip1119: raises $0.04 to $0.06
MrGeorgekish: folds
LLregs: folds
ilb571: calls $0.06
Ninjafuturo123: calls $0.05
KV24E: calls $0.04
*** FLOP *** [Jc 2s 4c]
Ninjafuturo123: checks
KV24E: checks
Josip1119: checks
ilb571: bets $0.08
Ninjafuturo123: folds
KV24E: calls $0.08
Josip1119: folds
*** TURN *** [Jc 2s 4c] [6d]
KV24E: checks
ilb571: bets $0.29
KV24E: calls $0.29
*** RIVER *** [Jc 2s 4c 6d] [2d]
KV24E: checks
ilb571: checks
*** SHOW DOWN ***
KV24E: shows [Qc Ac] (a pair of Deuces)
ilb571: shows [Jd Kd] (two pair, Jacks and Deuces)
ilb571 collected $0.95 from pot
*** SUMMARY ***
Total pot $0.98 | Rake $0.03
Board [Jc 2s 4c 6d 2d]
Seat 1: ilb571 (button) showed [Jd Kd] and won ($0.95) with two pair, Jacks and Deuces
Seat 2: Ninjafuturo123 (small blind) folded on the Flop
Seat 3: KV24E (big blind) showed [Qc Ac] and lost with a pair of Deuces
Seat 4: Josip1119 folded on the Flop
Seat 5: MrGeorgekish folded before Flop (didn't bet)
Seat 6: LLregs folded before Flop (didn't bet)

PokerStars Zoom Hand #247970223257:  Hold'em No Limit ($0.01/$0.02) - 2023/12/30 23:35:19 WET [2023/12/30 18:35:19 ET]
Table 'Halley' 6-max Seat #1 is the button
Seat 1: LLregs ($18.26 in chips)
Seat 2: IanMacDaddy ($6.20 in chips)
Seat 3: Jhosmelmino ($3.21 in chips)
Seat 4: scaflowne111 ($2.10 in chips)
Seat 5: rakywok ($2.35 in chips)
Seat 6: GarotoMaroto#1 ($0.42 in chips)
IanMacDaddy: posts small blind $0.01
Jhosmelmino: posts big blind $0.02
*** HOLE CARDS ***
Dealt to LLregs [9d 8s]
scaflowne111: raises $0.02 to $0.04
rakywok: folds
GarotoMaroto#1: folds
LLregs: folds
IanMacDaddy: folds
Jhosmelmino: folds
Uncalled bet ($0.02) returned to scaflowne111
scaflowne111 collected $0.05 from pot
scaflowne111: doesn't show hand
*** SUMMARY ***
Total pot $0.05 | Rake $0
Seat 1: LLregs (button) folded before Flop (didn't bet)
Seat 2: IanMacDaddy (small blind) folded before Flop
Seat 3: Jhosmelmino (big blind) folded before Flop
Seat 4: scaflowne111 collected ($0.05)
Seat 5: rakywok folded before Flop (didn't bet)
Seat 6: GarotoMaroto#1 folded before Flop (didn't bet)

PokerStars Zoom Hand #247970217737:  Hold'em No Limit ($0.01/$0.02) - 2023/12/30 23:35:03 WET [2023/12/30 18:35:03 ET]
Table 'Halley' 6-max Seat #1 is the button
Seat 1: Crusher_Vegeta ($2.76 in chips)
Seat 2: LLregs ($18.27 in chips)
Seat 3: Josip1119 ($2 in chips)
Seat 4: OuzoMan101 ($0.58 in chips)
Seat 5: jjuul ($2.20 in chips)
Seat 6: degelcamus ($2.64 in chips)
LLregs: posts small blind $0.01
Josip1119: posts big blind $0.02
*** HOLE CARDS ***
Dealt to LLregs [6h Js]
OuzoMan101: calls $0.02
jjuul: raises $0.04 to $0.06
degelcamus: folds
Crusher_Vegeta: raises $0.12 to $0.18
LLregs: folds
Josip1119: raises $0.23 to $0.41
OuzoMan101: folds
jjuul: folds
Crusher_Vegeta: folds
Uncalled bet ($0.23) returned to Josip1119
Josip1119 collected $0.45 from pot
Josip1119: doesn't show hand
*** SUMMARY ***
Total pot $0.45 | Rake $0
Seat 1: Crusher_Vegeta (button) folded before Flop
Seat 2: LLregs (small blind) folded before Flop
Seat 3: Josip1119 (big blind) collected ($0.45)
Seat 4: OuzoMan101 folded before Flop
Seat 5: jjuul folded before Flop
Seat 6: degelcamus folded before Flop (didn't bet)

PokerStars Zoom Hand #247970225561:  Hold'em No Limit ($0.01/$0.02) - 2023/12/30 23:35:26 WET [2023/12/30 18:35:26 ET]
Table 'Halley' 6-max Seat #1 is the button
Seat 1: Benzoor ($3.68 in chips)
Seat 2: Sw4nsan ($2 in chips)
Seat 3: Dspecial77 ($2 in chips)
Seat 4: LLregs ($18.26 in chips)
Seat 5: ItWasDuke ($2.22 in chips)
Seat 6: GeRA XG ($2.40 in chips)
Sw4nsan: posts small blind $0.01
Dspecial77: posts big blind $0.02
*** HOLE CARDS ***
Dealt to LLregs [5h Ts]
LLregs: folds
ItWasDuke: folds
GeRA XG: raises $0.03 to $0.05
Benzoor: folds
Sw4nsan: folds
Dspecial77: folds
Uncalled bet ($0.03) returned to GeRA XG
GeRA XG collected $0.05 from pot
GeRA XG: doesn't show hand
*** SUMMARY ***
Total pot $0.05 | Rake $0
Seat 1: Benzoor (button) folded before Flop (didn't bet)
Seat 2: Sw4nsan (small blind) folded before Flop
Seat 3: Dspecial77 (big blind) folded before Flop
Seat 4: LLregs folded before Flop (didn't bet)
Seat 5: ItWasDuke folded before Flop (didn't bet)
Seat 6: GeRA XG collected ($0.05)

PokerStars Zoom Hand #247970226902:  Hold'em No Limit ($0.01/$0.02) - 2023/12/30 23:35:30 WET [2023/12/30 18:35:30 ET]
Table 'Halley' 6-max Seat #1 is the button
Seat 1: 2plateado2 ($4.22 in chips)
Seat 2: mataski ($2.62 in chips)
Seat 3: Beskar405 ($2.45 in chips)
Seat 4: dickie1425 ($2.80 in chips)
Seat 5: LLregs ($18.26 in chips)
Seat 6: Tha_Saint7 ($1.72 in chips)
mataski: posts small blind $0.01
Beskar405: posts big blind $0.02
*** HOLE CARDS ***
Dealt to LLregs [Qc 4c]
dickie1425: folds
LLregs: folds
Tha_Saint7: raises $0.04 to $0.06
2plateado2: folds
mataski: folds
Beskar405: folds
Uncalled bet ($0.04) returned to Tha_Saint7
Tha_Saint7 collected $0.05 from pot
Tha_Saint7: doesn't show hand
*** SUMMARY ***
Total pot $0.05 | Rake $0
Seat 1: 2plateado2 (button) folded before Flop (didn't bet)
Seat 2: mataski (small blind) folded before Flop
Seat 3: Beskar405 (big blind) folded before Flop
Seat 4: dickie1425 folded before Flop (didn't bet)
Seat 5: LLregs folded before Flop (didn't bet)
Seat 6: Tha_Saint7 collected ($0.05)

PokerStars Zoom Hand #247970216080:  Hold'em No Limit ($0.01/$0.02) - 2023/12/30 23:34:58 WET [2023/12/30 18:34:58 ET]
Table 'Halley' 6-max Seat #1 is the button
Seat 1: degelcamus ($4.36 in chips)
Seat 2: Holding1994 ($2 in chips)
Seat 3: AdriPato ($2 in chips)
Seat 4: AugereDivus ($2.75 in chips)
Seat 5: LLregs ($18.27 in chips)
Seat 6: FEROIZ ($0.49 in chips)
Holding1994: posts small blind $0.01
AdriPato: posts big blind $0.02
*** HOLE CARDS ***
Dealt to LLregs [7c Td]
AugereDivus: folds
LLregs: folds
FEROIZ: folds
degelcamus: raises $0.02 to $0.04
Holding1994: calls $0.03
AdriPato: calls $0.02
*** FLOP *** [4s 7s 8h]
Holding1994: checks
AdriPato: checks
degelcamus: checks
*** TURN *** [4s 7s 8h] [5s]
Holding1994: checks
AdriPato: checks
degelcamus: checks
*** RIVER *** [4s 7s 8h 5s] [2d]
Holding1994: checks
AdriPato: checks
degelcamus: checks
*** SHOW DOWN ***
Holding1994: shows [Jh Th] (high card Jack)
AdriPato: shows [Qs Jd] (high card Queen)
degelcamus: shows [Ad 4d] (a pair of Fours)
degelcamus collected $0.12 from pot
*** SUMMARY ***
Total pot $0.12 | Rake $0
Board [4s 7s 8h 5s 2d]
Seat 1: degelcamus (button) showed [Ad 4d] and won ($0.12) with a pair of Fours
Seat 2: Holding1994 (small blind) showed [Jh Th] and lost with high card Jack
Seat 3: AdriPato (big blind) showed [Qs Jd] and lost with high card Queen
Seat 4: AugereDivus folded before Flop (didn't bet)
Seat 5: LLregs folded before Flop (didn't bet)
Seat 6: FEROIZ folded before Flop (didn't bet)

PokerStars Zoom Hand #247970227954:  Hold'em No Limit ($0.01/$0.02) - 2023/12/30 23:35:33 WET [2023/12/30 18:35:33 ET]
Table 'Halley' 6-max Seat #1 is the button
Seat 1: ItWasDuke ($3.31 in chips)
Seat 2: jjuul ($2.14 in chips)
Seat 3: LLregs ($18.26 in chips)
Seat 4: frankquanki ($7.97 in chips)
Seat 5: dimensionist ($2.48 in chips)
Seat 6: Crusher_Vegeta ($2.58 in chips)
jjuul: posts small blind $0.01
LLregs: posts big blind $0.02
*** HOLE CARDS ***
Dealt to LLregs [Ac 7d]
frankquanki: folds
dimensionist: folds
Crusher_Vegeta: folds
ItWasDuke: folds
jjuul: folds
Uncalled bet ($0.01) returned to LLregs
LLregs collected $0.02 from pot
LLregs: doesn't show hand
*** SUMMARY ***
Total pot $0.02 | Rake $0
Seat 1: ItWasDuke (button) folded before Flop (didn't bet)
Seat 2: jjuul (small blind) folded before Flop
Seat 3: LLregs (big blind) collected ($0.02)
Seat 4: frankquanki folded before Flop (didn't bet)
Seat 5: dimensionist folded before Flop (didn't bet)
Seat 6: Crusher_Vegeta folded before Flop (didn't bet)

PokerStars Zoom Hand #247970224574:  Hold'em No Limit ($0.01/$0.02) - 2023/12/30 23:35:23 WET [2023/12/30 18:35:23 ET]
Table 'Halley' 6-max Seat #1 is the button
Seat 1: hugopacifico ($1.93 in chips)
Seat 2: emopokera ($1.59 in chips)
Seat 3: Dspecial77 ($2 in chips)
Seat 4: LLregs ($18.26 in chips)
Seat 5: 5ars33r ($1.92 in chips)
Seat 6: shovetoi ($2.38 in chips)
emopokera: posts small blind $0.01
Dspecial77: posts big blind $0.02
*** HOLE CARDS ***
Dealt to LLregs [2d Jd]
LLregs: folds
5ars33r: folds
shovetoi: folds
hugopacifico: raises $0.02 to $0.04
emopokera: folds
Dspecial77: calls $0.02
*** FLOP *** [2h 9c Qh]
Dspecial77: checks
hugopacifico: checks
*** TURN *** [2h 9c Qh] [4h]
Dspecial77: bets $0.07
hugopacifico: calls $0.07
*** RIVER *** [2h 9c Qh 4h] [As]
Dspecial77: checks
hugopacifico: checks
*** SHOW DOWN ***
Dspecial77: shows [Td Kc] (high card Ace)
hugopacifico: shows [Ac 4c] (two pair, Aces and Fours)
hugopacifico collected $0.22 from pot
*** SUMMARY ***
Total pot $0.23 | Rake $0.01
Board [2h 9c Qh 4h As]
Seat 1: hugopacifico (button) showed [Ac 4c] and won ($0.22) with two pair, Aces and Fours
Seat 2: emopokera (small blind) folded before Flop
Seat 3: Dspecial77 (big blind) showed [Td Kc] and lost with high card Ace
Seat 4: LLregs folded before Flop (didn't bet)
Seat 5: 5ars33r folded before Flop (didn't bet)
Seat 6: shovetoi folded before Flop (didn't bet)

PokerStars Zoom Hand #247970234510:  Hold'em No Limit ($0.01/$0.02) - 2023/12/30 23:35:52 WET [2023/12/30 18:35:52 ET]
Table 'Halley' 6-max Seat #1 is the button
Seat 1: conspy84 ($2.18 in chips)
Seat 2: matzmaron ($1.72 in chips)
Seat 3: Crusher_Vegeta ($2.57 in chips)
Seat 4: AugereDivus ($3.04 in chips)
Seat 5: frankquanki ($3.52 in chips)
Seat 6: LLregs ($18.26 in chips)
matzmaron: posts small blind $0.01
Crusher_Vegeta: posts big blind $0.02
*** HOLE CARDS ***
Dealt to LLregs [3s 9h]
AugereDivus: folds
frankquanki: folds
LLregs: folds
conspy84: folds
matzmaron: folds
Uncalled bet ($0.01) returned to Crusher_Vegeta
Crusher_Vegeta collected $0.02 from pot
Crusher_Vegeta: doesn't show hand
*** SUMMARY ***
Total pot $0.02 | Rake $0
Seat 1: conspy84 (button) folded before Flop (didn't bet)
Seat 2: matzmaron (small blind) folded before Flop
Seat 3: Crusher_Vegeta (big blind) collected ($0.02)
Seat 4: AugereDivus folded before Flop (didn't bet)
Seat 5: frankquanki folded before Flop (didn't bet)
Seat 6: LLregs folded before Flop (didn't bet)

PokerStars Zoom Hand #247970235673:  Hold'em No Limit ($0.01/$0.02) - 2023/12/30 23:35:56 WET [2023/12/30 18:35:56 ET]
Table 'Halley' 6-max Seat #1 is the button
Seat 1: LLregs ($18.26 in chips)
Seat 2: Agneobr ($2.82 in chips)
Seat 3: STAROVERchik ($2.96 in chips)
Seat 4: Mr.Alter3go ($2.37 in chips)
Seat 5: Raymond322 ($2.88 in chips)
Seat 6: gmansilva ($3.13 in chips)
Agneobr: posts small blind $0.01
STAROVERchik: posts big blind $0.02
*** HOLE CARDS ***
Dealt to LLregs [Jd 5c]
Mr.Alter3go: folds
Raymond322: folds
gmansilva: folds
LLregs: raises $0.04 to $0.06
Agneobr: folds
STAROVERchik: folds
Uncalled bet ($0.04) returned to LLregs
LLregs collected $0.05 from pot
LLregs: doesn't show hand
*** SUMMARY ***
Total pot $0.05 | Rake $0
Seat 1: LLregs (button) collected ($0.05)
Seat 2: Agneobr (small blind) folded before Flop
Seat 3: STAROVERchik (big blind) folded before Flop
Seat 4: Mr.Alter3go folded before Flop (didn't bet)
Seat 5: Raymond322 folded before Flop (didn't bet)
Seat 6: gmansilva folded before Flop (didn't bet)

PokerStars Zoom Hand #247970233257:  Hold'em No Limit ($0.01/$0.02) - 2023/12/30 23:35:49 WET [2023/12/30 18:35:49 ET]
Table 'Halley' 6-max Seat #1 is the button
Seat 1: Beskar405 ($2.42 in chips)
Seat 2: LLregs ($18.27 in chips)
Seat 3: OKIRKOSTAS ($1.81 in chips)
Seat 4: MhtsosDhm ($2.17 in chips)
Seat 5: WEBOO1 ($4.12 in chips)
Seat 6: Varitthinut88 ($1.96 in chips)
LLregs: posts small blind $0.01
OKIRKOSTAS: posts big blind $0.02
*** HOLE CARDS ***
Dealt to LLregs [9d 7s]
MhtsosDhm: folds
WEBOO1: folds
Varitthinut88: calls $0.02
Beskar405: folds
LLregs: folds
OKIRKOSTAS: raises $0.08 to $0.10
Varitthinut88: calls $0.08
*** FLOP *** [8d Qd 7c]
OKIRKOSTAS: checks
Varitthinut88: checks
*** TURN *** [8d Qd 7c] [2d]
OKIRKOSTAS: bets $0.08
Varitthinut88: folds
Uncalled bet ($0.08) returned to OKIRKOSTAS
OKIRKOSTAS collected $0.20 from pot
OKIRKOSTAS: doesn't show hand
*** SUMMARY ***
Total pot $0.21 | Rake $0.01
Board [8d Qd 7c 2d]
Seat 1: Beskar405 (button) folded before Flop (didn't bet)
Seat 2: LLregs (small blind) folded before Flop
Seat 3: OKIRKOSTAS (big blind) collected ($0.20)
Seat 4: MhtsosDhm folded before Flop (didn't bet)
Seat 5: WEBOO1 folded before Flop (didn't bet)
Seat 6: Varitthinut88 folded on the Turn

PokerStars Zoom Hand #247970241360:  Hold'em No Limit ($0.01/$0.02) - 2023/12/30 23:36:13 WET [2023/12/30 18:36:13 ET]
Table 'Halley' 6-max Seat #1 is the button
Seat 1: Holding1994 ($2.42 in chips)
Seat 2: teletubo ($2.21 in chips)
Seat 3: Pere Ubu ($0.57 in chips)
Seat 4: LLregs ($18.29 in chips)
Seat 5: 888lifeIS ($2 in chips)
Seat 6: RaPoK23 ($2.89 in chips)
teletubo: posts small blind $0.01
Pere Ubu: posts big blind $0.02
*** HOLE CARDS ***
Dealt to LLregs [Th 5c]
LLregs: folds
888lifeIS: folds
RaPoK23: folds
Holding1994: folds
teletubo: folds
Uncalled bet ($0.01) returned to Pere Ubu
Pere Ubu collected $0.02 from pot
Pere Ubu: doesn't show hand
*** SUMMARY ***
Total pot $0.02 | Rake $0
Seat 1: Holding1994 (button) folded before Flop (didn't bet)
Seat 2: teletubo (small blind) folded before Flop
Seat 3: Pere Ubu (big blind) collected ($0.02)
Seat 4: LLregs folded before Flop (didn't bet)
Seat 5: 888lifeIS folded before Flop (didn't bet)
Seat 6: RaPoK23 folded before Flop (didn't bet)

PokerStars Zoom Hand #247970239773:  Hold'em No Limit ($0.01/$0.02) - 2023/12/30 23:36:08 WET [2023/12/30 18:36:08 ET]
Table 'Halley' 6-max Seat #1 is the button
Seat 1: 888lifeIS ($2.10 in chips)
Seat 2: danival2 ($9.78 in chips)
Seat 3: Fig0uu ($2.51 in chips)
Seat 4: LLregs ($18.29 in chips)
Seat 5: enixblr ($2 in chips)
Seat 6: IanMacDaddy ($6.17 in chips)
danival2: posts small blind $0.01
Fig0uu: posts big blind $0.02
*** HOLE CARDS ***
Dealt to LLregs [2d Jd]
LLregs: folds
enixblr: folds
IanMacDaddy: raises $0.03 to $0.05
888lifeIS: folds
danival2: folds
Fig0uu: folds
Uncalled bet ($0.03) returned to IanMacDaddy
IanMacDaddy collected $0.05 from pot
IanMacDaddy: doesn't show hand
*** SUMMARY ***
Total pot $0.05 | Rake $0
Seat 1: 888lifeIS (button) folded before Flop (didn't bet)
Seat 2: danival2 (small blind) folded before Flop
Seat 3: Fig0uu (big blind) folded before Flop
Seat 4: LLregs folded before Flop (didn't bet)
Seat 5: enixblr folded before Flop (didn't bet)
Seat 6: IanMacDaddy collected ($0.05)

PokerStars Zoom Hand #247970242704:  Hold'em No Limit ($0.01/$0.02) - 2023/12/30 23:36:17 WET [2023/12/30 18:36:17 ET]
Table 'Halley' 6-max Seat #1 is the button
Seat 1: Varitthinut88 ($1.86 in chips)
Seat 2: GamblersDream ($2.21 in chips)
Seat 3: LLregs ($18.29 in chips)
Seat 4: klio6tavia ($0.97 in chips)
Seat 5: ItWasDuke ($3.31 in chips)
Seat 6: Yogananda1 ($1.28 in chips)
GamblersDream: posts small blind $0.01
LLregs: posts big blind $0.02
*** HOLE CARDS ***
Dealt to LLregs [Kd Ah]
klio6tavia: folds
ItWasDuke: folds
Yogananda1: raises $0.03 to $0.05
Varitthinut88: folds
GamblersDream: folds
LLregs: raises $0.15 to $0.20
Yogananda1 is disconnected
Yogananda1: folds
Uncalled bet ($0.15) returned to LLregs
LLregs collected $0.11 from pot
LLregs: doesn't show hand
*** SUMMARY ***
Total pot $0.11 | Rake $0
Seat 1: Varitthinut88 (button) folded before Flop (didn't bet)
Seat 2: GamblersDream (small blind) folded before Flop
Seat 3: LLregs (big blind) collected ($0.11)
Seat 4: klio6tavia folded before Flop (didn't bet)
Seat 5: ItWasDuke folded before Flop (didn't bet)
Seat 6: Yogananda1 folded before Flop

PokerStars Zoom Hand #247970269330:  Hold'em No Limit ($0.01/$0.02) - 2023/12/30 23:37:37 WET [2023/12/30 18:37:37 ET]
Table 'Halley' 6-max Seat #1 is the button
Seat 1: fran8887 ($0.06 in chips)
Seat 2: CrazyFairfox ($2.92 in chips)
Seat 3: carapuce17 ($1.29 in chips)
Seat 4: conspy84 ($2.20 in chips)
Seat 5: LLregs ($18.35 in chips)
Seat 6: xink3r7 ($2.86 in chips)
CrazyFairfox: posts small blind $0.01
carapuce17: posts big blind $0.02
*** HOLE CARDS ***
Dealt to LLregs [8d 5c]
conspy84: folds
LLregs: folds
xink3r7: calls $0.02
fran8887: folds
CrazyFairfox: folds
carapuce17: raises $0.02 to $0.04
xink3r7: calls $0.02
*** FLOP *** [2h Qh 2c]
carapuce17: bets $0.02
xink3r7: folds
Uncalled bet ($0.02) returned to carapuce17
carapuce17 collected $0.09 from pot
carapuce17: doesn't show hand
*** SUMMARY ***
Total pot $0.09 | Rake $0
Board [2h Qh 2c]
Seat 1: fran8887 (button) folded before Flop (didn't bet)
Seat 2: CrazyFairfox (small blind) folded before Flop
Seat 3: carapuce17 (big blind) collected ($0.09)
Seat 4: conspy84 folded before Flop (didn't bet)
Seat 5: LLregs folded before Flop (didn't bet)
Seat 6: xink3r7 folded on the Flop

PokerStars Zoom Hand #247970271363:  Hold'em No Limit ($0.01/$0.02) - 2023/12/30 23:37:43 WET [2023/12/30 18:37:43 ET]
Table 'Halley' 6-max Seat #1 is the button
Seat 1: piistoon ($2 in chips)
Seat 2: LLregs ($18.35 in chips)
Seat 3: leedsrounder ($2.05 in chips)
Seat 4: badbeteador ($1.91 in chips)
Seat 5: Yogananda1 ($1.23 in chips)
Seat 6: Raymond322 ($2.80 in chips)
LLregs: posts small blind $0.01
leedsrounder: posts big blind $0.02
*** HOLE CARDS ***
Dealt to LLregs [Kh Js]
badbeteador: folds
Yogananda1: folds
Raymond322: folds
piistoon: raises $0.04 to $0.06
LLregs: calls $0.05
leedsrounder: folds
*** FLOP *** [Ac 5s Qh]
LLregs: checks
piistoon: bets $0.07
LLregs: calls $0.07
*** TURN *** [Ac 5s Qh] [5d]
LLregs: checks
piistoon: bets $0.18
LLregs: folds
Uncalled bet ($0.18) returned to piistoon
piistoon collected $0.27 from pot
piistoon: doesn't show hand
*** SUMMARY ***
Total pot $0.28 | Rake $0.01
Board [Ac 5s Qh 5d]
Seat 1: piistoon (button) collected ($0.27)
Seat 2: LLregs (small blind) folded on the Turn
Seat 3: leedsrounder (big blind) folded before Flop
Seat 4: badbeteador folded before Flop (didn't bet)
Seat 5: Yogananda1 folded before Flop (didn't bet)
Seat 6: Raymond322 folded before Flop (didn't bet)

PokerStars Zoom Hand #247970291219:  Hold'em No Limit ($0.01/$0.02) - 2023/12/30 23:38:42 WET [2023/12/30 18:38:42 ET]
Table 'Halley' 6-max Seat #1 is the button
Seat 1: LLregs ($18.22 in chips)
Seat 2: mataski ($2.35 in chips)
Seat 3: AdriPato ($2.07 in chips)
Seat 4: Lezcano101 ($2.24 in chips)
Seat 5: lemmy2719 ($3.03 in chips)
Seat 6: CRAZY KEFKA ($3.71 in chips)
mataski: posts small blind $0.01
AdriPato: posts big blind $0.02
*** HOLE CARDS ***
Dealt to LLregs [6c 4d]
Lezcano101: folds
lemmy2719: raises $0.04 to $0.06
CRAZY KEFKA: folds
LLregs: folds
mataski: folds
AdriPato: folds
Uncalled bet ($0.04) returned to lemmy2719
lemmy2719 collected $0.05 from pot
lemmy2719: doesn't show hand
*** SUMMARY ***
Total pot $0.05 | Rake $0
Seat 1: LLregs (button) folded before Flop (didn't bet)
Seat 2: mataski (small blind) folded before Flop
Seat 3: AdriPato (big blind) folded before Flop
Seat 4: Lezcano101 folded before Flop (didn't bet)
Seat 5: lemmy2719 collected ($0.05)
Seat 6: CRAZY KEFKA folded before Flop (didn't bet)

PokerStars Zoom Hand #247970292914:  Hold'em No Limit ($0.01/$0.02) - 2023/12/30 23:38:47 WET [2023/12/30 18:38:47 ET]
Table 'Halley' 6-max Seat #1 is the button
Seat 1: ItWasDuke ($3.37 in chips)
Seat 2: Quorthon_Zei ($2.09 in chips)
Seat 3: jack_high127 ($2.03 in chips)
Seat 4: scaflowne111 ($2.29 in chips)
Seat 5: Doragon38 ($1.73 in chips)
Seat 6: LLregs ($18.22 in chips)
Quorthon_Zei: posts small blind $0.01
jack_high127: posts big blind $0.02
*** HOLE CARDS ***
Dealt to LLregs [Kc 4d]
scaflowne111: folds
Doragon38: folds
LLregs: folds
ItWasDuke: folds
Quorthon_Zei: raises $0.04 to $0.06
jack_high127: folds
Uncalled bet ($0.04) returned to Quorthon_Zei
Quorthon_Zei collected $0.04 from pot
Quorthon_Zei: doesn't show hand
*** SUMMARY ***
Total pot $0.04 | Rake $0
Seat 1: ItWasDuke (button) folded before Flop (didn't bet)
Seat 2: Quorthon_Zei (small blind) collected ($0.04)
Seat 3: jack_high127 (big blind) folded before Flop
Seat 4: scaflowne111 folded before Flop (didn't bet)
Seat 5: Doragon38 folded before Flop (didn't bet)
Seat 6: LLregs folded before Flop (didn't bet)

PokerStars Zoom Hand #247970296689:  Hold'em No Limit ($0.01/$0.02) - 2023/12/30 23:38:58 WET [2023/12/30 18:38:58 ET]
Table 'Halley' 6-max Seat #1 is the button
Seat 1: MhtsosDhm ($2.03 in chips)
Seat 2: Bily Bo ($2.79 in chips)
Seat 3: AdriPato ($2.07 in chips)
Seat 4: LLregs ($18.22 in chips)
Seat 5: mataski ($2.34 in chips)
Seat 6: TITIRITERO223 ($1.81 in chips)
Bily Bo: posts small blind $0.01
AdriPato: posts big blind $0.02
*** HOLE CARDS ***
Dealt to LLregs [4h 2s]
LLregs: folds
mataski: folds
TITIRITERO223: folds
MhtsosDhm: raises $0.03 to $0.05
Bily Bo: folds
AdriPato: folds
Uncalled bet ($0.03) returned to MhtsosDhm
MhtsosDhm collected $0.05 from pot
MhtsosDhm: doesn't show hand
*** SUMMARY ***
Total pot $0.05 | Rake $0
Seat 1: MhtsosDhm (button) collected ($0.05)
Seat 2: Bily Bo (small blind) folded before Flop
Seat 3: AdriPato (big blind) folded before Flop
Seat 4: LLregs folded before Flop (didn't bet)
Seat 5: mataski folded before Flop (didn't bet)
Seat 6: TITIRITERO223 folded before Flop (didn't bet)

PokerStars Zoom Hand #247970297969:  Hold'em No Limit ($0.01/$0.02) - 2023/12/30 23:39:02 WET [2023/12/30 18:39:02 ET]
Table 'Halley' 6-max Seat #1 is the button
Seat 1: wooddyy29 ($1.70 in chips)
Seat 2: teletubo ($2.45 in chips)
Seat 3: LLregs ($18.22 in chips)
Seat 4: degelcamus ($2.50 in chips)
Seat 5: 2s2p1d ($2.42 in chips)
Seat 6: Leka69420 ($1.31 in chips)
teletubo: posts small blind $0.01
LLregs: posts big blind $0.02
*** HOLE CARDS ***
Dealt to LLregs [Jh 5h]
degelcamus: folds
2s2p1d: folds
Leka69420: folds
wooddyy29: folds
teletubo: raises $0.04 to $0.06
LLregs: folds
Uncalled bet ($0.04) returned to teletubo
teletubo collected $0.04 from pot
teletubo: doesn't show hand
*** SUMMARY ***
Total pot $0.04 | Rake $0
Seat 1: wooddyy29 (button) folded before Flop (didn't bet)
Seat 2: teletubo (small blind) collected ($0.04)
Seat 3: LLregs (big blind) folded before Flop
Seat 4: degelcamus folded before Flop (didn't bet)
Seat 5: 2s2p1d folded before Flop (didn't bet)
Seat 6: Leka69420 folded before Flop (didn't bet)

PokerStars Zoom Hand #247970304335:  Hold'em No Limit ($0.01/$0.02) - 2023/12/30 23:39:21 WET [2023/12/30 18:39:21 ET]
Table 'Halley' 6-max Seat #1 is the button
Seat 1: my sapphire ($3.22 in chips)
Seat 2: LLregs ($18.20 in chips)
Seat 3: freefrolloff ($3.53 in chips)
Seat 4: 888lifeIS ($2.01 in chips)
Seat 5: WEBOO1 ($3.92 in chips)
Seat 6: mataski ($2.35 in chips)
LLregs: posts small blind $0.01
freefrolloff: posts big blind $0.02
*** HOLE CARDS ***
Dealt to LLregs [Jc 7c]
888lifeIS: folds
WEBOO1: folds
mataski: folds
my sapphire: raises $0.03 to $0.05
LLregs: calls $0.04
freefrolloff: folds
*** FLOP *** [2d Qd 7d]
LLregs: checks
my sapphire: bets $0.09
LLregs: calls $0.09
*** TURN *** [2d Qd 7d] [Tc]
LLregs: checks
my sapphire: bets $0.23
LLregs: folds
Uncalled bet ($0.23) returned to my sapphire
my sapphire collected $0.29 from pot
my sapphire: doesn't show hand
*** SUMMARY ***
Total pot $0.30 | Rake $0.01
Board [2d Qd 7d Tc]
Seat 1: my sapphire (button) collected ($0.29)
Seat 2: LLregs (small blind) folded on the Turn
Seat 3: freefrolloff (big blind) folded before Flop
Seat 4: 888lifeIS folded before Flop (didn't bet)
Seat 5: WEBOO1 folded before Flop (didn't bet)
Seat 6: mataski folded before Flop (didn't bet)

PokerStars Zoom Hand #247970315734:  Hold'em No Limit ($0.01/$0.02) - 2023/12/30 23:39:55 WET [2023/12/30 18:39:55 ET]
Table 'Halley' 6-max Seat #1 is the button
Seat 1: concord1998 ($2.17 in chips)
Seat 2: null11 ($1.14 in chips)
Seat 3: emopokera ($1.38 in chips)
Seat 4: AdriPato ($2 in chips)
Seat 5: g0nia ($2.32 in chips)
Seat 6: LLregs ($18.06 in chips)
null11: posts small blind $0.01
emopokera: posts big blind $0.02
*** HOLE CARDS ***
Dealt to LLregs [8h 7s]
AdriPato: folds
g0nia: folds
LLregs: folds
concord1998: folds
null11: folds
Uncalled bet ($0.01) returned to emopokera
emopokera collected $0.02 from pot
emopokera: doesn't show hand
*** SUMMARY ***
Total pot $0.02 | Rake $0
Seat 1: concord1998 (button) folded before Flop (didn't bet)
Seat 2: null11 (small blind) folded before Flop
Seat 3: emopokera (big blind) collected ($0.02)
Seat 4: AdriPato folded before Flop (didn't bet)
Seat 5: g0nia folded before Flop (didn't bet)
Seat 6: LLregs folded before Flop (didn't bet)

PokerStars Zoom Hand #247970316658:  Hold'em No Limit ($0.01/$0.02) - 2023/12/30 23:39:58 WET [2023/12/30 18:39:58 ET]
Table 'Halley' 6-max Seat #1 is the button
Seat 1: LLregs ($18.06 in chips)
Seat 2: Mamirox ($2.48 in chips)
Seat 3: matzmaron ($3.32 in chips)
Seat 4: maritokpo ($1.97 in chips)
Seat 5: Leka69420 ($1.28 in chips)
Seat 6: AugereDivus ($3.15 in chips)
Mamirox: posts small blind $0.01
matzmaron: posts big blind $0.02
*** HOLE CARDS ***
Dealt to LLregs [Th Jd]
maritokpo: folds
Leka69420: folds
AugereDivus: folds
LLregs: raises $0.04 to $0.06
Mamirox: raises $0.12 to $0.18
matzmaron: folds
LLregs: folds
Uncalled bet ($0.12) returned to Mamirox
Mamirox collected $0.14 from pot
Mamirox: doesn't show hand
*** SUMMARY ***
Total pot $0.14 | Rake $0
Seat 1: LLregs (button) folded before Flop
Seat 2: Mamirox (small blind) collected ($0.14)
Seat 3: matzmaron (big blind) folded before Flop
Seat 4: maritokpo folded before Flop (didn't bet)
Seat 5: Leka69420 folded before Flop (didn't bet)
Seat 6: AugereDivus folded before Flop (didn't bet)

PokerStars Zoom Hand #247970321690:  Hold'em No Limit ($0.01/$0.02) - 2023/12/30 23:40:13 WET [2023/12/30 18:40:13 ET]
Table 'Halley' 6-max Seat #1 is the button
Seat 1: emopokera ($2.43 in chips)
Seat 2: jaanus666 ($0.98 in chips)
Seat 3: LLregs ($18 in chips)
Seat 4: AdriPato ($2.01 in chips)
Seat 5: my sapphire ($1.84 in chips)
Seat 6: Bily Bo ($3.45 in chips)
jaanus666: posts small blind $0.01
LLregs: posts big blind $0.02
*** HOLE CARDS ***
Dealt to LLregs [Qd 5c]
AdriPato: folds
my sapphire: raises $0.03 to $0.05
Bily Bo: folds
emopokera: folds
jaanus666: folds
LLregs: folds
Uncalled bet ($0.03) returned to my sapphire
my sapphire collected $0.05 from pot
my sapphire: doesn't show hand
*** SUMMARY ***
Total pot $0.05 | Rake $0
Seat 1: emopokera (button) folded before Flop (didn't bet)
Seat 2: jaanus666 (small blind) folded before Flop
Seat 3: LLregs (big blind) folded before Flop
Seat 4: AdriPato folded before Flop (didn't bet)
Seat 5: my sapphire collected ($0.05)
Seat 6: Bily Bo folded before Flop (didn't bet)

PokerStars Zoom Hand #247970432879:  Hold'em No Limit ($0.01/$0.02) - 2023/12/30 23:45:48 WET [2023/12/30 18:45:48 ET]
Table 'Halley' 6-max Seat #1 is the button
Seat 1: carsvic07 ($1.49 in chips)
Seat 2: LLregs ($17.98 in chips)
Seat 3: TomBarber00 ($3.88 in chips)
Seat 4: rrociioo ($0.92 in chips)
Seat 5: FrancoJokerPokk ($2.55 in chips)
Seat 6: Harold_Seven ($1.63 in chips)
LLregs: posts small blind $0.01
TomBarber00: posts big blind $0.02
*** HOLE CARDS ***
Dealt to LLregs [2c 4d]
rrociioo: folds
FrancoJokerPokk: raises $0.04 to $0.06
Harold_Seven: folds
carsvic07: folds
LLregs: folds
TomBarber00: calls $0.04
*** FLOP *** [2s 9s Td]
TomBarber00: checks
FrancoJokerPokk: bets $0.07
TomBarber00: folds
Uncalled bet ($0.07) returned to FrancoJokerPokk
FrancoJokerPokk collected $0.13 from pot
FrancoJokerPokk: doesn't show hand
*** SUMMARY ***
Total pot $0.13 | Rake $0
Board [2s 9s Td]
Seat 1: carsvic07 (button) folded before Flop (didn't bet)
Seat 2: LLregs (small blind) folded before Flop
Seat 3: TomBarber00 (big blind) folded on the Flop
Seat 4: rrociioo folded before Flop (didn't bet)
Seat 5: FrancoJokerPokk collected ($0.13)
Seat 6: Harold_Seven folded before Flop (didn't bet)

PokerStars Zoom Hand #247970431520:  Hold'em No Limit ($0.01/$0.02) - 2023/12/30 23:45:44 WET [2023/12/30 18:45:44 ET]
Table 'Halley' 6-max Seat #1 is the button
Seat 1: degelcamus ($2.32 in chips)
Seat 2: Leka69420 ($1.52 in chips)
Seat 3: lemmy2719 ($3.08 in chips)
Seat 4: ItWasDuke ($2.01 in chips)
Seat 5: LLregs ($17.98 in chips)
Seat 6: 888lifeIS ($2 in chips)
Leka69420: posts small blind $0.01
lemmy2719: posts big blind $0.02
*** HOLE CARDS ***
Dealt to LLregs [Jh 4c]
ItWasDuke: folds
LLregs: folds
888lifeIS: raises $0.02 to $0.04
degelcamus: folds
Leka69420: raises $0.02 to $0.06
lemmy2719: calls $0.04
888lifeIS: calls $0.02
*** FLOP *** [Qh 6h As]
Leka69420: bets $0.09
lemmy2719: calls $0.09
888lifeIS: folds
*** TURN *** [Qh 6h As] [6c]
Leka69420: checks
lemmy2719: bets $0.19
Leka69420: folds
Uncalled bet ($0.19) returned to lemmy2719
lemmy2719 collected $0.35 from pot
lemmy2719: doesn't show hand
*** SUMMARY ***
Total pot $0.36 | Rake $0.01
Board [Qh 6h As 6c]
Seat 1: degelcamus (button) folded before Flop (didn't bet)
Seat 2: Leka69420 (small blind) folded on the Turn
Seat 3: lemmy2719 (big blind) collected ($0.35)
Seat 4: ItWasDuke folded before Flop (didn't bet)
Seat 5: LLregs folded before Flop (didn't bet)
Seat 6: 888lifeIS folded on the Flop

PokerStars Zoom Hand #247970435452:  Hold'em No Limit ($0.01/$0.02) - 2023/12/30 23:45:56 WET [2023/12/30 18:45:56 ET]
Table 'Halley' 6-max Seat #1 is the button
Seat 1: Leoo00oo ($2.08 in chips)
Seat 2: beckzz2011 ($3.84 in chips)
Seat 3: gilmar080586 ($0.65 in chips)
Seat 4: LLregs ($17.97 in chips)
Seat 5: döuble ägent ($4.53 in chips)
Seat 6: Emanuel Pravato ($1.09 in chips)
beckzz2011: posts small blind $0.01
gilmar080586: posts big blind $0.02
*** HOLE CARDS ***
Dealt to LLregs [Ks Qd]
LLregs: raises $0.04 to $0.06
döuble ägent: folds
Emanuel Pravato: calls $0.06
Leoo00oo: folds
beckzz2011: folds
gilmar080586: folds
*** FLOP *** [Jd 2c Kh]
LLregs: bets $0.07
Emanuel Pravato: folds
Uncalled bet ($0.07) returned to LLregs
LLregs collected $0.14 from pot
LLregs: doesn't show hand
*** SUMMARY ***
Total pot $0.15 | Rake $0.01
Board [Jd 2c Kh]
Seat 1: Leoo00oo (button) folded before Flop (didn't bet)
Seat 2: beckzz2011 (small blind) folded before Flop
Seat 3: gilmar080586 (big blind) folded before Flop
Seat 4: LLregs collected ($0.14)
Seat 5: döuble ägent folded before Flop (didn't bet)
Seat 6: Emanuel Pravato folded on the Flop

PokerStars Zoom Hand #247970447164:  Hold'em No Limit ($0.01/$0.02) - 2023/12/30 23:46:33 WET [2023/12/30 18:46:33 ET]
Table 'Halley' 6-max Seat #1 is the button
Seat 1: LLregs ($18.05 in chips)
Seat 2: 888lifeIS ($2 in chips)
Seat 3: Puma, die ($3.74 in chips)
Seat 4: mataski ($2.29 in chips)
Seat 5: Wahnsinn24 ($1.83 in chips)
Seat 6: Fluffy Sable ($2.08 in chips)
888lifeIS: posts small blind $0.01
Puma, die: posts big blind $0.02
*** HOLE CARDS ***
Dealt to LLregs [5h 9s]
mataski: folds
Wahnsinn24: raises $0.04 to $0.06
Fluffy Sable: folds
LLregs: folds
888lifeIS: folds
Puma, die: folds
Uncalled bet ($0.04) returned to Wahnsinn24
Wahnsinn24 collected $0.05 from pot
Wahnsinn24: doesn't show hand
*** SUMMARY ***
Total pot $0.05 | Rake $0
Seat 1: LLregs (button) folded before Flop (didn't bet)
Seat 2: 888lifeIS (small blind) folded before Flop
Seat 3: Puma, die (big blind) folded before Flop
Seat 4: mataski folded before Flop (didn't bet)
Seat 5: Wahnsinn24 collected ($0.05)
Seat 6: Fluffy Sable folded before Flop (didn't bet)

PokerStars Zoom Hand #247970434139:  Hold'em No Limit ($0.01/$0.02) - 2023/12/30 23:45:52 WET [2023/12/30 18:45:52 ET]
Table 'Halley' 6-max Seat #1 is the button
Seat 1: 5ars33r ($1.89 in chips)
Seat 2: Kamozacre ($2.70 in chips)
Seat 3: Dspecial77 ($2.09 in chips)
Seat 4: Pierruet ($2.44 in chips)
Seat 5: LLregs ($17.97 in chips)
Seat 6: Compagno26 ($1.91 in chips)
Kamozacre: posts small blind $0.01
Dspecial77: posts big blind $0.02
*** HOLE CARDS ***
Dealt to LLregs [2s 6s]
Pierruet: raises $0.02 to $0.04
LLregs: folds
Compagno26: calls $0.04
5ars33r: calls $0.04
Kamozacre: folds
Dspecial77: calls $0.02
*** FLOP *** [Ah 8d 8s]
Dspecial77: checks
Pierruet: checks
Compagno26: checks
5ars33r: checks
*** TURN *** [Ah 8d 8s] [7c]
Dspecial77: checks
Pierruet: bets $0.08
Compagno26: folds
5ars33r: calls $0.08
Dspecial77: folds
*** RIVER *** [Ah 8d 8s 7c] [Jh]
Pierruet: bets $0.32
5ars33r: raises $0.53 to $0.85
Pierruet: calls $0.53
*** SHOW DOWN ***
5ars33r: shows [7d 7h] (a full house, Sevens full of Eights)
Pierruet: mucks hand
5ars33r collected $1.96 from pot
*** SUMMARY ***
Total pot $2.03 | Rake $0.07
Board [Ah 8d 8s 7c Jh]
Seat 1: 5ars33r (button) showed [7d 7h] and won ($1.96) with a full house, Sevens full of Eights
Seat 2: Kamozacre (small blind) folded before Flop
Seat 3: Dspecial77 (big blind) folded on the Turn
Seat 4: Pierruet mucked [9c Ad]
Seat 5: LLregs folded before Flop (didn't bet)
Seat 6: Compagno26 folded on the Turn

PokerStars Zoom Hand #247970446147:  Hold'em No Limit ($0.01/$0.02) - 2023/12/30 23:46:29 WET [2023/12/30 18:46:29 ET]
Table 'Halley' 6-max Seat #1 is the button
Seat 1: srna10 ($2.45 in chips)
Seat 2: shovetoi ($3.81 in chips)
Seat 3: Communist654 ($5.11 in chips)
Seat 4: gilmar080586 ($0.59 in chips)
Seat 5: Kamozacre ($2.09 in chips)
Seat 6: LLregs ($18.05 in chips)
shovetoi: posts small blind $0.01
Communist654: posts big blind $0.02
*** HOLE CARDS ***
Dealt to LLregs [2s 7c]
gilmar080586: folds
Kamozacre: folds
LLregs: folds
srna10: folds
shovetoi: raises $0.04 to $0.06
Communist654: calls $0.04
*** FLOP *** [Jh Ks Js]
shovetoi: checks
Communist654: checks
*** TURN *** [Jh Ks Js] [9d]
shovetoi: bets $0.08
Communist654: calls $0.08
*** RIVER *** [Jh Ks Js 9d] [3h]
shovetoi: bets $0.27
Communist654: folds
Uncalled bet ($0.27) returned to shovetoi
shovetoi collected $0.27 from pot
shovetoi: doesn't show hand
*** SUMMARY ***
Total pot $0.28 | Rake $0.01
Board [Jh Ks Js 9d 3h]
Seat 1: srna10 (button) folded before Flop (didn't bet)
Seat 2: shovetoi (small blind) collected ($0.27)
Seat 3: Communist654 (big blind) folded on the River
Seat 4: gilmar080586 folded before Flop (didn't bet)
Seat 5: Kamozacre folded before Flop (didn't bet)
Seat 6: LLregs folded before Flop (didn't bet)

PokerStars Zoom Hand #247970450983:  Hold'em No Limit ($0.01/$0.02) - 2023/12/30 23:46:44 WET [2023/12/30 18:46:44 ET]
Table 'Halley' 6-max Seat #1 is the button
Seat 1: GarotoMaroto#1 ($0.95 in chips)
Seat 2: ekipavd996 ($1.99 in chips)
Seat 3: LLregs ($18.05 in chips)
Seat 4: TamiSieche ($1.14 in chips)
Seat 5: Mamirox ($5.04 in chips)
Seat 6: NoDenyPanda ($7.62 in chips)
ekipavd996: posts small blind $0.01
LLregs: posts big blind $0.02
*** HOLE CARDS ***
Dealt to LLregs [9s Qs]
TamiSieche: folds
Mamirox: folds
NoDenyPanda: folds
GarotoMaroto#1: raises $0.02 to $0.04
ekipavd996: folds
LLregs: calls $0.02
*** FLOP *** [Qh Qd 4c]
LLregs: checks
GarotoMaroto#1: bets $0.06
LLregs: calls $0.06
*** TURN *** [Qh Qd 4c] [7d]
LLregs: bets $0.10
GarotoMaroto#1: calls $0.10
*** RIVER *** [Qh Qd 4c 7d] [Jc]
LLregs: bets $1.08
GarotoMaroto#1: calls $0.75 and is all-in
Uncalled bet ($0.33) returned to LLregs
*** SHOW DOWN ***
LLregs: shows [9s Qs] (three of a kind, Queens)
GarotoMaroto#1: shows [Jd 9d] (two pair, Queens and Jacks)
LLregs collected $1.84 from pot
*** SUMMARY ***
Total pot $1.91 | Rake $0.07
Board [Qh Qd 4c 7d Jc]
Seat 1: GarotoMaroto#1 (button) showed [Jd 9d] and lost with two pair, Queens and Jacks
Seat 2: ekipavd996 (small blind) folded before Flop
Seat 3: LLregs (big blind) showed [9s Qs] and won ($1.84) with three of a kind, Queens
Seat 4: TamiSieche folded before Flop (didn't bet)
Seat 5: Mamirox folded before Flop (didn't bet)
Seat 6: NoDenyPanda folded before Flop (didn't bet)

PokerStars Zoom Hand #247970478419:  Hold'em No Limit ($0.01/$0.02) - 2023/12/30 23:48:08 WET [2023/12/30 18:48:08 ET]
Table 'Halley' 6-max Seat #1 is the button
Seat 1: Puma, die ($3.82 in chips)
Seat 2: döuble ägent ($4.29 in chips)
Seat 3: enixblr ($2 in chips)
Seat 4: WEBOO1 ($3.71 in chips)
Seat 5: bastian031211 ($1.42 in chips)
Seat 6: LLregs ($18.94 in chips)
döuble ägent: posts small blind $0.01
enixblr: posts big blind $0.02
*** HOLE CARDS ***
Dealt to LLregs [8c 7d]
WEBOO1: folds
bastian031211: raises $1.40 to $1.42 and is all-in
LLregs: folds
Puma, die: folds
döuble ägent: folds
enixblr: folds
Uncalled bet ($1.40) returned to bastian031211
bastian031211 collected $0.05 from pot
bastian031211: doesn't show hand
*** SUMMARY ***
Total pot $0.05 | Rake $0
Seat 1: Puma, die (button) folded before Flop (didn't bet)
Seat 2: döuble ägent (small blind) folded before Flop
Seat 3: enixblr (big blind) folded before Flop
Seat 4: WEBOO1 folded before Flop (didn't bet)
Seat 5: bastian031211 collected ($0.05)
Seat 6: LLregs folded before Flop (didn't bet)

PokerStars Zoom Hand #247970481603:  Hold'em No Limit ($0.01/$0.02) - 2023/12/30 23:48:18 WET [2023/12/30 18:48:18 ET]
Table 'Halley' 6-max Seat #1 is the button
Seat 1: AugereDivus ($4.81 in chips)
Seat 2: LLregs ($18.94 in chips)
Seat 3: poker58887 ($1.94 in chips)
Seat 4: 232489410 ($3.16 in chips)
Seat 5: aricast19 ($2.60 in chips)
Seat 6: juules92 ($3.22 in chips)
LLregs: posts small blind $0.01
poker58887: posts big blind $0.02
*** HOLE CARDS ***
Dealt to LLregs [Jc Kc]
232489410: folds
aricast19: folds
juules92: raises $0.04 to $0.06
AugereDivus: folds
LLregs: calls $0.05
poker58887: folds
*** FLOP *** [5d 9d 5c]
LLregs: checks
juules92: checks
*** TURN *** [5d 9d 5c] [4c]
LLregs: bets $0.07
juules92: folds
Uncalled bet ($0.07) returned to LLregs
LLregs collected $0.14 from pot
LLregs: doesn't show hand
*** SUMMARY ***
Total pot $0.14 | Rake $0
Board [5d 9d 5c 4c]
Seat 1: AugereDivus (button) folded before Flop (didn't bet)
Seat 2: LLregs (small blind) collected ($0.14)
Seat 3: poker58887 (big blind) folded before Flop
Seat 4: 232489410 folded before Flop (didn't bet)
Seat 5: aricast19 folded before Flop (didn't bet)
Seat 6: juules92 folded on the Turn

PokerStars Zoom Hand #247970480317:  Hold'em No Limit ($0.01/$0.02) - 2023/12/30 23:48:14 WET [2023/12/30 18:48:14 ET]
Table 'Halley' 6-max Seat #1 is the button
Seat 1: caioaspinelli ($3.32 in chips)
Seat 2: FEROIZ ($2.22 in chips)
Seat 3: GeRA XG ($1.11 in chips)
Seat 4: sebastiaosj ($2.84 in chips)
Seat 5: LLregs ($18.94 in chips)
Seat 6: pekkakoo ($2 in chips)
FEROIZ: posts small blind $0.01
GeRA XG: posts big blind $0.02
*** HOLE CARDS ***
Dealt to LLregs [Kc 4d]
sebastiaosj: folds
LLregs: folds
pekkakoo: folds
caioaspinelli: raises $0.05 to $0.07
FEROIZ: folds
GeRA XG: calls $0.05
*** FLOP *** [3h Td Kh]
GeRA XG: checks
caioaspinelli: bets $0.07
GeRA XG: calls $0.07
*** TURN *** [3h Td Kh] [Tc]
GeRA XG: checks
caioaspinelli: checks
*** RIVER *** [3h Td Kh Tc] [Ts]
GeRA XG: checks
caioaspinelli: bets $0.38
GeRA XG: folds
Uncalled bet ($0.38) returned to caioaspinelli
caioaspinelli collected $0.28 from pot
caioaspinelli: doesn't show hand
*** SUMMARY ***
Total pot $0.29 | Rake $0.01
Board [3h Td Kh Tc Ts]
Seat 1: caioaspinelli (button) collected ($0.28)
Seat 2: FEROIZ (small blind) folded before Flop
Seat 3: GeRA XG (big blind) folded on the River
Seat 4: sebastiaosj folded before Flop (didn't bet)
Seat 5: LLregs folded before Flop (didn't bet)
Seat 6: pekkakoo folded before Flop (didn't bet)

PokerStars Zoom Hand #247970492957:  Hold'em No Limit ($0.01/$0.02) - 2023/12/30 23:48:53 WET [2023/12/30 18:48:53 ET]
Table 'Halley' 6-max Seat #1 is the button
Seat 1: degelcamus ($6.14 in chips)
Seat 2: joseleo61 ($2.07 in chips)
Seat 3: ovi2xs ($1.70 in chips)
Seat 4: LLregs ($19.02 in chips)
Seat 5: praznina ($1.92 in chips)
Seat 6: danival2 ($2.45 in chips)
joseleo61: posts small blind $0.01
ovi2xs: posts big blind $0.02
*** HOLE CARDS ***
Dealt to LLregs [As 9h]
LLregs: folds
praznina: folds
danival2: folds
degelcamus: folds
joseleo61: raises $0.03 to $0.05
ovi2xs: folds
Uncalled bet ($0.03) returned to joseleo61
joseleo61 collected $0.04 from pot
joseleo61: doesn't show hand
*** SUMMARY ***
Total pot $0.04 | Rake $0
Seat 1: degelcamus (button) folded before Flop (didn't bet)
Seat 2: joseleo61 (small blind) collected ($0.04)
Seat 3: ovi2xs (big blind) folded before Flop
Seat 4: LLregs folded before Flop (didn't bet)
Seat 5: praznina folded before Flop (didn't bet)
Seat 6: danival2 folded before Flop (didn't bet)

PokerStars Zoom Hand #247970494550:  Hold'em No Limit ($0.01/$0.02) - 2023/12/30 23:48:58 WET [2023/12/30 18:48:58 ET]
Table 'Halley' 6-max Seat #1 is the button
Seat 1: beckzz2011 ($3.84 in chips)
Seat 2: CRAZY KEFKA ($3.99 in chips)
Seat 3: praznina ($1.92 in chips)
Seat 4: LLregs ($19.02 in chips)
Seat 5: bluethebear ($0.81 in chips)
Seat 6: GeRA XG ($0.97 in chips)
CRAZY KEFKA: posts small blind $0.01
praznina: posts big blind $0.02
*** HOLE CARDS ***
Dealt to LLregs [8s 2s]
LLregs: folds
bluethebear: folds
GeRA XG: folds
beckzz2011: folds
CRAZY KEFKA: folds
Uncalled bet ($0.01) returned to praznina
praznina collected $0.02 from pot
praznina: doesn't show hand
*** SUMMARY ***
Total pot $0.02 | Rake $0
Seat 1: beckzz2011 (button) folded before Flop (didn't bet)
Seat 2: CRAZY KEFKA (small blind) folded before Flop
Seat 3: praznina (big blind) collected ($0.02)
Seat 4: LLregs folded before Flop (didn't bet)
Seat 5: bluethebear folded before Flop (didn't bet)
Seat 6: GeRA XG folded before Flop (didn't bet)

PokerStars Zoom Hand #247970497396:  Hold'em No Limit ($0.01/$0.02) - 2023/12/30 23:49:07 WET [2023/12/30 18:49:07 ET]
Table 'Halley' 6-max Seat #1 is the button
Seat 1: Mamirox ($3.15 in chips)
Seat 2: Shmatrixs ($2.69 in chips)
Seat 3: LLregs ($19.02 in chips)
Seat 4: praznina ($1.82 in chips)
Seat 5: pekkakoo ($2 in chips)
Seat 6: Fluffy Sable ($2.21 in chips)
Shmatrixs: posts small blind $0.01
LLregs: posts big blind $0.02
*** HOLE CARDS ***
Dealt to LLregs [5h 3h]
praznina: folds
pekkakoo: folds
Fluffy Sable: folds
Mamirox: folds
Shmatrixs: raises $0.04 to $0.06
LLregs: folds
Uncalled bet ($0.04) returned to Shmatrixs
Shmatrixs collected $0.04 from pot
Shmatrixs: doesn't show hand
*** SUMMARY ***
Total pot $0.04 | Rake $0
Seat 1: Mamirox (button) folded before Flop (didn't bet)
Seat 2: Shmatrixs (small blind) collected ($0.04)
Seat 3: LLregs (big blind) folded before Flop
Seat 4: praznina folded before Flop (didn't bet)
Seat 5: pekkakoo folded before Flop (didn't bet)
Seat 6: Fluffy Sable folded before Flop (didn't bet)

PokerStars Zoom Hand #247970506524:  Hold'em No Limit ($0.01/$0.02) - 2023/12/30 23:49:35 WET [2023/12/30 18:49:35 ET]
Table 'Halley' 6-max Seat #1 is the button
Seat 1: Communist654 ($4.80 in chips)
Seat 2: LLregs ($19 in chips)
Seat 3: WEBOO1 ($3.89 in chips)
Seat 4: mataski ($2.72 in chips)
Seat 5: Holding1994 ($2 in chips)
Seat 6: SpeedyRiffic ($1.83 in chips)
LLregs: posts small blind $0.01
WEBOO1: posts big blind $0.02
*** HOLE CARDS ***
Dealt to LLregs [3c Jd]
mataski: folds
Holding1994: folds
SpeedyRiffic: folds
Communist654: raises $0.03 to $0.05
LLregs: folds
WEBOO1: raises $0.36 to $0.41
Communist654: folds
Uncalled bet ($0.36) returned to WEBOO1
WEBOO1 collected $0.11 from pot
WEBOO1: doesn't show hand
*** SUMMARY ***
Total pot $0.11 | Rake $0
Seat 1: Communist654 (button) folded before Flop
Seat 2: LLregs (small blind) folded before Flop
Seat 3: WEBOO1 (big blind) collected ($0.11)
Seat 4: mataski folded before Flop (didn't bet)
Seat 5: Holding1994 folded before Flop (didn't bet)
Seat 6: SpeedyRiffic folded before Flop (didn't bet)

PokerStars Zoom Hand #247970490726:  Hold'em No Limit ($0.01/$0.02) - 2023/12/30 23:48:46 WET [2023/12/30 18:48:46 ET]
Table 'Halley' 6-max Seat #1 is the button
Seat 1: LLregs ($19.02 in chips)
Seat 2: naruhoka ($9.04 in chips)
Seat 3: xink3r7 ($2.20 in chips)
Seat 4: caioaspinelli ($1.22 in chips)
Seat 5: founts15 ($2.22 in chips)
Seat 6: carsvic07 ($1.26 in chips)
naruhoka: posts small blind $0.01
xink3r7: posts big blind $0.02
*** HOLE CARDS ***
Dealt to LLregs [Ac 2s]
caioaspinelli: raises $0.04 to $0.06
founts15: folds
carsvic07: folds
LLregs: folds
naruhoka: raises $0.12 to $0.18
xink3r7: folds
caioaspinelli: calls $0.12
*** FLOP *** [5c Jh Kd]
naruhoka: bets $0.09
caioaspinelli: calls $0.09
*** TURN *** [5c Jh Kd] [2h]
naruhoka: checks
caioaspinelli: bets $0.21
naruhoka: raises $0.21 to $0.42
caioaspinelli: raises $0.53 to $0.95 and is all-in
naruhoka: calls $0.53
*** RIVER *** [5c Jh Kd 2h] [5d]
*** SHOW DOWN ***
naruhoka: shows [Ad As] (two pair, Aces and Fives)
caioaspinelli: shows [Td Qd] (a pair of Fives)
naruhoka cashed out the hand for $2.01 | Cash Out Fee $0.04
*** SUMMARY ***
Total pot $2.46 | Rake $0.09
Board [5c Jh Kd 2h 5d]
Seat 1: LLregs (button) folded before Flop (didn't bet)
Seat 2: naruhoka (small blind) showed [Ad As] and won ($2.37) with two pair, Aces and Fives (pot not awarded as player cashed out)
Seat 3: xink3r7 (big blind) folded before Flop
Seat 4: caioaspinelli showed [Td Qd] and lost with a pair of Fives
Seat 5: founts15 folded before Flop (didn't bet)
Seat 6: carsvic07 folded before Flop (didn't bet)

PokerStars Zoom Hand #247970505466:  Hold'em No Limit ($0.01/$0.02) - 2023/12/30 23:49:32 WET [2023/12/30 18:49:32 ET]
Table 'Halley' 6-max Seat #1 is the button
Seat 1: 888lifeIS ($2 in chips)
Seat 2: Wahnsinn24 ($2.26 in chips)
Seat 3: AmatorGiga ($2.57 in chips)
Seat 4: 232489410 ($3.10 in chips)
Seat 5: kuelas ($1.79 in chips)
Seat 6: LLregs ($19 in chips)
Wahnsinn24: posts small blind $0.01
AmatorGiga: posts big blind $0.02
*** HOLE CARDS ***
Dealt to LLregs [2c Ts]
232489410: calls $0.02
kuelas: folds
LLregs: folds
888lifeIS: folds
Wahnsinn24: folds
AmatorGiga: checks
*** FLOP *** [Qh 2d 9d]
AmatorGiga: checks
232489410: checks
*** TURN *** [Qh 2d 9d] [9h]
AmatorGiga: bets $0.03
232489410: calls $0.03
*** RIVER *** [Qh 2d 9d 9h] [7c]
AmatorGiga: checks
232489410: checks
*** SHOW DOWN ***
AmatorGiga: shows [Tc Jd] (a pair of Nines)
232489410: shows [Td Th] (two pair, Tens and Nines)
232489410 collected $0.11 from pot
*** SUMMARY ***
Total pot $0.11 | Rake $0
Board [Qh 2d 9d 9h 7c]
Seat 1: 888lifeIS (button) folded before Flop (didn't bet)
Seat 2: Wahnsinn24 (small blind) folded before Flop
Seat 3: AmatorGiga (big blind) showed [Tc Jd] and lost with a pair of Nines
Seat 4: 232489410 showed [Td Th] and won ($0.11) with two pair, Tens and Nines
Seat 5: kuelas folded before Flop (didn't bet)
Seat 6: LLregs folded before Flop (didn't bet)

PokerStars Zoom Hand #247970507802:  Hold'em No Limit ($0.01/$0.02) - 2023/12/30 23:49:39 WET [2023/12/30 18:49:39 ET]
Table 'Halley' 6-max Seat #1 is the button
Seat 1: LLregs ($18.99 in chips)
Seat 2: Kamozacre ($2.96 in chips)
Seat 3: kuelas ($1.79 in chips)
Seat 4: NeckCarp ($1.01 in chips)
Seat 5: Milianx777 ($2.02 in chips)
Seat 6: lemmy2719 ($3.36 in chips)
Kamozacre: posts small blind $0.01
kuelas: posts big blind $0.02
*** HOLE CARDS ***
Dealt to LLregs [Jd Kc]
NeckCarp: folds
Milianx777: folds
lemmy2719: folds
LLregs: raises $0.04 to $0.06
Kamozacre: folds
kuelas: folds
Uncalled bet ($0.04) returned to LLregs
LLregs collected $0.05 from pot
LLregs: doesn't show hand
*** SUMMARY ***
Total pot $0.05 | Rake $0
Seat 1: LLregs (button) collected ($0.05)
Seat 2: Kamozacre (small blind) folded before Flop
Seat 3: kuelas (big blind) folded before Flop
Seat 4: NeckCarp folded before Flop (didn't bet)
Seat 5: Milianx777 folded before Flop (didn't bet)
Seat 6: lemmy2719 folded before Flop (didn't bet)

PokerStars Zoom Hand #247970513077:  Hold'em No Limit ($0.01/$0.02) - 2023/12/30 23:49:56 WET [2023/12/30 18:49:56 ET]
Table 'Halley' 6-max Seat #1 is the button
Seat 1: naruhoka ($9.83 in chips)
Seat 2: leedsrounder ($3.71 in chips)
Seat 3: LLregs ($19.02 in chips)
Seat 4: emopokera ($6.18 in chips)
Seat 5: Bergländer ($1.08 in chips)
Seat 6: TomBarber00 ($3.46 in chips)
leedsrounder: posts small blind $0.01
LLregs: posts big blind $0.02
*** HOLE CARDS ***
Dealt to LLregs [7h Jh]
emopokera: folds
Bergländer: folds
TomBarber00: folds
naruhoka: folds
leedsrounder: raises $0.04 to $0.06
LLregs: calls $0.04
*** FLOP *** [Qs 9c 7d]
leedsrounder: checks
LLregs: bets $0.06
leedsrounder: folds
Uncalled bet ($0.06) returned to LLregs
LLregs collected $0.12 from pot
LLregs: doesn't show hand
*** SUMMARY ***
Total pot $0.12 | Rake $0
Board [Qs 9c 7d]
Seat 1: naruhoka (button) folded before Flop (didn't bet)
Seat 2: leedsrounder (small blind) folded on the Flop
Seat 3: LLregs (big blind) collected ($0.12)
Seat 4: emopokera folded before Flop (didn't bet)
Seat 5: Bergländer folded before Flop (didn't bet)
Seat 6: TomBarber00 folded before Flop (didn't bet)

PokerStars Zoom Hand #247970520096:  Hold'em No Limit ($0.01/$0.02) - 2023/12/30 23:50:17 WET [2023/12/30 18:50:17 ET]
Table 'Halley' 6-max Seat #1 is the button
Seat 1: Bevza2021 ($0.69 in chips)
Seat 2: LLregs ($19.08 in chips)
Seat 3: Harold_Seven ($1.80 in chips)
Seat 4: erru9107 ($1.94 in chips)
Seat 5: 52outsxx ($1.43 in chips)
Seat 6: Shmatrixs ($4.18 in chips)
LLregs: posts small blind $0.01
Harold_Seven: posts big blind $0.02
*** HOLE CARDS ***
Dealt to LLregs [Kh 4h]
erru9107: folds
52outsxx: folds
Shmatrixs: raises $0.02 to $0.04
Bevza2021: calls $0.04
LLregs: folds
Harold_Seven: folds
*** FLOP *** [9c 7h 4d]
Shmatrixs: bets $0.05
Bevza2021: calls $0.05
*** TURN *** [9c 7h 4d] [8c]
Shmatrixs: bets $0.17
Bevza2021: folds
Uncalled bet ($0.17) returned to Shmatrixs
Shmatrixs collected $0.20 from pot
Shmatrixs: doesn't show hand
*** SUMMARY ***
Total pot $0.21 | Rake $0.01
Board [9c 7h 4d 8c]
Seat 1: Bevza2021 (button) folded on the Turn
Seat 2: LLregs (small blind) folded before Flop
Seat 3: Harold_Seven (big blind) folded before Flop
Seat 4: erru9107 folded before Flop (didn't bet)
Seat 5: 52outsxx folded before Flop (didn't bet)
Seat 6: Shmatrixs collected ($0.20)

PokerStars Zoom Hand #247970526618:  Hold'em No Limit ($0.01/$0.02) - 2023/12/30 23:50:38 WET [2023/12/30 18:50:38 ET]
Table 'Halley' 6-max Seat #1 is the button
Seat 1: aricast19 ($2.57 in chips)
Seat 2: m4tthaios ($2.79 in chips)
Seat 3: MhtsosDhm ($2.13 in chips)
Seat 4: pedroph3ks ($3.67 in chips)
Seat 5: Holding1994 ($2 in chips)
Seat 6: LLregs ($19.07 in chips)
m4tthaios: posts small blind $0.01
MhtsosDhm: posts big blind $0.02
*** HOLE CARDS ***
Dealt to LLregs [Kd Th]
pedroph3ks: folds
Holding1994: folds
LLregs: raises $0.04 to $0.06
aricast19: folds
m4tthaios: folds
MhtsosDhm: folds
Uncalled bet ($0.04) returned to LLregs
LLregs collected $0.05 from pot
LLregs: doesn't show hand
*** SUMMARY ***
Total pot $0.05 | Rake $0
Seat 1: aricast19 (button) folded before Flop (didn't bet)
Seat 2: m4tthaios (small blind) folded before Flop
Seat 3: MhtsosDhm (big blind) folded before Flop
Seat 4: pedroph3ks folded before Flop (didn't bet)
Seat 5: Holding1994 folded before Flop (didn't bet)
Seat 6: LLregs collected ($0.05)

PokerStars Zoom Hand #247970534269:  Hold'em No Limit ($0.01/$0.02) - 2023/12/30 23:51:02 WET [2023/12/30 18:51:02 ET]
Table 'Halley' 6-max Seat #1 is the button
Seat 1: edgarones ($2.12 in chips)
Seat 2: Mamirox ($4.58 in chips)
Seat 3: MhtsosDhm ($3.67 in chips)
Seat 4: Compagno26 ($1.84 in chips)
Seat 5: LLregs ($19.10 in chips)
Seat 6: dogor73 ($1.12 in chips)
Mamirox: posts small blind $0.01
MhtsosDhm: posts big blind $0.02
*** HOLE CARDS ***
Dealt to LLregs [3h 7c]
Compagno26: raises $0.04 to $0.06
LLregs: folds
dogor73: folds
edgarones: folds
Mamirox: folds
MhtsosDhm: folds
Uncalled bet ($0.04) returned to Compagno26
Compagno26 collected $0.05 from pot
Compagno26: doesn't show hand
*** SUMMARY ***
Total pot $0.05 | Rake $0
Seat 1: edgarones (button) folded before Flop (didn't bet)
Seat 2: Mamirox (small blind) folded before Flop
Seat 3: MhtsosDhm (big blind) folded before Flop
Seat 4: Compagno26 collected ($0.05)
Seat 5: LLregs folded before Flop (didn't bet)
Seat 6: dogor73 folded before Flop (didn't bet)

PokerStars Zoom Hand #247970539372:  Hold'em No Limit ($0.01/$0.02) - 2023/12/30 23:51:18 WET [2023/12/30 18:51:18 ET]
Table 'Halley' 6-max Seat #1 is the button
Seat 1: pligtye ($2.09 in chips)
Seat 2: jabberwocky ($1.64 in chips)
Seat 3: huevo_nob10 ($2.50 in chips)
Seat 4: LLregs ($19.10 in chips)
Seat 5: olsekpoker ($3.66 in chips)
Seat 6: Holding1994 ($2 in chips)
jabberwocky: posts small blind $0.01
huevo_nob10: posts big blind $0.02
*** HOLE CARDS ***
Dealt to LLregs [Th Jd]
LLregs: folds
olsekpoker: folds
Holding1994: folds
pligtye: folds
jabberwocky: folds
Uncalled bet ($0.01) returned to huevo_nob10
huevo_nob10 collected $0.02 from pot
huevo_nob10: doesn't show hand
*** SUMMARY ***
Total pot $0.02 | Rake $0
Seat 1: pligtye (button) folded before Flop (didn't bet)
Seat 2: jabberwocky (small blind) folded before Flop
Seat 3: huevo_nob10 (big blind) collected ($0.02)
Seat 4: LLregs folded before Flop (didn't bet)
Seat 5: olsekpoker folded before Flop (didn't bet)
Seat 6: Holding1994 folded before Flop (didn't bet)

PokerStars Zoom Hand #247970538151:  Hold'em No Limit ($0.01/$0.02) - 2023/12/30 23:51:14 WET [2023/12/30 18:51:14 ET]
Table 'Halley' 6-max Seat #1 is the button
Seat 1: hondaandy ($0.80 in chips)
Seat 2: concord1998 ($1.73 in chips)
Seat 3: conspy84 ($3.48 in chips)
Seat 4: beckzz2011 ($2.24 in chips)
Seat 5: LLregs ($19.10 in chips)
Seat 6: emopokera ($1.74 in chips)
concord1998: posts small blind $0.01
conspy84: posts big blind $0.02
*** HOLE CARDS ***
Dealt to LLregs [Ks 5h]
beckzz2011: raises $0.05 to $0.07
LLregs: folds
emopokera: folds
hondaandy: calls $0.07
concord1998: folds
conspy84: folds
*** FLOP *** [9h 5s 9d]
beckzz2011: checks
hondaandy: bets $0.73 and is all-in
beckzz2011: folds
Uncalled bet ($0.73) returned to hondaandy
hondaandy collected $0.16 from pot
hondaandy: doesn't show hand
*** SUMMARY ***
Total pot $0.17 | Rake $0.01
Board [9h 5s 9d]
Seat 1: hondaandy (button) collected ($0.16)
Seat 2: concord1998 (small blind) folded before Flop
Seat 3: conspy84 (big blind) folded before Flop
Seat 4: beckzz2011 folded on the Flop
Seat 5: LLregs folded before Flop (didn't bet)
Seat 6: emopokera folded before Flop (didn't bet)

PokerStars Zoom Hand #247970541594:  Hold'em No Limit ($0.01/$0.02) - 2023/12/30 23:51:25 WET [2023/12/30 18:51:25 ET]
Table 'Halley' 6-max Seat #1 is the button
Seat 1: frankquanki ($8.77 in chips)
Seat 2: Maariancs ($2 in chips)
Seat 3: LLregs ($19.10 in chips)
Seat 4: Leka69420 ($2.06 in chips)
Seat 5: dogor73 ($2.80 in chips)
Seat 6: mataski ($2.69 in chips)
Maariancs: posts small blind $0.01
LLregs: posts big blind $0.02
*** HOLE CARDS ***
Dealt to LLregs [4d Td]
Leka69420: folds
dogor73: raises $0.06 to $0.08
mataski: folds
frankquanki: raises $0.19 to $0.27
Maariancs: folds
LLregs: folds
dogor73: folds
Uncalled bet ($0.19) returned to frankquanki
frankquanki collected $0.19 from pot
frankquanki: doesn't show hand
*** SUMMARY ***
Total pot $0.19 | Rake $0
Seat 1: frankquanki (button) collected ($0.19)
Seat 2: Maariancs (small blind) folded before Flop
Seat 3: LLregs (big blind) folded before Flop
Seat 4: Leka69420 folded before Flop (didn't bet)
Seat 5: dogor73 folded before Flop
Seat 6: mataski folded before Flop (didn't bet)

PokerStars Zoom Hand #247970540625:  Hold'em No Limit ($0.01/$0.02) - 2023/12/30 23:51:22 WET [2023/12/30 18:51:22 ET]
Table 'Halley' 6-max Seat #1 is the button
Seat 1: jabberwocky ($1.63 in chips)
Seat 2: christex1 ($2 in chips)
Seat 3: WEBOO1 ($3.97 in chips)
Seat 4: LLregs ($19.10 in chips)
Seat 5: Bily Bo ($2.54 in chips)
Seat 6: frankquanki ($8.77 in chips)
christex1: posts small blind $0.01
WEBOO1: posts big blind $0.02
*** HOLE CARDS ***
Dealt to LLregs [8c 7h]
LLregs: folds
Bily Bo: folds
frankquanki: folds
jabberwocky: folds
christex1: raises $0.04 to $0.06
WEBOO1: raises $0.12 to $0.18
christex1: folds
Uncalled bet ($0.12) returned to WEBOO1
WEBOO1 collected $0.12 from pot
WEBOO1: doesn't show hand
*** SUMMARY ***
Total pot $0.12 | Rake $0
Seat 1: jabberwocky (button) folded before Flop (didn't bet)
Seat 2: christex1 (small blind) folded before Flop
Seat 3: WEBOO1 (big blind) collected ($0.12)
Seat 4: LLregs folded before Flop (didn't bet)
Seat 5: Bily Bo folded before Flop (didn't bet)
Seat 6: frankquanki folded before Flop (didn't bet)

PokerStars Zoom Hand #247970546727:  Hold'em No Limit ($0.01/$0.02) - 2023/12/30 23:51:41 WET [2023/12/30 18:51:41 ET]
Table 'Halley' 6-max Seat #1 is the button
Seat 1: AugereDivus ($4.76 in chips)
Seat 2: Tosche34 ($2 in chips)
Seat 3: AA-west-AA ($1.04 in chips)
Seat 4: NoDenyPanda ($5.27 in chips)
Seat 5: christex1 ($2.30 in chips)
Seat 6: LLregs ($19.08 in chips)
Tosche34: posts small blind $0.01
AA-west-AA: posts big blind $0.02
*** HOLE CARDS ***
Dealt to LLregs [8d 9c]
NoDenyPanda: folds
christex1: folds
LLregs: folds
AugereDivus: folds
Tosche34: folds
Uncalled bet ($0.01) returned to AA-west-AA
AA-west-AA collected $0.02 from pot
AA-west-AA: doesn't show hand
*** SUMMARY ***
Total pot $0.02 | Rake $0
Seat 1: AugereDivus (button) folded before Flop (didn't bet)
Seat 2: Tosche34 (small blind) folded before Flop
Seat 3: AA-west-AA (big blind) collected ($0.02)
Seat 4: NoDenyPanda folded before Flop (didn't bet)
Seat 5: christex1 folded before Flop (didn't bet)
Seat 6: LLregs folded before Flop (didn't bet)

PokerStars Zoom Hand #247970535571:  Hold'em No Limit ($0.01/$0.02) - 2023/12/30 23:51:06 WET [2023/12/30 18:51:06 ET]
Table 'Halley' 6-max Seat #1 is the button
Seat 1: LLregs ($19.10 in chips)
Seat 2: 5ars33r ($2.51 in chips)
Seat 3: kuelas ($1.71 in chips)
Seat 4: danival2 ($2.93 in chips)
Seat 5: FEROIZ ($1.94 in chips)
Seat 6: my sapphire ($1.08 in chips)
5ars33r: posts small blind $0.01
kuelas: posts big blind $0.02
*** HOLE CARDS ***
Dealt to LLregs [7d 5d]
danival2: raises $0.03 to $0.05
FEROIZ: folds
my sapphire: raises $0.11 to $0.16
LLregs: folds
5ars33r: calls $0.15
kuelas: folds
danival2: calls $0.11
*** FLOP *** [6h 7c 5s]
5ars33r: checks
danival2: checks
my sapphire: checks
*** TURN *** [6h 7c 5s] [Js]
5ars33r: checks
danival2: bets $0.12
my sapphire: calls $0.12
5ars33r: folds
*** RIVER *** [6h 7c 5s Js] [8c]
danival2: checks
my sapphire: bets $0.36
danival2: calls $0.36
*** SHOW DOWN ***
my sapphire: shows [Kc 9c] (a straight, Five to Nine)
danival2: mucks hand
my sapphire collected $1.41 from pot
*** SUMMARY ***
Total pot $1.46 | Rake $0.05
Board [6h 7c 5s Js 8c]
Seat 1: LLregs (button) folded before Flop (didn't bet)
Seat 2: 5ars33r (small blind) folded on the Turn
Seat 3: kuelas (big blind) folded before Flop
Seat 4: danival2 mucked [8h 8d]
Seat 5: FEROIZ folded before Flop (didn't bet)
Seat 6: my sapphire showed [Kc 9c] and won ($1.41) with a straight, Five to Nine

PokerStars Zoom Hand #247970549199:  Hold'em No Limit ($0.01/$0.02) - 2023/12/30 23:51:49 WET [2023/12/30 18:51:49 ET]
Table 'Halley' 6-max Seat #1 is the button
Seat 1: FEROIZ ($1.89 in chips)
Seat 2: LLregs ($19.08 in chips)
Seat 3: dealmekkplease ($3.63 in chips)
Seat 4: founts15 ($2.32 in chips)
Seat 5: frankquanki ($8.88 in chips)
Seat 6: 5ars33r ($2.35 in chips)
LLregs: posts small blind $0.01
dealmekkplease: posts big blind $0.02
*** HOLE CARDS ***
Dealt to LLregs [4d 4s]
founts15: raises $0.04 to $0.06
frankquanki: folds
5ars33r: folds
FEROIZ: folds
LLregs: calls $0.05
dealmekkplease: folds
*** FLOP *** [As 4c 3s]
LLregs: checks
founts15: bets $0.07
LLregs: calls $0.07
*** TURN *** [As 4c 3s] [3d]
LLregs: checks
founts15: checks
*** RIVER *** [As 4c 3s 3d] [9h]
LLregs: bets $0.23
founts15: folds
Uncalled bet ($0.23) returned to LLregs
LLregs collected $0.27 from pot
LLregs: doesn't show hand
*** SUMMARY ***
Total pot $0.28 | Rake $0.01
Board [As 4c 3s 3d 9h]
Seat 1: FEROIZ (button) folded before Flop (didn't bet)
Seat 2: LLregs (small blind) collected ($0.27)
Seat 3: dealmekkplease (big blind) folded before Flop
Seat 4: founts15 folded on the River
Seat 5: frankquanki folded before Flop (didn't bet)
Seat 6: 5ars33r folded before Flop (didn't bet)

PokerStars Zoom Hand #247970548012:  Hold'em No Limit ($0.01/$0.02) - 2023/12/30 23:51:45 WET [2023/12/30 18:51:45 ET]
Table 'Halley' 6-max Seat #1 is the button
Seat 1: Ghul Dukaht ($3.23 in chips)
Seat 2: erru9107 ($1.65 in chips)
Seat 3: fafyny ($1.63 in chips)
Seat 4: naruhoka ($9.73 in chips)
Seat 5: LLregs ($19.08 in chips)
Seat 6: aricast19 ($2.57 in chips)
erru9107: posts small blind $0.01
fafyny: posts big blind $0.02
*** HOLE CARDS ***
Dealt to LLregs [6h 5s]
naruhoka: folds
LLregs: folds
aricast19: raises $0.04 to $0.06
Ghul Dukaht: folds
erru9107: calls $0.05
fafyny: folds
*** FLOP *** [4h 4s Ah]
erru9107: bets $0.11
aricast19: calls $0.11
*** TURN *** [4h 4s Ah] [7d]
erru9107: bets $0.26
aricast19: raises $0.37 to $0.63
erru9107: raises $0.85 to $1.48 and is all-in
aricast19: calls $0.85
*** RIVER *** [4h 4s Ah 7d] [2s]
*** SHOW DOWN ***
erru9107: shows [As 9s] (two pair, Aces and Fours)
aricast19: shows [Ad Ks] (two pair, Aces and Fours - King kicker)
aricast19 collected $3.20 from pot
*** SUMMARY ***
Total pot $3.32 | Rake $0.12
Board [4h 4s Ah 7d 2s]
Seat 1: Ghul Dukaht (button) folded before Flop (didn't bet)
Seat 2: erru9107 (small blind) showed [As 9s] and lost with two pair, Aces and Fours
Seat 3: fafyny (big blind) folded before Flop
Seat 4: naruhoka folded before Flop (didn't bet)
Seat 5: LLregs folded before Flop (didn't bet)
Seat 6: aricast19 showed [Ad Ks] and won ($3.20) with two pair, Aces and Fours

PokerStars Zoom Hand #247970559187:  Hold'em No Limit ($0.01/$0.02) - 2023/12/30 23:52:20 WET [2023/12/30 18:52:20 ET]
Table 'Halley' 6-max Seat #1 is the button
Seat 1: LLregs ($19.22 in chips)
Seat 2: emopokera ($6.08 in chips)
Seat 3: Leka69420 ($2.15 in chips)
Seat 4: AugereDivus ($2.78 in chips)
Seat 5: Bily Bo ($2 in chips)
Seat 6: STAROVERchik ($2.89 in chips)
emopokera: posts small blind $0.01
Leka69420: posts big blind $0.02
*** HOLE CARDS ***
Dealt to LLregs [6s Td]
AugereDivus: folds
Bily Bo: folds
STAROVERchik: folds
LLregs: folds
emopokera: folds
Uncalled bet ($0.01) returned to Leka69420
Leka69420 collected $0.02 from pot
Leka69420: doesn't show hand
*** SUMMARY ***
Total pot $0.02 | Rake $0
Seat 1: LLregs (button) folded before Flop (didn't bet)
Seat 2: emopokera (small blind) folded before Flop
Seat 3: Leka69420 (big blind) collected ($0.02)
Seat 4: AugereDivus folded before Flop (didn't bet)
Seat 5: Bily Bo folded before Flop (didn't bet)
Seat 6: STAROVERchik folded before Flop (didn't bet)

PokerStars Zoom Hand #247970560406:  Hold'em No Limit ($0.01/$0.02) - 2023/12/30 23:52:24 WET [2023/12/30 18:52:24 ET]
Table 'Halley' 6-max Seat #1 is the button
Seat 1: jjuul ($2.70 in chips)
Seat 2: Tosche34 ($2 in chips)
Seat 3: sebastiaosj ($3.25 in chips)
Seat 4: LLregs ($19.22 in chips)
Seat 5: 888lifeIS ($3.37 in chips)
Seat 6: marcin55505 ($0.97 in chips)
Tosche34: posts small blind $0.01
sebastiaosj: posts big blind $0.02
*** HOLE CARDS ***
Dealt to LLregs [Ad Js]
LLregs: raises $0.04 to $0.06
888lifeIS: folds
marcin55505: folds
jjuul: folds
Tosche34: folds
sebastiaosj: calls $0.04
*** FLOP *** [8c Ah Ac]
sebastiaosj: checks
LLregs: checks
*** TURN *** [8c Ah Ac] [Th]
sebastiaosj: checks
LLregs: checks
*** RIVER *** [8c Ah Ac Th] [5d]
sebastiaosj: checks
LLregs: bets $0.10
sebastiaosj: folds
Uncalled bet ($0.10) returned to LLregs
LLregs collected $0.13 from pot
LLregs: doesn't show hand
*** SUMMARY ***
Total pot $0.13 | Rake $0
Board [8c Ah Ac Th 5d]
Seat 1: jjuul (button) folded before Flop (didn't bet)
Seat 2: Tosche34 (small blind) folded before Flop
Seat 3: sebastiaosj (big blind) folded on the River
Seat 4: LLregs collected ($0.13)
Seat 5: 888lifeIS folded before Flop (didn't bet)
Seat 6: marcin55505 folded before Flop (didn't bet)

PokerStars Zoom Hand #247970576282:  Hold'em No Limit ($0.01/$0.02) - 2023/12/30 23:53:14 WET [2023/12/30 18:53:14 ET]
Table 'Halley' 6-max Seat #1 is the button
Seat 1: leedsrounder ($3.60 in chips)
Seat 2: DIRTOJAU1985 ($1 in chips)
Seat 3: LLregs ($19.29 in chips)
Seat 4: Kamozacre ($2.40 in chips)
Seat 5: Raymond322 ($3.94 in chips)
Seat 6: my sapphire ($2.98 in chips)
DIRTOJAU1985: posts small blind $0.01
LLregs: posts big blind $0.02
*** HOLE CARDS ***
Dealt to LLregs [6d 5s]
Kamozacre: folds
Raymond322: folds
my sapphire: folds
leedsrounder: folds
DIRTOJAU1985: folds
Uncalled bet ($0.01) returned to LLregs
LLregs collected $0.02 from pot
LLregs: doesn't show hand
*** SUMMARY ***
Total pot $0.02 | Rake $0
Seat 1: leedsrounder (button) folded before Flop (didn't bet)
Seat 2: DIRTOJAU1985 (small blind) folded before Flop
Seat 3: LLregs (big blind) collected ($0.02)
Seat 4: Kamozacre folded before Flop (didn't bet)
Seat 5: Raymond322 folded before Flop (didn't bet)
Seat 6: my sapphire folded before Flop (didn't bet)

PokerStars Zoom Hand #247970582583:  Hold'em No Limit ($0.01/$0.02) - 2023/12/30 23:53:34 WET [2023/12/30 18:53:34 ET]
Table 'Halley' 6-max Seat #1 is the button
Seat 1: LLregs ($19.30 in chips)
Seat 2: beckzz2011 ($6.16 in chips)
Seat 3: dogor73 ($2.61 in chips)
Seat 4: leedsrounder ($4.09 in chips)
Seat 5: Ukr Troll ($5.15 in chips)
Seat 6: erru9107 ($1.97 in chips)
beckzz2011: posts small blind $0.01
dogor73: posts big blind $0.02
*** HOLE CARDS ***
Dealt to LLregs [8h 8d]
leedsrounder: folds
Ukr Troll: folds
erru9107: folds
LLregs: raises $0.04 to $0.06
beckzz2011: folds
dogor73: folds
Uncalled bet ($0.04) returned to LLregs
LLregs collected $0.05 from pot
LLregs: doesn't show hand
*** SUMMARY ***
Total pot $0.05 | Rake $0
Seat 1: LLregs (button) collected ($0.05)
Seat 2: beckzz2011 (small blind) folded before Flop
Seat 3: dogor73 (big blind) folded before Flop
Seat 4: leedsrounder folded before Flop (didn't bet)
Seat 5: Ukr Troll folded before Flop (didn't bet)
Seat 6: erru9107 folded before Flop (didn't bet)

PokerStars Zoom Hand #247970580717:  Hold'em No Limit ($0.01/$0.02) - 2023/12/30 23:53:28 WET [2023/12/30 18:53:28 ET]
Table 'Halley' 6-max Seat #1 is the button
Seat 1: gmansilva ($4.51 in chips)
Seat 2: mataski ($2.87 in chips)
Seat 3: jandsonpower ($2 in chips)
Seat 4: Deny0403 ($2.20 in chips)
Seat 5: LLregs ($19.30 in chips)
Seat 6: TamiSieche ($0.38 in chips)
mataski: posts small blind $0.01
jandsonpower: posts big blind $0.02
*** HOLE CARDS ***
Dealt to LLregs [5h Ah]
Deny0403: raises $0.04 to $0.06
LLregs: folds
TamiSieche: folds
gmansilva: folds
mataski: folds
jandsonpower: calls $0.04
*** FLOP *** [9s 3s Jd]
jandsonpower: checks
Deny0403: checks
*** TURN *** [9s 3s Jd] [3d]
jandsonpower: bets $0.07
Deny0403: folds
Uncalled bet ($0.07) returned to jandsonpower
jandsonpower collected $0.13 from pot
jandsonpower: doesn't show hand
*** SUMMARY ***
Total pot $0.13 | Rake $0
Board [9s 3s Jd 3d]
Seat 1: gmansilva (button) folded before Flop (didn't bet)
Seat 2: mataski (small blind) folded before Flop
Seat 3: jandsonpower (big blind) collected ($0.13)
Seat 4: Deny0403 folded on the Turn
Seat 5: LLregs folded before Flop (didn't bet)
Seat 6: TamiSieche folded before Flop (didn't bet)

PokerStars Zoom Hand #247970575012:  Hold'em No Limit ($0.01/$0.02) - 2023/12/30 23:53:10 WET [2023/12/30 18:53:10 ET]
Table 'Halley' 6-max Seat #1 is the button
Seat 1: frankquanki ($3.22 in chips)
Seat 2: MhtsosDhm ($2.07 in chips)
Seat 3: teletubo ($2.10 in chips)
Seat 4: LLregs ($19.29 in chips)
Seat 5: beckzz2011 ($2.43 in chips)
Seat 6: kuelas ($1.98 in chips)
MhtsosDhm: posts small blind $0.01
teletubo: posts big blind $0.02
*** HOLE CARDS ***
Dealt to LLregs [5h 3c]
LLregs: folds
beckzz2011: folds
kuelas: raises $0.02 to $0.04
frankquanki: folds
MhtsosDhm: folds
teletubo: calls $0.02
*** FLOP *** [4h Qc 6h]
teletubo: checks
kuelas: checks
*** TURN *** [4h Qc 6h] [Kd]
teletubo: checks
kuelas: bets $0.05
teletubo: calls $0.05
*** RIVER *** [4h Qc 6h Kd] [Ks]
teletubo: checks
kuelas: bets $0.08
teletubo: calls $0.08
*** SHOW DOWN ***
kuelas: shows [Jh Kc] (three of a kind, Kings)
teletubo: mucks hand
kuelas collected $0.34 from pot
*** SUMMARY ***
Total pot $0.35 | Rake $0.01
Board [4h Qc 6h Kd Ks]
Seat 1: frankquanki (button) folded before Flop (didn't bet)
Seat 2: MhtsosDhm (small blind) folded before Flop
Seat 3: teletubo (big blind) mucked [Kh 8s]
Seat 4: LLregs folded before Flop (didn't bet)
Seat 5: beckzz2011 folded before Flop (didn't bet)
Seat 6: kuelas showed [Jh Kc] and won ($0.34) with three of a kind, Kings

PokerStars Zoom Hand #247970587702:  Hold'em No Limit ($0.01/$0.02) - 2023/12/30 23:53:50 WET [2023/12/30 18:53:50 ET]
Table 'Halley' 6-max Seat #1 is the button
Seat 1: bornagain002 ($2.74 in chips)
Seat 2: LLregs ($19.33 in chips)
Seat 3: sebastiaosj ($3.17 in chips)
Seat 4: emopokera ($1.77 in chips)
Seat 5: piistoon ($4.01 in chips)
Seat 6: roydivision1 ($4.86 in chips)
LLregs: posts small blind $0.01
sebastiaosj: posts big blind $0.02
*** HOLE CARDS ***
Dealt to LLregs [Jh 5h]
emopokera: folds
piistoon: folds
roydivision1: folds
bornagain002: raises $0.06 to $0.08
LLregs: folds
sebastiaosj: folds
Uncalled bet ($0.06) returned to bornagain002
bornagain002 collected $0.05 from pot
bornagain002: doesn't show hand
*** SUMMARY ***
Total pot $0.05 | Rake $0
Seat 1: bornagain002 (button) collected ($0.05)
Seat 2: LLregs (small blind) folded before Flop
Seat 3: sebastiaosj (big blind) folded before Flop
Seat 4: emopokera folded before Flop (didn't bet)
Seat 5: piistoon folded before Flop (didn't bet)
Seat 6: roydivision1 folded before Flop (didn't bet)

PokerStars Zoom Hand #247970591541:  Hold'em No Limit ($0.01/$0.02) - 2023/12/30 23:54:02 WET [2023/12/30 18:54:02 ET]
Table 'Halley' 6-max Seat #1 is the button
Seat 1: ovi2xs ($1.76 in chips)
Seat 2: teletubo ($1.93 in chips)
Seat 3: Tony-Broke ($2.55 in chips)
Seat 4: piistoon ($4.01 in chips)
Seat 5: degelcamus ($2 in chips)
Seat 6: LLregs ($19.32 in chips)
teletubo: posts small blind $0.01
Tony-Broke: posts big blind $0.02
*** HOLE CARDS ***
Dealt to LLregs [6c 2d]
piistoon is disconnected
piistoon has timed out while disconnected
piistoon: folds
degelcamus: folds
LLregs: folds
ovi2xs: folds
teletubo: raises $0.04 to $0.06
Tony-Broke: folds
Uncalled bet ($0.04) returned to teletubo
teletubo collected $0.04 from pot
teletubo: doesn't show hand
*** SUMMARY ***
Total pot $0.04 | Rake $0
Seat 1: ovi2xs (button) folded before Flop (didn't bet)
Seat 2: teletubo (small blind) collected ($0.04)
Seat 3: Tony-Broke (big blind) folded before Flop
Seat 4: piistoon folded before Flop (didn't bet)
Seat 5: degelcamus folded before Flop (didn't bet)
Seat 6: LLregs folded before Flop (didn't bet)

PokerStars Zoom Hand #247970592771:  Hold'em No Limit ($0.01/$0.02) - 2023/12/30 23:54:06 WET [2023/12/30 18:54:06 ET]
Table 'Halley' 6-max Seat #1 is the button
Seat 1: Holding1994 ($2.04 in chips)
Seat 2: sebastiaosj ($3.15 in chips)
Seat 3: luizlobo2 ($2.26 in chips)
Seat 4: FEROIZ ($3.32 in chips)
Seat 5: LLregs ($19.32 in chips)
Seat 6: ovi2xs ($1.76 in chips)
sebastiaosj: posts small blind $0.01
luizlobo2: posts big blind $0.02
*** HOLE CARDS ***
Dealt to LLregs [Tc 3c]
FEROIZ: folds
LLregs: folds
ovi2xs: calls $0.02
Holding1994: folds
sebastiaosj: folds
luizlobo2: checks
*** FLOP *** [Th Qd 5s]
luizlobo2: checks
ovi2xs: bets $0.02
luizlobo2: folds
Uncalled bet ($0.02) returned to ovi2xs
ovi2xs collected $0.05 from pot
ovi2xs: doesn't show hand
*** SUMMARY ***
Total pot $0.05 | Rake $0
Board [Th Qd 5s]
Seat 1: Holding1994 (button) folded before Flop (didn't bet)
Seat 2: sebastiaosj (small blind) folded before Flop
Seat 3: luizlobo2 (big blind) folded on the Flop
Seat 4: FEROIZ folded before Flop (didn't bet)
Seat 5: LLregs folded before Flop (didn't bet)
Seat 6: ovi2xs collected ($0.05)

PokerStars Zoom Hand #247970593976:  Hold'em No Limit ($0.01/$0.02) - 2023/12/30 23:54:10 WET [2023/12/30 18:54:10 ET]
Table 'Halley' 6-max Seat #1 is the button
Seat 1: FISHINGJACK1 ($2.20 in chips)
Seat 2: Holding1994 ($2.04 in chips)
Seat 3: LLregs ($19.32 in chips)
Seat 4: SannBy ($2.32 in chips)
Seat 5: 232489410 ($2.98 in chips)
Seat 6: christex1 ($2.24 in chips)
Holding1994: posts small blind $0.01
LLregs: posts big blind $0.02
*** HOLE CARDS ***
Dealt to LLregs [9d As]
SannBy: folds
232489410: calls $0.02
christex1: folds
FISHINGJACK1: folds
Holding1994: folds
LLregs: checks
*** FLOP *** [7s Tc 3s]
LLregs: checks
232489410: checks
*** TURN *** [7s Tc 3s] [9c]
LLregs: bets $0.02
232489410: folds
Uncalled bet ($0.02) returned to LLregs
LLregs collected $0.05 from pot
LLregs: doesn't show hand
*** SUMMARY ***
Total pot $0.05 | Rake $0
Board [7s Tc 3s 9c]
Seat 1: FISHINGJACK1 (button) folded before Flop (didn't bet)
Seat 2: Holding1994 (small blind) folded before Flop
Seat 3: LLregs (big blind) collected ($0.05)
Seat 4: SannBy folded before Flop (didn't bet)
Seat 5: 232489410 folded on the Turn
Seat 6: christex1 folded before Flop (didn't bet)

PokerStars Zoom Hand #247970601066:  Hold'em No Limit ($0.01/$0.02) - 2023/12/30 23:54:32 WET [2023/12/30 18:54:32 ET]
Table 'Halley' 6-max Seat #1 is the button
Seat 1: christex1 ($2.22 in chips)
Seat 2: AugereDivus ($3.61 in chips)
Seat 3: STAROVERchik ($2.81 in chips)
Seat 4: 2plateado2 ($2.03 in chips)
Seat 5: Dinostzi ($1.07 in chips)
Seat 6: LLregs ($19.35 in chips)
AugereDivus: posts small blind $0.01
STAROVERchik: posts big blind $0.02
*** HOLE CARDS ***
Dealt to LLregs [Ah Js]
2plateado2: folds
Dinostzi: raises $0.04 to $0.06
LLregs: raises $0.12 to $0.18
christex1: raises $0.26 to $0.44
AugereDivus: folds
STAROVERchik: folds
Dinostzi: folds
LLregs: folds
Uncalled bet ($0.26) returned to christex1
christex1 collected $0.45 from pot
christex1: doesn't show hand
*** SUMMARY ***
Total pot $0.45 | Rake $0
Seat 1: christex1 (button) collected ($0.45)
Seat 2: AugereDivus (small blind) folded before Flop
Seat 3: STAROVERchik (big blind) folded before Flop
Seat 4: 2plateado2 folded before Flop (didn't bet)
Seat 5: Dinostzi folded before Flop
Seat 6: LLregs folded before Flop

PokerStars Zoom Hand #247970613926:  Hold'em No Limit ($0.01/$0.02) - 2023/12/30 23:55:15 WET [2023/12/30 18:55:15 ET]
Table 'Halley' 6-max Seat #1 is the button
Seat 1: LLregs ($19.16 in chips)
Seat 2: Deny0403 ($8.99 in chips)
Seat 3: Bily Bo ($2.48 in chips)
Seat 4: violacc ($1.66 in chips)
Seat 5: my sapphire ($1.92 in chips)
Seat 6: blueskyeee ($2.22 in chips)
Deny0403: posts small blind $0.01
Bily Bo: posts big blind $0.02
*** HOLE CARDS ***
Dealt to LLregs [7d 3h]
violacc: folds
my sapphire: folds
blueskyeee: folds
LLregs: folds
Deny0403: folds
Uncalled bet ($0.01) returned to Bily Bo
Bily Bo collected $0.02 from pot
Bily Bo: doesn't show hand
*** SUMMARY ***
Total pot $0.02 | Rake $0
Seat 1: LLregs (button) folded before Flop (didn't bet)
Seat 2: Deny0403 (small blind) folded before Flop
Seat 3: Bily Bo (big blind) collected ($0.02)
Seat 4: violacc folded before Flop (didn't bet)
Seat 5: my sapphire folded before Flop (didn't bet)
Seat 6: blueskyeee folded before Flop (didn't bet)

PokerStars Zoom Hand #247970612985:  Hold'em No Limit ($0.01/$0.02) - 2023/12/30 23:55:11 WET [2023/12/30 18:55:11 ET]
Table 'Halley' 6-max Seat #1 is the button
Seat 1: N0tsobig ($2.22 in chips)
Seat 2: LLregs ($19.17 in chips)
Seat 3: Kamozacre ($2.37 in chips)
Seat 4: beckzz2011 ($4.15 in chips)
Seat 5: ekipavd996 ($2.91 in chips)
Seat 6: freefrolloff ($2.90 in chips)
LLregs: posts small blind $0.01
Kamozacre: posts big blind $0.02
*** HOLE CARDS ***
Dealt to LLregs [9d 4c]
beckzz2011: folds
ekipavd996: raises $0.02 to $0.04
freefrolloff: folds
N0tsobig: folds
LLregs: folds
Kamozacre: folds
Uncalled bet ($0.02) returned to ekipavd996
ekipavd996 collected $0.05 from pot
ekipavd996: doesn't show hand
*** SUMMARY ***
Total pot $0.05 | Rake $0
Seat 1: N0tsobig (button) folded before Flop (didn't bet)
Seat 2: LLregs (small blind) folded before Flop
Seat 3: Kamozacre (big blind) folded before Flop
Seat 4: beckzz2011 folded before Flop (didn't bet)
Seat 5: ekipavd996 collected ($0.05)
Seat 6: freefrolloff folded before Flop (didn't bet)

PokerStars Zoom Hand #247970617186:  Hold'em No Limit ($0.01/$0.02) - 2023/12/30 23:55:28 WET [2023/12/30 18:55:28 ET]
Table 'Halley' 6-max Seat #1 is the button
Seat 1: N0tsobig ($2.22 in chips)
Seat 2: FEROIZ ($1.73 in chips)
Seat 3: Wahnsinn24 ($2.47 in chips)
Seat 4: WEBOO1 ($3.21 in chips)
Seat 5: AugereDivus ($5.47 in chips)
Seat 6: LLregs ($19.16 in chips)
FEROIZ: posts small blind $0.01
Wahnsinn24: posts big blind $0.02
*** HOLE CARDS ***
Dealt to LLregs [Js 4h]
WEBOO1: raises $0.04 to $0.06
AugereDivus: folds
LLregs: folds
N0tsobig: folds
FEROIZ: folds
Wahnsinn24: folds
Uncalled bet ($0.04) returned to WEBOO1
WEBOO1 collected $0.05 from pot
WEBOO1: doesn't show hand
*** SUMMARY ***
Total pot $0.05 | Rake $0
Seat 1: N0tsobig (button) folded before Flop (didn't bet)
Seat 2: FEROIZ (small blind) folded before Flop
Seat 3: Wahnsinn24 (big blind) folded before Flop
Seat 4: WEBOO1 collected ($0.05)
Seat 5: AugereDivus folded before Flop (didn't bet)
Seat 6: LLregs folded before Flop (didn't bet)

PokerStars Zoom Hand #247970618186:  Hold'em No Limit ($0.01/$0.02) - 2023/12/30 23:55:32 WET [2023/12/30 18:55:32 ET]
Table 'Halley' 6-max Seat #1 is the button
Seat 1: FEROIZ ($1.72 in chips)
Seat 2: 888lifeIS ($2.06 in chips)
Seat 3: LLregs ($19.16 in chips)
Seat 4: degelcamus ($4.70 in chips)
Seat 5: GeRA XG ($0.85 in chips)
Seat 6: NoDenyPanda ($5.20 in chips)
888lifeIS: posts small blind $0.01
LLregs: posts big blind $0.02
*** HOLE CARDS ***
Dealt to LLregs [Ks 4c]
degelcamus: folds
GeRA XG: folds
NoDenyPanda: folds
FEROIZ: raises $0.03 to $0.05
888lifeIS: folds
LLregs: folds
Uncalled bet ($0.03) returned to FEROIZ
FEROIZ collected $0.05 from pot
FEROIZ: doesn't show hand
*** SUMMARY ***
Total pot $0.05 | Rake $0
Seat 1: FEROIZ (button) collected ($0.05)
Seat 2: 888lifeIS (small blind) folded before Flop
Seat 3: LLregs (big blind) folded before Flop
Seat 4: degelcamus folded before Flop (didn't bet)
Seat 5: GeRA XG folded before Flop (didn't bet)
Seat 6: NoDenyPanda folded before Flop (didn't bet)

PokerStars Zoom Hand #247970615932:  Hold'em No Limit ($0.01/$0.02) - 2023/12/30 23:55:23 WET [2023/12/30 18:55:23 ET]
Table 'Halley' 6-max Seat #1 is the button
Seat 1: beckzz2011 ($2.01 in chips)
Seat 2: jjuul ($2.36 in chips)
Seat 3: Franca682 ($2.53 in chips)
Seat 4: LLregs ($19.16 in chips)
Seat 5: Bily Bo ($2.49 in chips)
Seat 6: Leoo00oo ($2.31 in chips)
jjuul: posts small blind $0.01
Franca682: posts big blind $0.02
*** HOLE CARDS ***
Dealt to LLregs [5s 2h]
LLregs: folds
Bily Bo: folds
Leoo00oo: folds
beckzz2011: folds
jjuul: raises $0.04 to $0.06
Franca682: calls $0.04
*** FLOP *** [Ks 4c Ad]
jjuul: checks
Franca682: bets $0.02
jjuul: calls $0.02
*** TURN *** [Ks 4c Ad] [2d]
jjuul: checks
Franca682: checks
*** RIVER *** [Ks 4c Ad 2d] [5c]
jjuul: checks
Franca682: checks
*** SHOW DOWN ***
jjuul: shows [Kc 9c] (a pair of Kings)
Franca682: mucks hand
jjuul collected $0.15 from pot
*** SUMMARY ***
Total pot $0.16 | Rake $0.01
Board [Ks 4c Ad 2d 5c]
Seat 1: beckzz2011 (button) folded before Flop (didn't bet)
Seat 2: jjuul (small blind) showed [Kc 9c] and won ($0.15) with a pair of Kings
Seat 3: Franca682 (big blind) mucked [Jc 8d]
Seat 4: LLregs folded before Flop (didn't bet)
Seat 5: Bily Bo folded before Flop (didn't bet)
Seat 6: Leoo00oo folded before Flop (didn't bet)

PokerStars Zoom Hand #247970614844:  Hold'em No Limit ($0.01/$0.02) - 2023/12/30 23:55:19 WET [2023/12/30 18:55:19 ET]
Table 'Halley' 6-max Seat #1 is the button
Seat 1: christex1 ($2.48 in chips)
Seat 2: MhtsosDhm ($4.08 in chips)
Seat 3: Shmatrixs ($4.51 in chips)
Seat 4: AugereDivus ($3.58 in chips)
Seat 5: LLregs ($19.16 in chips)
Seat 6: Deny0403 ($8.98 in chips)
MhtsosDhm: posts small blind $0.01
Shmatrixs: posts big blind $0.02
*** HOLE CARDS ***
Dealt to LLregs [3c 3s]
AugereDivus: folds
LLregs: folds
Deny0403: folds
christex1: folds
MhtsosDhm: raises $0.03 to $0.05
Shmatrixs: raises $0.15 to $0.20
MhtsosDhm: calls $0.15
*** FLOP *** [Jc Ah 7d]
MhtsosDhm: checks
Shmatrixs: checks
*** TURN *** [Jc Ah 7d] [Ks]
MhtsosDhm: bets $0.30
Shmatrixs: calls $0.30
*** RIVER *** [Jc Ah 7d Ks] [2h]
MhtsosDhm: bets $1
Shmatrixs: folds
Uncalled bet ($1) returned to MhtsosDhm
MhtsosDhm collected $0.96 from pot
MhtsosDhm: doesn't show hand
*** SUMMARY ***
Total pot $1 | Rake $0.04
Board [Jc Ah 7d Ks 2h]
Seat 1: christex1 (button) folded before Flop (didn't bet)
Seat 2: MhtsosDhm (small blind) collected ($0.96)
Seat 3: Shmatrixs (big blind) folded on the River
Seat 4: AugereDivus folded before Flop (didn't bet)
Seat 5: LLregs folded before Flop (didn't bet)
Seat 6: Deny0403 folded before Flop (didn't bet)

PokerStars Zoom Hand #247970622411:  Hold'em No Limit ($0.01/$0.02) - 2023/12/30 23:55:49 WET [2023/12/30 18:55:49 ET]
Table 'Halley' 6-max Seat #1 is the button
Seat 1: Ukr Troll ($5.12 in chips)
Seat 2: christex1 ($2.46 in chips)
Seat 3: ovi2xs ($1.87 in chips)
Seat 4: LLregs ($19.14 in chips)
Seat 5: Bergländer ($0.77 in chips)
Seat 6: erru9107 ($1.92 in chips)
christex1: posts small blind $0.01
ovi2xs: posts big blind $0.02
*** HOLE CARDS ***
Dealt to LLregs [7c 2d]
LLregs: folds
Bergländer: folds
erru9107: folds
Ukr Troll: raises $0.02 to $0.04
christex1: folds
ovi2xs: calls $0.02
*** FLOP *** [Tc Jc 4c]
ovi2xs: checks
Ukr Troll: bets $0.04
ovi2xs: folds
Uncalled bet ($0.04) returned to Ukr Troll
Ukr Troll collected $0.09 from pot
Ukr Troll: doesn't show hand
*** SUMMARY ***
Total pot $0.09 | Rake $0
Board [Tc Jc 4c]
Seat 1: Ukr Troll (button) collected ($0.09)
Seat 2: christex1 (small blind) folded before Flop
Seat 3: ovi2xs (big blind) folded on the Flop
Seat 4: LLregs folded before Flop (didn't bet)
Seat 5: Bergländer folded before Flop (didn't bet)
Seat 6: erru9107 folded before Flop (didn't bet)

PokerStars Zoom Hand #247970628425:  Hold'em No Limit ($0.01/$0.02) - 2023/12/30 23:56:13 WET [2023/12/30 18:56:13 ET]
Table 'Halley' 6-max Seat #1 is the button
Seat 1: LLregs ($19.13 in chips)
Seat 2: Cadu3012 ($1.09 in chips)
Seat 3: Holding1994 ($2.33 in chips)
Seat 4: jjuul ($4.24 in chips)
Seat 5: conspy84 ($5.13 in chips)
Seat 6: 5ars33r ($2.07 in chips)
Cadu3012: posts small blind $0.01
Holding1994: posts big blind $0.02
*** HOLE CARDS ***
Dealt to LLregs [7d 9h]
jjuul: folds
conspy84: folds
5ars33r: raises $0.03 to $0.05
LLregs: folds
Cadu3012: folds
Holding1994: folds
Uncalled bet ($0.03) returned to 5ars33r
5ars33r collected $0.05 from pot
5ars33r: doesn't show hand
*** SUMMARY ***
Total pot $0.05 | Rake $0
Seat 1: LLregs (button) folded before Flop (didn't bet)
Seat 2: Cadu3012 (small blind) folded before Flop
Seat 3: Holding1994 (big blind) folded before Flop
Seat 4: jjuul folded before Flop (didn't bet)
Seat 5: conspy84 folded before Flop (didn't bet)
Seat 6: 5ars33r collected ($0.05)

PokerStars Zoom Hand #247970623363:  Hold'em No Limit ($0.01/$0.02) - 2023/12/30 23:55:53 WET [2023/12/30 18:55:53 ET]
Table 'Halley' 6-max Seat #1 is the button
Seat 1: CRAZY KEFKA ($4 in chips)
Seat 2: LLregs ($19.14 in chips)
Seat 3: Wahnsinn24 ($1.31 in chips)
Seat 4: fafyny ($1.60 in chips)
Seat 5: gmansilva ($4.55 in chips)
Seat 6: christex1 ($2.45 in chips)
LLregs: posts small blind $0.01
Wahnsinn24: posts big blind $0.02
*** HOLE CARDS ***
Dealt to LLregs [Ks 5c]
fafyny: folds
gmansilva: raises $0.02 to $0.04
christex1: folds
CRAZY KEFKA: folds
LLregs: folds
Wahnsinn24: calls $0.02
*** FLOP *** [4s 3h 6d]
Wahnsinn24: checks
gmansilva: checks
*** TURN *** [4s 3h 6d] [Qd]
Wahnsinn24: checks
gmansilva: bets $0.14
Wahnsinn24: folds
Uncalled bet ($0.14) returned to gmansilva
gmansilva collected $0.09 from pot
gmansilva: doesn't show hand
*** SUMMARY ***
Total pot $0.09 | Rake $0
Board [4s 3h 6d Qd]
Seat 1: CRAZY KEFKA (button) folded before Flop (didn't bet)
Seat 2: LLregs (small blind) folded before Flop
Seat 3: Wahnsinn24 (big blind) folded on the Turn
Seat 4: fafyny folded before Flop (didn't bet)
Seat 5: gmansilva collected ($0.09)
Seat 6: christex1 folded before Flop (didn't bet)

PokerStars Zoom Hand #247970631189:  Hold'em No Limit ($0.01/$0.02) - 2023/12/30 23:56:24 WET [2023/12/30 18:56:24 ET]
Table 'Halley' 6-max Seat #1 is the button
Seat 1: Raymond322 ($4.76 in chips)
Seat 2: Phantom Aces 1 ($2.25 in chips)
Seat 3: LLregs ($19.13 in chips)
Seat 4: lemmy2719 ($3.62 in chips)
Seat 5: Kamozacre ($2.08 in chips)
Seat 6: Deny0403 ($8.89 in chips)
Phantom Aces 1: posts small blind $0.01
LLregs: posts big blind $0.02
*** HOLE CARDS ***
Dealt to LLregs [Ac 4c]
lemmy2719: folds
Kamozacre: folds
Deny0403: raises $0.04 to $0.06
Raymond322: folds
Phantom Aces 1: folds
LLregs: calls $0.04
*** FLOP *** [Qs Kh 7h]
LLregs: checks
Deny0403: bets $0.09
LLregs: folds
Uncalled bet ($0.09) returned to Deny0403
Deny0403 collected $0.13 from pot
Deny0403: doesn't show hand
*** SUMMARY ***
Total pot $0.13 | Rake $0
Board [Qs Kh 7h]
Seat 1: Raymond322 (button) folded before Flop (didn't bet)
Seat 2: Phantom Aces 1 (small blind) folded before Flop
Seat 3: LLregs (big blind) folded on the Flop
Seat 4: lemmy2719 folded before Flop (didn't bet)
Seat 5: Kamozacre folded before Flop (didn't bet)
Seat 6: Deny0403 collected ($0.13)

PokerStars Zoom Hand #247970637104:  Hold'em No Limit ($0.01/$0.02) - 2023/12/30 23:56:48 WET [2023/12/30 18:56:48 ET]
Table 'Halley' 6-max Seat #1 is the button
Seat 1: huevo_nob10 ($2.06 in chips)
Seat 2: mataski ($3.02 in chips)
Seat 3: xink3r7 ($2.24 in chips)
Seat 4: 52outsxx ($1.41 in chips)
Seat 5: jandsonpower ($2.31 in chips)
Seat 6: LLregs ($19.07 in chips)
mataski: posts small blind $0.01
xink3r7: posts big blind $0.02
*** HOLE CARDS ***
Dealt to LLregs [6h Qd]
52outsxx: folds
jandsonpower: folds
LLregs: folds
huevo_nob10: folds
mataski: raises $0.04 to $0.06
xink3r7: folds
Uncalled bet ($0.04) returned to mataski
mataski collected $0.04 from pot
mataski: doesn't show hand
*** SUMMARY ***
Total pot $0.04 | Rake $0
Seat 1: huevo_nob10 (button) folded before Flop (didn't bet)
Seat 2: mataski (small blind) collected ($0.04)
Seat 3: xink3r7 (big blind) folded before Flop
Seat 4: 52outsxx folded before Flop (didn't bet)
Seat 5: jandsonpower folded before Flop (didn't bet)
Seat 6: LLregs folded before Flop (didn't bet)

PokerStars Zoom Hand #247970638081:  Hold'em No Limit ($0.01/$0.02) - 2023/12/30 23:56:52 WET [2023/12/30 18:56:52 ET]
Table 'Halley' 6-max Seat #1 is the button
Seat 1: MhtsosDhm ($2.19 in chips)
Seat 2: AugereDivus ($3.29 in chips)
Seat 3: zat210 ($1.79 in chips)
Seat 4: Kamozacre ($2.36 in chips)
Seat 5: LLregs ($19.07 in chips)
Seat 6: Capitari ($2 in chips)
AugereDivus: posts small blind $0.01
zat210: posts big blind $0.02
*** HOLE CARDS ***
Dealt to LLregs [5s As]
Kamozacre: raises $0.02 to $0.04
LLregs: folds
Capitari: folds
MhtsosDhm: folds
AugereDivus: folds
zat210: calls $0.02
*** FLOP *** [5h 4d 4s]
zat210: checks
Kamozacre: bets $0.03
zat210: folds
Uncalled bet ($0.03) returned to Kamozacre
Kamozacre collected $0.09 from pot
Kamozacre: doesn't show hand
*** SUMMARY ***
Total pot $0.09 | Rake $0
Board [5h 4d 4s]
Seat 1: MhtsosDhm (button) folded before Flop (didn't bet)
Seat 2: AugereDivus (small blind) folded before Flop
Seat 3: zat210 (big blind) folded on the Flop
Seat 4: Kamozacre collected ($0.09)
Seat 5: LLregs folded before Flop (didn't bet)
Seat 6: Capitari folded before Flop (didn't bet)

PokerStars Zoom Hand #247970639168:  Hold'em No Limit ($0.01/$0.02) - 2023/12/30 23:56:56 WET [2023/12/30 18:56:56 ET]
Table 'Halley' 6-max Seat #1 is the button
Seat 1: LLregs ($19.07 in chips)
Seat 2: Wahnsinn24 ($2.44 in chips)
Seat 3: Deny0403 ($8.96 in chips)
Seat 4: MhtsosDhm ($4.85 in chips)
Seat 5: Communist654 ($4.04 in chips)
Seat 6: Ukr Troll ($5.27 in chips)
Wahnsinn24: posts small blind $0.01
Deny0403: posts big blind $0.02
*** HOLE CARDS ***
Dealt to LLregs [9d Kd]
MhtsosDhm: folds
Communist654: folds
Ukr Troll: raises $0.02 to $0.04
LLregs: calls $0.04
Wahnsinn24: folds
Deny0403: folds
*** FLOP *** [8s 5c 4c]
Ukr Troll: checks
LLregs: checks
*** TURN *** [8s 5c 4c] [Kh]
Ukr Troll: checks
LLregs: bets $0.04
Ukr Troll: folds
Uncalled bet ($0.04) returned to LLregs
LLregs collected $0.11 from pot
LLregs: doesn't show hand
*** SUMMARY ***
Total pot $0.11 | Rake $0
Board [8s 5c 4c Kh]
Seat 1: LLregs (button) collected ($0.11)
Seat 2: Wahnsinn24 (small blind) folded before Flop
Seat 3: Deny0403 (big blind) folded before Flop
Seat 4: MhtsosDhm folded before Flop (didn't bet)
Seat 5: Communist654 folded before Flop (didn't bet)
Seat 6: Ukr Troll folded on the Turn

PokerStars Zoom Hand #247970647967:  Hold'em No Limit ($0.01/$0.02) - 2023/12/30 23:57:31 WET [2023/12/30 18:57:31 ET]
Table 'Halley' 6-max Seat #1 is the button
Seat 1: GeRA XG ($2.94 in chips)
Seat 2: LLregs ($19.14 in chips)
Seat 3: Bily Bo ($2 in chips)
Seat 4: AugereDivus ($6.57 in chips)
Seat 5: JuanChu070 ($2.94 in chips)
Seat 6: altertan ($2.16 in chips)
LLregs: posts small blind $0.01
Bily Bo: posts big blind $0.02
*** HOLE CARDS ***
Dealt to LLregs [2s 3s]
AugereDivus: folds
JuanChu070: folds
altertan: folds
GeRA XG: folds
LLregs: folds
Uncalled bet ($0.01) returned to Bily Bo
Bily Bo collected $0.02 from pot
Bily Bo: doesn't show hand
*** SUMMARY ***
Total pot $0.02 | Rake $0
Seat 1: GeRA XG (button) folded before Flop (didn't bet)
Seat 2: LLregs (small blind) folded before Flop
Seat 3: Bily Bo (big blind) collected ($0.02)
Seat 4: AugereDivus folded before Flop (didn't bet)
Seat 5: JuanChu070 folded before Flop (didn't bet)
Seat 6: altertan folded before Flop (didn't bet)

PokerStars Zoom Hand #247970651264:  Hold'em No Limit ($0.01/$0.02) - 2023/12/30 23:57:44 WET [2023/12/30 18:57:44 ET]
Table 'Halley' 6-max Seat #1 is the button
Seat 1: huevo_nob10 ($2 in chips)
Seat 2: NeckCarp ($0.99 in chips)
Seat 3: LLregs ($19.13 in chips)
Seat 4: Maariancs ($2.01 in chips)
Seat 5: my sapphire ($2.74 in chips)
Seat 6: Jungl3 Julia ($2.82 in chips)
NeckCarp: posts small blind $0.01
LLregs: posts big blind $0.02
*** HOLE CARDS ***
Dealt to LLregs [Ts 6c]
Maariancs: folds
my sapphire: folds
Jungl3 Julia: folds
huevo_nob10: folds
NeckCarp: folds
Uncalled bet ($0.01) returned to LLregs
LLregs collected $0.02 from pot
LLregs: doesn't show hand
*** SUMMARY ***
Total pot $0.02 | Rake $0
Seat 1: huevo_nob10 (button) folded before Flop (didn't bet)
Seat 2: NeckCarp (small blind) folded before Flop
Seat 3: LLregs (big blind) collected ($0.02)
Seat 4: Maariancs folded before Flop (didn't bet)
Seat 5: my sapphire folded before Flop (didn't bet)
Seat 6: Jungl3 Julia folded before Flop (didn't bet)

PokerStars Zoom Hand #247970656205:  Hold'em No Limit ($0.01/$0.02) - 2023/12/30 23:58:04 WET [2023/12/30 18:58:04 ET]
Table 'Halley' 6-max Seat #1 is the button
Seat 1: Savile ($2.06 in chips)
Seat 2: Leoo00oo ($2.35 in chips)
Seat 3: mataski ($2.66 in chips)
Seat 4: LLregs ($19.14 in chips)
Seat 5: leedsrounder ($2.17 in chips)
Seat 6: christex1 ($2.18 in chips)
Leoo00oo: posts small blind $0.01
mataski: posts big blind $0.02
*** HOLE CARDS ***
Dealt to LLregs [7d 3h]
LLregs: folds
leedsrounder: folds
christex1: folds
Savile: raises $0.04 to $0.06
Leoo00oo: folds
mataski: folds
Uncalled bet ($0.04) returned to Savile
Savile collected $0.05 from pot
Savile: doesn't show hand
*** SUMMARY ***
Total pot $0.05 | Rake $0
Seat 1: Savile (button) collected ($0.05)
Seat 2: Leoo00oo (small blind) folded before Flop
Seat 3: mataski (big blind) folded before Flop
Seat 4: LLregs folded before Flop (didn't bet)
Seat 5: leedsrounder folded before Flop (didn't bet)
Seat 6: christex1 folded before Flop (didn't bet)

PokerStars Zoom Hand #247970654924:  Hold'em No Limit ($0.01/$0.02) - 2023/12/30 23:57:59 WET [2023/12/30 18:57:59 ET]
Table 'Halley' 6-max Seat #1 is the button
Seat 1: Holding1994 ($4.19 in chips)
Seat 2: JuanChu070 ($2.92 in chips)
Seat 3: trickywizard64 ($1.93 in chips)
Seat 4: LLregs ($19.14 in chips)
Seat 5: WEBOO1 ($5.05 in chips)
Seat 6: MhtsosDhm ($4.78 in chips)
JuanChu070: posts small blind $0.01
trickywizard64: posts big blind $0.02
*** HOLE CARDS ***
Dealt to LLregs [2h 5d]
LLregs: folds
WEBOO1: folds
MhtsosDhm: raises $0.03 to $0.05
Holding1994: folds
JuanChu070: folds
trickywizard64: folds
Uncalled bet ($0.03) returned to MhtsosDhm
MhtsosDhm collected $0.05 from pot
MhtsosDhm: doesn't show hand
*** SUMMARY ***
Total pot $0.05 | Rake $0
Seat 1: Holding1994 (button) folded before Flop (didn't bet)
Seat 2: JuanChu070 (small blind) folded before Flop
Seat 3: trickywizard64 (big blind) folded before Flop
Seat 4: LLregs folded before Flop (didn't bet)
Seat 5: WEBOO1 folded before Flop (didn't bet)
Seat 6: MhtsosDhm collected ($0.05)

PokerStars Zoom Hand #247970658628:  Hold'em No Limit ($0.01/$0.02) - 2023/12/30 23:58:14 WET [2023/12/30 18:58:14 ET]
Table 'Halley' 6-max Seat #1 is the button
Seat 1: LLregs ($19.14 in chips)
Seat 2: 52outsxx ($1.43 in chips)
Seat 3: 888lifeIS ($2 in chips)
Seat 4: huevo_nob10 ($2.01 in chips)
Seat 5: rounder_rf ($2 in chips)
Seat 6: leedsrounder ($2.17 in chips)
52outsxx: posts small blind $0.01
888lifeIS: posts big blind $0.02
*** HOLE CARDS ***
Dealt to LLregs [Ad 5c]
huevo_nob10: folds
rounder_rf: raises $0.04 to $0.06
leedsrounder: folds
LLregs: folds
52outsxx: folds
888lifeIS: folds
Uncalled bet ($0.04) returned to rounder_rf
rounder_rf collected $0.05 from pot
rounder_rf: doesn't show hand
*** SUMMARY ***
Total pot $0.05 | Rake $0
Seat 1: LLregs (button) folded before Flop (didn't bet)
Seat 2: 52outsxx (small blind) folded before Flop
Seat 3: 888lifeIS (big blind) folded before Flop
Seat 4: huevo_nob10 folded before Flop (didn't bet)
Seat 5: rounder_rf collected ($0.05)
Seat 6: leedsrounder folded before Flop (didn't bet)

PokerStars Zoom Hand #247970659490:  Hold'em No Limit ($0.01/$0.02) - 2023/12/30 23:58:18 WET [2023/12/30 18:58:18 ET]
Table 'Halley' 6-max Seat #1 is the button
Seat 1: Tombombadillo88 ($1.25 in chips)
Seat 2: mjeenetto ($2.05 in chips)
Seat 3: Holding1994 ($2.12 in chips)
Seat 4: frankquanki ($15.18 in chips)
Seat 5: LLregs ($19.14 in chips)
Seat 6: Savile ($2.09 in chips)
mjeenetto: posts small blind $0.01
Holding1994: posts big blind $0.02
*** HOLE CARDS ***
Dealt to LLregs [Ac 3h]
frankquanki: folds
LLregs: folds
Savile: folds
Tombombadillo88: folds
mjeenetto: calls $0.01
Holding1994: raises $0.08 to $0.10
mjeenetto: folds
Uncalled bet ($0.08) returned to Holding1994
Holding1994 collected $0.04 from pot
Holding1994: doesn't show hand
*** SUMMARY ***
Total pot $0.04 | Rake $0
Seat 1: Tombombadillo88 (button) folded before Flop (didn't bet)
Seat 2: mjeenetto (small blind) folded before Flop
Seat 3: Holding1994 (big blind) collected ($0.04)
Seat 4: frankquanki folded before Flop (didn't bet)
Seat 5: LLregs folded before Flop (didn't bet)
Seat 6: Savile folded before Flop (didn't bet)

PokerStars Zoom Hand #247970662425:  Hold'em No Limit ($0.01/$0.02) - 2023/12/30 23:58:29 WET [2023/12/30 18:58:29 ET]
Table 'Halley' 6-max Seat #1 is the button
Seat 1: jjuul ($3.80 in chips)
Seat 2: Capitari ($2.07 in chips)
Seat 3: LLregs ($19.13 in chips)
Seat 4: enixblr ($2 in chips)
Seat 5: sebastiaosj ($2.90 in chips)
Seat 6: dealmekkplease ($3.44 in chips)
Capitari: posts small blind $0.01
LLregs: posts big blind $0.02
*** HOLE CARDS ***
Dealt to LLregs [Qs 3c]
enixblr: folds
sebastiaosj: folds
dealmekkplease: folds
jjuul: folds
Capitari: folds
Uncalled bet ($0.01) returned to LLregs
LLregs collected $0.02 from pot
LLregs: doesn't show hand
*** SUMMARY ***
Total pot $0.02 | Rake $0
Seat 1: jjuul (button) folded before Flop (didn't bet)
Seat 2: Capitari (small blind) folded before Flop
Seat 3: LLregs (big blind) collected ($0.02)
Seat 4: enixblr folded before Flop (didn't bet)
Seat 5: sebastiaosj folded before Flop (didn't bet)
Seat 6: dealmekkplease folded before Flop (didn't bet)

PokerStars Zoom Hand #247970661409:  Hold'em No Limit ($0.01/$0.02) - 2023/12/30 23:58:25 WET [2023/12/30 18:58:25 ET]
Table 'Halley' 6-max Seat #1 is the button
Seat 1: hondaandy ($0.62 in chips)
Seat 2: NoDenyPanda ($2.38 in chips)
Seat 3: simplydochry ($2 in chips)
Seat 4: JuanChu070 ($2.91 in chips)
Seat 5: LLregs ($19.13 in chips)
Seat 6: Dspecial77 ($2.11 in chips)
NoDenyPanda: posts small blind $0.01
simplydochry: posts big blind $0.02
*** HOLE CARDS ***
Dealt to LLregs [9c 4c]
JuanChu070: folds
LLregs: folds
Dspecial77: folds
hondaandy: calls $0.02
NoDenyPanda: folds
simplydochry: checks
*** FLOP *** [Qd 8c 4d]
simplydochry: checks
hondaandy: checks
*** TURN *** [Qd 8c 4d] [3d]
simplydochry: bets $0.04
hondaandy: folds
Uncalled bet ($0.04) returned to simplydochry
simplydochry collected $0.05 from pot
simplydochry: doesn't show hand
*** SUMMARY ***
Total pot $0.05 | Rake $0
Board [Qd 8c 4d 3d]
Seat 1: hondaandy (button) folded on the Turn
Seat 2: NoDenyPanda (small blind) folded before Flop
Seat 3: simplydochry (big blind) collected ($0.05)
Seat 4: JuanChu070 folded before Flop (didn't bet)
Seat 5: LLregs folded before Flop (didn't bet)
Seat 6: Dspecial77 folded before Flop (didn't bet)

PokerStars Zoom Hand #247970657190:  Hold'em No Limit ($0.01/$0.02) - 2023/12/30 23:58:08 WET [2023/12/30 18:58:08 ET]
Table 'Halley' 6-max Seat #1 is the button
Seat 1: JuanChu070 ($2.91 in chips)
Seat 2: 888lifeIS ($2.37 in chips)
Seat 3: Jungl3 Julia ($2.81 in chips)
Seat 4: conspy84 ($5.06 in chips)
Seat 5: szajm ($2.26 in chips)
Seat 6: LLregs ($19.14 in chips)
888lifeIS: posts small blind $0.01
Jungl3 Julia: posts big blind $0.02
*** HOLE CARDS ***
Dealt to LLregs [7d Ts]
conspy84: folds
szajm: folds
LLregs: folds
JuanChu070: folds
888lifeIS: raises $0.02 to $0.04
Jungl3 Julia: calls $0.02
*** FLOP *** [Qs 6d Kd]
888lifeIS: checks
Jungl3 Julia: checks
*** TURN *** [Qs 6d Kd] [7h]
888lifeIS: bets $0.05
Jungl3 Julia: folds
Uncalled bet ($0.05) returned to 888lifeIS
888lifeIS collected $0.08 from pot
888lifeIS: doesn't show hand
*** SUMMARY ***
Total pot $0.08 | Rake $0
Board [Qs 6d Kd 7h]
Seat 1: JuanChu070 (button) folded before Flop (didn't bet)
Seat 2: 888lifeIS (small blind) collected ($0.08)
Seat 3: Jungl3 Julia (big blind) folded on the Turn
Seat 4: conspy84 folded before Flop (didn't bet)
Seat 5: szajm folded before Flop (didn't bet)
Seat 6: LLregs folded before Flop (didn't bet)

PokerStars Zoom Hand #247970660392:  Hold'em No Limit ($0.01/$0.02) - 2023/12/30 23:58:21 WET [2023/12/30 18:58:21 ET]
Table 'Halley' 6-max Seat #1 is the button
Seat 1: violacc ($1.56 in chips)
Seat 2: LLregs ($19.14 in chips)
Seat 3: LeBreton67 ($1.81 in chips)
Seat 4: degelcamus ($5.89 in chips)
Seat 5: GarotoMaroto#1 ($0.97 in chips)
Seat 6: kaio brenno ($1.92 in chips)
LLregs: posts small blind $0.01
LeBreton67: posts big blind $0.02
*** HOLE CARDS ***
Dealt to LLregs [Kd 7c]
degelcamus: folds
GarotoMaroto#1: raises $0.02 to $0.04
kaio brenno: folds
violacc: folds
LLregs: folds
LeBreton67: calls $0.02
*** FLOP *** [As 6d 9h]
LeBreton67: bets $0.04
GarotoMaroto#1: calls $0.04
*** TURN *** [As 6d 9h] [6h]
LeBreton67: bets $0.08
GarotoMaroto#1: raises $0.08 to $0.16
LeBreton67: calls $0.08
*** RIVER *** [As 6d 9h 6h] [Jh]
LeBreton67: checks
GarotoMaroto#1: bets $0.06
LeBreton67: calls $0.06
*** SHOW DOWN ***
GarotoMaroto#1: shows [9d Ah] (two pair, Aces and Nines)
LeBreton67: mucks hand
GarotoMaroto#1 collected $0.59 from pot
*** SUMMARY ***
Total pot $0.61 | Rake $0.02
Board [As 6d 9h 6h Jh]
Seat 1: violacc (button) folded before Flop (didn't bet)
Seat 2: LLregs (small blind) folded before Flop
Seat 3: LeBreton67 (big blind) mucked [7s Ad]
Seat 4: degelcamus folded before Flop (didn't bet)
Seat 5: GarotoMaroto#1 showed [9d Ah] and won ($0.59) with two pair, Aces and Nines
Seat 6: kaio brenno folded before Flop (didn't bet)

PokerStars Zoom Hand #247970664954:  Hold'em No Limit ($0.01/$0.02) - 2023/12/30 23:58:39 WET [2023/12/30 18:58:39 ET]
Table 'Halley' 6-max Seat #1 is the button
Seat 1: edgarones ($2.78 in chips)
Seat 2: Phantom Aces 1 ($2.02 in chips)
Seat 3: MhtsosDhm ($4.11 in chips)
Seat 4: mataski ($3.61 in chips)
Seat 5: teletubo ($2.37 in chips)
Seat 6: LLregs ($19.14 in chips)
Phantom Aces 1: posts small blind $0.01
MhtsosDhm: posts big blind $0.02
*** HOLE CARDS ***
Dealt to LLregs [7c Jc]
mataski: folds
teletubo: folds
LLregs: raises $0.04 to $0.06
edgarones: folds
Phantom Aces 1: folds
MhtsosDhm: calls $0.04
*** FLOP *** [2h 7h 9s]
MhtsosDhm: checks
LLregs: bets $0.06
MhtsosDhm: folds
Uncalled bet ($0.06) returned to LLregs
LLregs collected $0.13 from pot
LLregs: doesn't show hand
*** SUMMARY ***
Total pot $0.13 | Rake $0
Board [2h 7h 9s]
Seat 1: edgarones (button) folded before Flop (didn't bet)
Seat 2: Phantom Aces 1 (small blind) folded before Flop
Seat 3: MhtsosDhm (big blind) folded on the Flop
Seat 4: mataski folded before Flop (didn't bet)
Seat 5: teletubo folded before Flop (didn't bet)
Seat 6: LLregs collected ($0.13)

PokerStars Zoom Hand #247970671677:  Hold'em No Limit ($0.01/$0.02) - 2023/12/30 23:59:06 WET [2023/12/30 18:59:06 ET]
Table 'Halley' 6-max Seat #1 is the button
Seat 1: Dspecial77 ($2 in chips)
Seat 2: LLregs ($19.21 in chips)
Seat 3: Frijolesconarro ($2.09 in chips)
Seat 4: Josip1119 ($2.05 in chips)
Seat 5: edgarones ($2.75 in chips)
Seat 6: Xx ZolDo xX ($2.64 in chips)
LLregs: posts small blind $0.01
Frijolesconarro: posts big blind $0.02
*** HOLE CARDS ***
Dealt to LLregs [9s 4s]
Josip1119: raises $0.04 to $0.06
edgarones: folds
Xx ZolDo xX: folds
Dspecial77: raises $0.15 to $0.21
LLregs: folds
Frijolesconarro: folds
Josip1119: calls $0.15
*** FLOP *** [Ah 2s 2h]
Josip1119: checks
Dspecial77: checks
*** TURN *** [Ah 2s 2h] [6d]
Josip1119: bets $0.22
Dspecial77: calls $0.22
*** RIVER *** [Ah 2s 2h 6d] [9c]
Josip1119: bets $0.43
Dspecial77: calls $0.43
*** SHOW DOWN ***
Josip1119: shows [Ac 9h] (two pair, Aces and Nines)
Dspecial77: mucks hand
Josip1119 collected $1.69 from pot
*** SUMMARY ***
Total pot $1.75 | Rake $0.06
Board [Ah 2s 2h 6d 9c]
Seat 1: Dspecial77 (button) mucked [Ks Kc]
Seat 2: LLregs (small blind) folded before Flop
Seat 3: Frijolesconarro (big blind) folded before Flop
Seat 4: Josip1119 showed [Ac 9h] and won ($1.69) with two pair, Aces and Nines
Seat 5: edgarones folded before Flop (didn't bet)
Seat 6: Xx ZolDo xX folded before Flop (didn't bet)

PokerStars Zoom Hand #247970675511:  Hold'em No Limit ($0.01/$0.02) - 2023/12/30 23:59:22 WET [2023/12/30 18:59:22 ET]
Table 'Halley' 6-max Seat #1 is the button
Seat 1: Hamodii86 ($2.66 in chips)
Seat 2: Ukr Troll ($1.87 in chips)
Seat 3: Harold_Seven ($1.06 in chips)
Seat 4: beckzz2011 ($2.51 in chips)
Seat 5: LLregs ($19.20 in chips)
Seat 6: Dinostzi ($1.03 in chips)
Ukr Troll: posts small blind $0.01
Harold_Seven: posts big blind $0.02
*** HOLE CARDS ***
Dealt to LLregs [Qh As]
beckzz2011: folds
LLregs: raises $0.04 to $0.06
Dinostzi: folds
Hamodii86: folds
Ukr Troll: folds
Harold_Seven: folds
Uncalled bet ($0.04) returned to LLregs
LLregs collected $0.05 from pot
LLregs: doesn't show hand
*** SUMMARY ***
Total pot $0.05 | Rake $0
Seat 1: Hamodii86 (button) folded before Flop (didn't bet)
Seat 2: Ukr Troll (small blind) folded before Flop
Seat 3: Harold_Seven (big blind) folded before Flop
Seat 4: beckzz2011 folded before Flop (didn't bet)
Seat 5: LLregs collected ($0.05)
Seat 6: Dinostzi folded before Flop (didn't bet)

PokerStars Zoom Hand #247970673376:  Hold'em No Limit ($0.01/$0.02) - 2023/12/30 23:59:13 WET [2023/12/30 18:59:13 ET]
Table 'Halley' 6-max Seat #1 is the button
Seat 1: LLregs ($19.20 in chips)
Seat 2: Shmatrixs ($2.01 in chips)
Seat 3: CRAZY KEFKA ($3.78 in chips)
Seat 4: cesariox778 ($2.15 in chips)
Seat 5: zat210 ($1.70 in chips)
Seat 6: Savile ($2.20 in chips)
Shmatrixs: posts small blind $0.01
CRAZY KEFKA: posts big blind $0.02
*** HOLE CARDS ***
Dealt to LLregs [2h 9c]
cesariox778: raises $0.02 to $0.04
zat210: folds
Savile: calls $0.04
LLregs: folds
Shmatrixs: folds
CRAZY KEFKA: calls $0.02
*** FLOP *** [3d 2s 4s]
CRAZY KEFKA: checks
cesariox778: checks
Savile: bets $0.07
CRAZY KEFKA: calls $0.07
cesariox778: folds
*** TURN *** [3d 2s 4s] [4h]
CRAZY KEFKA: bets $0.09
Savile: folds
Uncalled bet ($0.09) returned to CRAZY KEFKA
CRAZY KEFKA collected $0.26 from pot
CRAZY KEFKA: doesn't show hand
*** SUMMARY ***
Total pot $0.27 | Rake $0.01
Board [3d 2s 4s 4h]
Seat 1: LLregs (button) folded before Flop (didn't bet)
Seat 2: Shmatrixs (small blind) folded before Flop
Seat 3: CRAZY KEFKA (big blind) collected ($0.26)
Seat 4: cesariox778 folded on the Flop
Seat 5: zat210 folded before Flop (didn't bet)
Seat 6: Savile folded on the Turn

PokerStars Zoom Hand #247970682499:  Hold'em No Limit ($0.01/$0.02) - 2023/12/30 23:59:50 WET [2023/12/30 18:59:50 ET]
Table 'Halley' 6-max Seat #1 is the button
Seat 1: CRAZY KEFKA ($3.93 in chips)
Seat 2: conspy84 ($7.51 in chips)
Seat 3: LLregs ($19.23 in chips)
Seat 4: MhtsosDhm ($4.07 in chips)
Seat 5: hugopacifico ($2.16 in chips)
Seat 6: Deny0403 ($2.36 in chips)
conspy84: posts small blind $0.01
LLregs: posts big blind $0.02
*** HOLE CARDS ***
Dealt to LLregs [9s 3s]
MhtsosDhm: folds
hugopacifico: folds
Deny0403: raises $0.04 to $0.06
CRAZY KEFKA: folds
conspy84: calls $0.05
LLregs: folds
*** FLOP *** [Th Jc 3d]
conspy84: checks
Deny0403: bets $0.09
conspy84: folds
Uncalled bet ($0.09) returned to Deny0403
Deny0403 collected $0.14 from pot
Deny0403: doesn't show hand
*** SUMMARY ***
Total pot $0.14 | Rake $0
Board [Th Jc 3d]
Seat 1: CRAZY KEFKA (button) folded before Flop (didn't bet)
Seat 2: conspy84 (small blind) folded on the Flop
Seat 3: LLregs (big blind) folded before Flop
Seat 4: MhtsosDhm folded before Flop (didn't bet)
Seat 5: hugopacifico folded before Flop (didn't bet)
Seat 6: Deny0403 collected ($0.14)

PokerStars Zoom Hand #247970685644:  Hold'em No Limit ($0.01/$0.02) - 2023/12/31 0:00:03 WET [2023/12/30 19:00:03 ET]
Table 'Halley' 6-max Seat #1 is the button
Seat 1: cliffton1980 ($1.97 in chips)
Seat 2: Phantom Aces 1 ($2.02 in chips)
Seat 3: RickyPoker ($2.07 in chips)
Seat 4: Kamozacre ($2.41 in chips)
Seat 5: LLregs ($19.21 in chips)
Seat 6: Frijolesconarro ($2.05 in chips)
Phantom Aces 1: posts small blind $0.01
RickyPoker: posts big blind $0.02
*** HOLE CARDS ***
Dealt to LLregs [Tc Qc]
Kamozacre: folds
LLregs: raises $0.04 to $0.06
Frijolesconarro: folds
cliffton1980: calls $0.06
Phantom Aces 1: folds
RickyPoker: calls $0.04
*** FLOP *** [5h Ah Jh]
RickyPoker: checks
LLregs: checks
cliffton1980: bets $0.18
RickyPoker: folds
LLregs: folds
Uncalled bet ($0.18) returned to cliffton1980
cliffton1980 collected $0.18 from pot
cliffton1980: doesn't show hand
*** SUMMARY ***
Total pot $0.19 | Rake $0.01
Board [5h Ah Jh]
Seat 1: cliffton1980 (button) collected ($0.18)
Seat 2: Phantom Aces 1 (small blind) folded before Flop
Seat 3: RickyPoker (big blind) folded on the Flop
Seat 4: Kamozacre folded before Flop (didn't bet)
Seat 5: LLregs folded on the Flop
Seat 6: Frijolesconarro folded before Flop (didn't bet)

PokerStars Zoom Hand #247970696106:  Hold'em No Limit ($0.01/$0.02) - 2023/12/31 0:00:43 WET [2023/12/30 19:00:43 ET]
Table 'Halley' 6-max Seat #1 is the button
Seat 1: my sapphire ($2.23 in chips)
Seat 2: 5ars33r ($2.62 in chips)
Seat 3: RaPoK23 ($4.29 in chips)
Seat 4: NoDenyPanda ($7.83 in chips)
Seat 5: sebastiaosj ($2.44 in chips)
Seat 6: LLregs ($19.15 in chips)
5ars33r: posts small blind $0.01
RaPoK23: posts big blind $0.02
*** HOLE CARDS ***
Dealt to LLregs [2c Jc]
NoDenyPanda: raises $0.04 to $0.06
sebastiaosj: folds
LLregs: folds
my sapphire: folds
5ars33r: folds
RaPoK23: calls $0.04
*** FLOP *** [Jd 8s Qc]
RaPoK23: checks
NoDenyPanda: bets $0.10
RaPoK23: folds
Uncalled bet ($0.10) returned to NoDenyPanda
NoDenyPanda collected $0.13 from pot
NoDenyPanda: doesn't show hand
*** SUMMARY ***
Total pot $0.13 | Rake $0
Board [Jd 8s Qc]
Seat 1: my sapphire (button) folded before Flop (didn't bet)
Seat 2: 5ars33r (small blind) folded before Flop
Seat 3: RaPoK23 (big blind) folded on the Flop
Seat 4: NoDenyPanda collected ($0.13)
Seat 5: sebastiaosj folded before Flop (didn't bet)
Seat 6: LLregs folded before Flop (didn't bet)

PokerStars Zoom Hand #247970697504:  Hold'em No Limit ($0.01/$0.02) - 2023/12/31 0:00:47 WET [2023/12/30 19:00:47 ET]
Table 'Halley' 6-max Seat #1 is the button
Seat 1: LLregs ($19.15 in chips)
Seat 2: conspy84 ($3.13 in chips)
Seat 3: hugopacifico ($2.16 in chips)
Seat 4: Kamozacre ($2.17 in chips)
Seat 5: danival2 ($2.76 in chips)
Seat 6: Deny0403 ($1.85 in chips)
conspy84: posts small blind $0.01
hugopacifico: posts big blind $0.02
*** HOLE CARDS ***
Dealt to LLregs [As Kc]
Kamozacre: folds
danival2: folds
Deny0403: folds
LLregs: raises $0.04 to $0.06
conspy84: raises $0.10 to $0.16
hugopacifico: folds
LLregs: calls $0.10
*** FLOP *** [9h 3d 9s]
conspy84: bets $0.04
LLregs: calls $0.04
*** TURN *** [9h 3d 9s] [2h]
conspy84: bets $0.04
LLregs: calls $0.04
*** RIVER *** [9h 3d 9s 2h] [7c]
conspy84: checks
LLregs: bets $0.39
conspy84: calls $0.39
*** SHOW DOWN ***
LLregs: shows [As Kc] (a pair of Nines)
conspy84: shows [Ah Ks] (a pair of Nines)
conspy84 collected $0.62 from pot
LLregs collected $0.62 from pot
*** SUMMARY ***
Total pot $1.28 | Rake $0.04
Board [9h 3d 9s 2h 7c]
Seat 1: LLregs (button) showed [As Kc] and won ($0.62) with a pair of Nines
Seat 2: conspy84 (small blind) showed [Ah Ks] and won ($0.62) with a pair of Nines
Seat 3: hugopacifico (big blind) folded before Flop
Seat 4: Kamozacre folded before Flop (didn't bet)
Seat 5: danival2 folded before Flop (didn't bet)
Seat 6: Deny0403 folded before Flop (didn't bet)

PokerStars Zoom Hand #247970710079:  Hold'em No Limit ($0.01/$0.02) - 2023/12/31 0:01:31 WET [2023/12/30 19:01:31 ET]
Table 'Halley' 6-max Seat #1 is the button
Seat 1: AAAVVV77 ($1.39 in chips)
Seat 2: degelcamus ($4.20 in chips)
Seat 3: m4tthaios ($4.07 in chips)
Seat 4: LLregs ($19.14 in chips)
Seat 5: beckzz2011 ($2 in chips)
Seat 6: conspy84 ($3.12 in chips)
degelcamus: posts small blind $0.01
m4tthaios: posts big blind $0.02
*** HOLE CARDS ***
Dealt to LLregs [7h Jh]
LLregs: folds
beckzz2011: folds
conspy84: folds
AAAVVV77: folds
degelcamus: folds
Uncalled bet ($0.01) returned to m4tthaios
m4tthaios collected $0.02 from pot
m4tthaios: doesn't show hand
*** SUMMARY ***
Total pot $0.02 | Rake $0
Seat 1: AAAVVV77 (button) folded before Flop (didn't bet)
Seat 2: degelcamus (small blind) folded before Flop
Seat 3: m4tthaios (big blind) collected ($0.02)
Seat 4: LLregs folded before Flop (didn't bet)
Seat 5: beckzz2011 folded before Flop (didn't bet)
Seat 6: conspy84 folded before Flop (didn't bet)

PokerStars Zoom Hand #247970711607:  Hold'em No Limit ($0.01/$0.02) - 2023/12/31 0:01:36 WET [2023/12/30 19:01:36 ET]
Table 'Halley' 6-max Seat #1 is the button
Seat 1: edgarones ($0.58 in chips)
Seat 2: beckzz2011 ($4.66 in chips)
Seat 3: LLregs ($19.14 in chips)
Seat 4: bornagain002 ($4.57 in chips)
Seat 5: Leoo00oo ($2.41 in chips)
Seat 6: kuelas ($2.15 in chips)
beckzz2011: posts small blind $0.01
LLregs: posts big blind $0.02
*** HOLE CARDS ***
Dealt to LLregs [2c Qh]
bornagain002: folds
Leoo00oo: folds
kuelas: raises $0.02 to $0.04
edgarones: calls $0.04
beckzz2011: folds
LLregs: folds
*** FLOP *** [Js 5h 8s]
kuelas: bets $2.11 and is all-in
edgarones: folds
Uncalled bet ($2.11) returned to kuelas
kuelas collected $0.11 from pot
kuelas: doesn't show hand
*** SUMMARY ***
Total pot $0.11 | Rake $0
Board [Js 5h 8s]
Seat 1: edgarones (button) folded on the Flop
Seat 2: beckzz2011 (small blind) folded before Flop
Seat 3: LLregs (big blind) folded before Flop
Seat 4: bornagain002 folded before Flop (didn't bet)
Seat 5: Leoo00oo folded before Flop (didn't bet)
Seat 6: kuelas collected ($0.11)

PokerStars Zoom Hand #247970715106:  Hold'em No Limit ($0.01/$0.02) - 2023/12/31 0:01:46 WET [2023/12/30 19:01:46 ET]
Table 'Halley' 6-max Seat #1 is the button
Seat 1: Harold_Seven ($3.29 in chips)
Seat 2: AugereDivus ($3.86 in chips)
Seat 3: bmisu30 ($3.58 in chips)
Seat 4: LLregs ($19.12 in chips)
Seat 5: Gambleatze ($1.30 in chips)
Seat 6: my sapphire ($7.60 in chips)
AugereDivus: posts small blind $0.01
bmisu30: posts big blind $0.02
*** HOLE CARDS ***
Dealt to LLregs [Ts Td]
LLregs: raises $0.04 to $0.06
Gambleatze: folds
my sapphire: folds
Harold_Seven: folds
AugereDivus: folds
bmisu30: calls $0.04
*** FLOP *** [2d 7s Jh]
bmisu30: checks
LLregs: checks
*** TURN *** [2d 7s Jh] [8d]
bmisu30: bets $0.02
LLregs: calls $0.02
*** RIVER *** [2d 7s Jh 8d] [6c]
bmisu30: checks
LLregs: bets $0.08
bmisu30: calls $0.08
*** SHOW DOWN ***
LLregs: shows [Ts Td] (a pair of Tens)
bmisu30: mucks hand
LLregs collected $0.32 from pot
*** SUMMARY ***
Total pot $0.33 | Rake $0.01
Board [2d 7s Jh 8d 6c]
Seat 1: Harold_Seven (button) folded before Flop (didn't bet)
Seat 2: AugereDivus (small blind) folded before Flop
Seat 3: bmisu30 (big blind) mucked [2c 4h]
Seat 4: LLregs showed [Ts Td] and won ($0.32) with a pair of Tens
Seat 5: Gambleatze folded before Flop (didn't bet)
Seat 6: my sapphire folded before Flop (didn't bet)

PokerStars Zoom Hand #247970724302:  Hold'em No Limit ($0.01/$0.02) - 2023/12/31 0:02:17 WET [2023/12/30 19:02:17 ET]
Table 'Halley' 6-max Seat #1 is the button
Seat 1: Arminsadzak88 ($1.97 in chips)
Seat 2: LLregs ($19.28 in chips)
Seat 3: Gambleatze ($1.24 in chips)
Seat 4: M1k3B4gUnc1nh4 ($2.33 in chips)
Seat 5: shovetoi ($3.77 in chips)
Seat 6: Fluffy Sable ($2.06 in chips)
LLregs: posts small blind $0.01
Gambleatze: posts big blind $0.02
*** HOLE CARDS ***
Dealt to LLregs [8h Qs]
M1k3B4gUnc1nh4: folds
shovetoi: folds
Fluffy Sable: folds
Arminsadzak88: folds
LLregs: raises $0.04 to $0.06
Gambleatze: raises $0.04 to $0.10
LLregs: calls $0.04
*** FLOP *** [Qc 5s 5h]
LLregs: bets $0.15
Gambleatze: raises $0.15 to $0.30
LLregs: raises $3.22 to $3.52
Gambleatze: calls $0.84 and is all-in
Uncalled bet ($2.38) returned to LLregs
*** TURN *** [Qc 5s 5h] [4s]
*** RIVER *** [Qc 5s 5h 4s] [8d]
*** SHOW DOWN ***
LLregs: shows [8h Qs] (two pair, Queens and Eights)
Gambleatze: shows [Jh Jd] (two pair, Jacks and Fives)
LLregs collected $2.39 from pot
*** SUMMARY ***
Total pot $2.48 | Rake $0.09
Board [Qc 5s 5h 4s 8d]
Seat 1: Arminsadzak88 (button) folded before Flop (didn't bet)
Seat 2: LLregs (small blind) showed [8h Qs] and won ($2.39) with two pair, Queens and Eights
Seat 3: Gambleatze (big blind) showed [Jh Jd] and lost with two pair, Jacks and Fives
Seat 4: M1k3B4gUnc1nh4 folded before Flop (didn't bet)
Seat 5: shovetoi folded before Flop (didn't bet)
Seat 6: Fluffy Sable folded before Flop (didn't bet)

PokerStars Zoom Hand #247970737694:  Hold'em No Limit ($0.01/$0.02) - 2023/12/31 0:03:00 WET [2023/12/30 19:03:00 ET]
Table 'Halley' 6-max Seat #1 is the button
Seat 1: my sapphire ($7.40 in chips)
Seat 2: Communist654 ($4.76 in chips)
Seat 3: Holding1994 ($2 in chips)
Seat 4: Raymond322 ($4.32 in chips)
Seat 5: döuble ägent ($4.26 in chips)
Seat 6: LLregs ($20.43 in chips)
Communist654: posts small blind $0.01
Holding1994: posts big blind $0.02
*** HOLE CARDS ***
Dealt to LLregs [Ac Js]
Raymond322: folds
döuble ägent: folds
LLregs: raises $0.04 to $0.06
my sapphire: folds
Communist654: folds
Holding1994: folds
Uncalled bet ($0.04) returned to LLregs
LLregs collected $0.05 from pot
LLregs: doesn't show hand
*** SUMMARY ***
Total pot $0.05 | Rake $0
Seat 1: my sapphire (button) folded before Flop (didn't bet)
Seat 2: Communist654 (small blind) folded before Flop
Seat 3: Holding1994 (big blind) folded before Flop
Seat 4: Raymond322 folded before Flop (didn't bet)
Seat 5: döuble ägent folded before Flop (didn't bet)
Seat 6: LLregs collected ($0.05)

PokerStars Zoom Hand #247970743726:  Hold'em No Limit ($0.01/$0.02) - 2023/12/31 0:03:19 WET [2023/12/30 19:03:19 ET]
Table 'Halley' 6-max Seat #1 is the button
Seat 1: LLregs ($20.46 in chips)
Seat 2: Fluffy Sable ($2.03 in chips)
Seat 3: frankquanki ($15.74 in chips)
Seat 4: mataski ($2.91 in chips)
Seat 5: Jrussy ($1.98 in chips)
Seat 6: LogSmaher ($1.85 in chips)
Fluffy Sable: posts small blind $0.01
frankquanki: posts big blind $0.02
*** HOLE CARDS ***
Dealt to LLregs [9s Kd]
mataski: folds
Jrussy: folds
LogSmaher: folds
LLregs: folds
Fluffy Sable: folds
Uncalled bet ($0.01) returned to frankquanki
frankquanki collected $0.02 from pot
frankquanki: doesn't show hand
*** SUMMARY ***
Total pot $0.02 | Rake $0
Seat 1: LLregs (button) folded before Flop (didn't bet)
Seat 2: Fluffy Sable (small blind) folded before Flop
Seat 3: frankquanki (big blind) collected ($0.02)
Seat 4: mataski folded before Flop (didn't bet)
Seat 5: Jrussy folded before Flop (didn't bet)
Seat 6: LogSmaher folded before Flop (didn't bet)

PokerStars Zoom Hand #247970746121:  Hold'em No Limit ($0.01/$0.02) - 2023/12/31 0:03:27 WET [2023/12/30 19:03:27 ET]
Table 'Halley' 6-max Seat #1 is the button
Seat 1: qw3306 ($2.09 in chips)
Seat 2: Raymond322 ($4.30 in chips)
Seat 3: Phantom Aces 1 ($2.32 in chips)
Seat 4: LLregs ($20.46 in chips)
Seat 5: MortaR24K ($1.63 in chips)
Seat 6: Holding1994 ($2.60 in chips)
Raymond322: posts small blind $0.01
Phantom Aces 1: posts big blind $0.02
*** HOLE CARDS ***
Dealt to LLregs [Kh 6h]
LLregs: folds
MortaR24K: folds
Holding1994: folds
qw3306: raises $0.03 to $0.05
Raymond322: folds
Phantom Aces 1: folds
Uncalled bet ($0.03) returned to qw3306
qw3306 collected $0.05 from pot
qw3306: doesn't show hand
*** SUMMARY ***
Total pot $0.05 | Rake $0
Seat 1: qw3306 (button) collected ($0.05)
Seat 2: Raymond322 (small blind) folded before Flop
Seat 3: Phantom Aces 1 (big blind) folded before Flop
Seat 4: LLregs folded before Flop (didn't bet)
Seat 5: MortaR24K folded before Flop (didn't bet)
Seat 6: Holding1994 folded before Flop (didn't bet)

PokerStars Zoom Hand #247970747420:  Hold'em No Limit ($0.01/$0.02) - 2023/12/31 0:03:32 WET [2023/12/30 19:03:32 ET]
Table 'Halley' 6-max Seat #1 is the button
Seat 1: my sapphire ($2 in chips)
Seat 2: zat210 ($1.70 in chips)
Seat 3: LLregs ($20.46 in chips)
Seat 4: shovetoi ($3.21 in chips)
Seat 5: BadTom32 ($1.21 in chips)
Seat 6: j10playerj10 ($2.42 in chips)
zat210: posts small blind $0.01
LLregs: posts big blind $0.02
*** HOLE CARDS ***
Dealt to LLregs [9s Jc]
shovetoi: folds
BadTom32: folds
j10playerj10: folds
my sapphire: raises $0.03 to $0.05
zat210: folds
LLregs: calls $0.03
*** FLOP *** [2s 8c 9d]
LLregs: checks
my sapphire: bets $0.06
LLregs: calls $0.06
*** TURN *** [2s 8c 9d] [6h]
LLregs: checks
my sapphire: checks
*** RIVER *** [2s 8c 9d 6h] [Ts]
LLregs: bets $0.11
my sapphire: folds
Uncalled bet ($0.11) returned to LLregs
LLregs collected $0.22 from pot
LLregs: doesn't show hand
*** SUMMARY ***
Total pot $0.23 | Rake $0.01
Board [2s 8c 9d 6h Ts]
Seat 1: my sapphire (button) folded on the River
Seat 2: zat210 (small blind) folded before Flop
Seat 3: LLregs (big blind) collected ($0.22)
Seat 4: shovetoi folded before Flop (didn't bet)
Seat 5: BadTom32 folded before Flop (didn't bet)
Seat 6: j10playerj10 folded before Flop (didn't bet)

PokerStars Zoom Hand #247970755813:  Hold'em No Limit ($0.01/$0.02) - 2023/12/31 0:03:58 WET [2023/12/30 19:03:58 ET]
Table 'Halley' 6-max Seat #1 is the button
Seat 1: piistoon ($2 in chips)
Seat 2: LLregs ($20.57 in chips)
Seat 3: my sapphire ($2.07 in chips)
Seat 4: altertan ($4.17 in chips)
Seat 5: Holding1994 ($2.81 in chips)
Seat 6: alex_4_jack ($2.01 in chips)
LLregs: posts small blind $0.01
my sapphire: posts big blind $0.02
*** HOLE CARDS ***
Dealt to LLregs [Ts 9s]
altertan: folds
Holding1994: folds
alex_4_jack: folds
piistoon: folds
LLregs: raises $0.04 to $0.06
my sapphire: folds
Uncalled bet ($0.04) returned to LLregs
LLregs collected $0.04 from pot
LLregs: doesn't show hand
*** SUMMARY ***
Total pot $0.04 | Rake $0
Seat 1: piistoon (button) folded before Flop (didn't bet)
Seat 2: LLregs (small blind) collected ($0.04)
Seat 3: my sapphire (big blind) folded before Flop
Seat 4: altertan folded before Flop (didn't bet)
Seat 5: Holding1994 folded before Flop (didn't bet)
Seat 6: alex_4_jack folded before Flop (didn't bet)

PokerStars Zoom Hand #247970765472:  Hold'em No Limit ($0.01/$0.02) - 2023/12/31 0:04:30 WET [2023/12/30 19:04:30 ET]
Table 'Halley' 6-max Seat #1 is the button
Seat 1: LLregs ($20.59 in chips)
Seat 2: shovetoi ($3.53 in chips)
Seat 3: micro0401 ($2.21 in chips)
Seat 4: capuuh ($3.91 in chips)
Seat 5: Threnodytz ($1.47 in chips)
Seat 6: eektwomice ($3.33 in chips)
shovetoi: posts small blind $0.01
micro0401: posts big blind $0.02
*** HOLE CARDS ***
Dealt to LLregs [8c 5s]
capuuh: raises $0.03 to $0.05
Threnodytz: folds
eektwomice: folds
LLregs: folds
shovetoi: folds
micro0401: folds
Uncalled bet ($0.03) returned to capuuh
capuuh collected $0.05 from pot
capuuh: doesn't show hand
*** SUMMARY ***
Total pot $0.05 | Rake $0
Seat 1: LLregs (button) folded before Flop (didn't bet)
Seat 2: shovetoi (small blind) folded before Flop
Seat 3: micro0401 (big blind) folded before Flop
Seat 4: capuuh collected ($0.05)
Seat 5: Threnodytz folded before Flop (didn't bet)
Seat 6: eektwomice folded before Flop (didn't bet)

PokerStars Zoom Hand #247970771646:  Hold'em No Limit ($0.01/$0.02) - 2023/12/31 0:04:50 WET [2023/12/30 19:04:50 ET]
Table 'Halley' 6-max Seat #1 is the button
Seat 1: fafyny ($1.94 in chips)
Seat 2: capuuh ($2.41 in chips)
Seat 3: broks01 ($2 in chips)
Seat 4: LLregs ($20.59 in chips)
Seat 5: 888lifeIS ($2.25 in chips)
Seat 6: altertan ($2.41 in chips)
capuuh: posts small blind $0.01
broks01: posts big blind $0.02
*** HOLE CARDS ***
Dealt to LLregs [7d Ks]
LLregs: folds
888lifeIS: raises $0.02 to $0.04
altertan: folds
fafyny: folds
capuuh: folds
broks01: folds
Uncalled bet ($0.02) returned to 888lifeIS
888lifeIS collected $0.05 from pot
888lifeIS: doesn't show hand
*** SUMMARY ***
Total pot $0.05 | Rake $0
Seat 1: fafyny (button) folded before Flop (didn't bet)
Seat 2: capuuh (small blind) folded before Flop
Seat 3: broks01 (big blind) folded before Flop
Seat 4: LLregs folded before Flop (didn't bet)
Seat 5: 888lifeIS collected ($0.05)
Seat 6: altertan folded before Flop (didn't bet)

PokerStars Zoom Hand #247970764257:  Hold'em No Limit ($0.01/$0.02) - 2023/12/31 0:04:26 WET [2023/12/30 19:04:26 ET]
Table 'Halley' 6-max Seat #1 is the button
Seat 1: BadTom32 ($1.21 in chips)
Seat 2: 2plateado2 ($2 in chips)
Seat 3: Bily Bo ($2.94 in chips)
Seat 4: conspy84 ($2.82 in chips)
Seat 5: LLregs ($20.59 in chips)
Seat 6: NineHi72 ($13.46 in chips)
2plateado2: posts small blind $0.01
Bily Bo: posts big blind $0.02
*** HOLE CARDS ***
Dealt to LLregs [Ts 2h]
conspy84: folds
LLregs: folds
NineHi72: raises $0.04 to $0.06
BadTom32: calls $0.06
2plateado2: folds
Bily Bo: folds
*** FLOP *** [3c As Tc]
NineHi72: bets $0.09
BadTom32: calls $0.09
*** TURN *** [3c As Tc] [9h]
NineHi72: checks
BadTom32: bets $0.16
NineHi72: folds
Uncalled bet ($0.16) returned to BadTom32
BadTom32 collected $0.32 from pot
BadTom32: doesn't show hand
*** SUMMARY ***
Total pot $0.33 | Rake $0.01
Board [3c As Tc 9h]
Seat 1: BadTom32 (button) collected ($0.32)
Seat 2: 2plateado2 (small blind) folded before Flop
Seat 3: Bily Bo (big blind) folded before Flop
Seat 4: conspy84 folded before Flop (didn't bet)
Seat 5: LLregs folded before Flop (didn't bet)
Seat 6: NineHi72 folded on the Turn

PokerStars Zoom Hand #247970772890:  Hold'em No Limit ($0.01/$0.02) - 2023/12/31 0:04:54 WET [2023/12/30 19:04:54 ET]
Table 'Halley' 6-max Seat #1 is the button
Seat 1: FrancoJokerPokk ($2.77 in chips)
Seat 2: GuyverXpro ($1.89 in chips)
Seat 3: TamiSieche ($1.75 in chips)
Seat 4: luizlobo2 ($3.93 in chips)
Seat 5: LLregs ($20.59 in chips)
Seat 6: IngeniEbr10 ($2.05 in chips)
GuyverXpro: posts small blind $0.01
TamiSieche: posts big blind $0.02
*** HOLE CARDS ***
Dealt to LLregs [Kc 5s]
luizlobo2: raises $0.04 to $0.06
LLregs: folds
IngeniEbr10: folds
FrancoJokerPokk: folds
GuyverXpro: calls $0.05
TamiSieche: folds
*** FLOP *** [As 5h 4d]
GuyverXpro: checks
luizlobo2: bets $0.06
GuyverXpro: folds
Uncalled bet ($0.06) returned to luizlobo2
luizlobo2 collected $0.14 from pot
luizlobo2: doesn't show hand
*** SUMMARY ***
Total pot $0.14 | Rake $0
Board [As 5h 4d]
Seat 1: FrancoJokerPokk (button) folded before Flop (didn't bet)
Seat 2: GuyverXpro (small blind) folded on the Flop
Seat 3: TamiSieche (big blind) folded before Flop
Seat 4: luizlobo2 collected ($0.14)
Seat 5: LLregs folded before Flop (didn't bet)
Seat 6: IngeniEbr10 folded before Flop (didn't bet)

PokerStars Zoom Hand #247970767238:  Hold'em No Limit ($0.01/$0.02) - 2023/12/31 0:04:35 WET [2023/12/30 19:04:35 ET]
Table 'Halley' 6-max Seat #1 is the button
Seat 1: my sapphire ($9.90 in chips)
Seat 2: bornagain002 ($4.88 in chips)
Seat 3: qw3306 ($2.08 in chips)
Seat 4: Shmatrixs ($2.27 in chips)
Seat 5: altertan ($4.14 in chips)
Seat 6: LLregs ($20.59 in chips)
bornagain002: posts small blind $0.01
qw3306: posts big blind $0.02
*** HOLE CARDS ***
Dealt to LLregs [Ks 9c]
Shmatrixs: folds
altertan: folds
LLregs: folds
my sapphire: raises $0.03 to $0.05
bornagain002: raises $0.12 to $0.17
qw3306: folds
my sapphire: calls $0.12
*** FLOP *** [9h 5d 8c]
bornagain002: bets $0.35
my sapphire: calls $0.35
*** TURN *** [9h 5d 8c] [3h]
bornagain002: bets $4.36 and is all-in
my sapphire: folds
Uncalled bet ($4.36) returned to bornagain002
bornagain002 collected $1.02 from pot
bornagain002: doesn't show hand
*** SUMMARY ***
Total pot $1.06 | Rake $0.04
Board [9h 5d 8c 3h]
Seat 1: my sapphire (button) folded on the Turn
Seat 2: bornagain002 (small blind) collected ($1.02)
Seat 3: qw3306 (big blind) folded before Flop
Seat 4: Shmatrixs folded before Flop (didn't bet)
Seat 5: altertan folded before Flop (didn't bet)
Seat 6: LLregs folded before Flop (didn't bet)

PokerStars Zoom Hand #247970776870:  Hold'em No Limit ($0.01/$0.02) - 2023/12/31 0:05:07 WET [2023/12/30 19:05:07 ET]
Table 'Halley' 6-max Seat #1 is the button
Seat 1: m4tthaios ($3.06 in chips)
Seat 2: 888lifeIS ($2.28 in chips)
Seat 3: LLregs ($20.59 in chips)
Seat 4: Holding1994 ($2.79 in chips)
Seat 5: joshua_raw1 ($3.30 in chips)
Seat 6: micro0401 ($2.14 in chips)
888lifeIS: posts small blind $0.01
LLregs: posts big blind $0.02
*** HOLE CARDS ***
Dealt to LLregs [8s 2s]
Holding1994: folds
joshua_raw1: folds
micro0401: folds
m4tthaios: folds
888lifeIS: raises $0.02 to $0.04
LLregs: raises $0.10 to $0.14
888lifeIS: folds
Uncalled bet ($0.10) returned to LLregs
LLregs collected $0.08 from pot
LLregs: doesn't show hand
*** SUMMARY ***
Total pot $0.08 | Rake $0
Seat 1: m4tthaios (button) folded before Flop (didn't bet)
Seat 2: 888lifeIS (small blind) folded before Flop
Seat 3: LLregs (big blind) collected ($0.08)
Seat 4: Holding1994 folded before Flop (didn't bet)
Seat 5: joshua_raw1 folded before Flop (didn't bet)
Seat 6: micro0401 folded before Flop (didn't bet)

PokerStars Zoom Hand #247970775919:  Hold'em No Limit ($0.01/$0.02) - 2023/12/31 0:05:04 WET [2023/12/30 19:05:04 ET]
Table 'Halley' 6-max Seat #1 is the button
Seat 1: jandsonpower ($2.30 in chips)
Seat 2: beckzz2011 ($6.65 in chips)
Seat 3: CelsinhoBra ($0.58 in chips)
Seat 4: LLregs ($20.59 in chips)
Seat 5: 888lifeIS ($2.28 in chips)
Seat 6: REHSTH ($2.09 in chips)
beckzz2011: posts small blind $0.01
CelsinhoBra: posts big blind $0.02
*** HOLE CARDS ***
Dealt to LLregs [Qh 3c]
LLregs: folds
888lifeIS: folds
REHSTH is disconnected
REHSTH has timed out while disconnected
REHSTH: folds
jandsonpower: folds
beckzz2011: raises $0.04 to $0.06
CelsinhoBra: calls $0.04
*** FLOP *** [7d 2d 8h]
beckzz2011: bets $0.12
CelsinhoBra: folds
Uncalled bet ($0.12) returned to beckzz2011
beckzz2011 collected $0.12 from pot
beckzz2011: doesn't show hand
*** SUMMARY ***
Total pot $0.12 | Rake $0
Board [7d 2d 8h]
Seat 1: jandsonpower (button) folded before Flop (didn't bet)
Seat 2: beckzz2011 (small blind) collected ($0.12)
Seat 3: CelsinhoBra (big blind) folded on the Flop
Seat 4: LLregs folded before Flop (didn't bet)
Seat 5: 888lifeIS folded before Flop (didn't bet)
Seat 6: REHSTH folded before Flop (didn't bet)

PokerStars Zoom Hand #247970783168:  Hold'em No Limit ($0.01/$0.02) - 2023/12/31 0:05:28 WET [2023/12/30 19:05:28 ET]
Table 'Halley' 6-max Seat #1 is the button
Seat 1: 888lifeIS ($2 in chips)
Seat 2: LLregs ($20.63 in chips)
Seat 3: Gambleatze ($0.88 in chips)
Seat 4: GarotoMaroto#1 ($1.20 in chips)
Seat 5: dogor73 ($4.58 in chips)
Seat 6: leedsrounder ($2 in chips)
LLregs: posts small blind $0.01
Gambleatze: posts big blind $0.02
*** HOLE CARDS ***
Dealt to LLregs [4d Kc]
GarotoMaroto#1: folds
dogor73: folds
leedsrounder: folds
888lifeIS: raises $0.02 to $0.04
LLregs: folds
Gambleatze: folds
Uncalled bet ($0.02) returned to 888lifeIS
888lifeIS collected $0.05 from pot
888lifeIS: doesn't show hand
*** SUMMARY ***
Total pot $0.05 | Rake $0
Seat 1: 888lifeIS (button) collected ($0.05)
Seat 2: LLregs (small blind) folded before Flop
Seat 3: Gambleatze (big blind) folded before Flop
Seat 4: GarotoMaroto#1 folded before Flop (didn't bet)
Seat 5: dogor73 folded before Flop (didn't bet)
Seat 6: leedsrounder folded before Flop (didn't bet)

PokerStars Zoom Hand #247970791258:  Hold'em No Limit ($0.01/$0.02) - 2023/12/31 0:05:54 WET [2023/12/30 19:05:54 ET]
Table 'Halley' 6-max Seat #1 is the button
Seat 1: conspy84 ($2.79 in chips)
Seat 2: emopokera ($1.62 in chips)
Seat 3: frankquanki ($1.02 in chips)
Seat 4: 3ldickson ($0.90 in chips)
Seat 5: Holding1994 ($2.73 in chips)
Seat 6: LLregs ($20.62 in chips)
emopokera: posts small blind $0.01
frankquanki: posts big blind $0.02
*** HOLE CARDS ***
Dealt to LLregs [Qd 6h]
3ldickson: folds
Holding1994: folds
LLregs: folds
conspy84: folds
emopokera: folds
Uncalled bet ($0.01) returned to frankquanki
frankquanki collected $0.02 from pot
frankquanki: doesn't show hand
*** SUMMARY ***
Total pot $0.02 | Rake $0
Seat 1: conspy84 (button) folded before Flop (didn't bet)
Seat 2: emopokera (small blind) folded before Flop
Seat 3: frankquanki (big blind) collected ($0.02)
Seat 4: 3ldickson folded before Flop (didn't bet)
Seat 5: Holding1994 folded before Flop (didn't bet)
Seat 6: LLregs folded before Flop (didn't bet)

PokerStars Zoom Hand #247970785652:  Hold'em No Limit ($0.01/$0.02) - 2023/12/31 0:05:36 WET [2023/12/30 19:05:36 ET]
Table 'Halley' 6-max Seat #1 is the button
Seat 1: LLregs ($20.62 in chips)
Seat 2: Dspecial77 ($2 in chips)
Seat 3: beckzz2011 ($6.71 in chips)
Seat 4: cesariox778 ($0.52 in chips)
Seat 5: R.MacGyver13 ($1.16 in chips)
Seat 6: leedsrounder ($5.86 in chips)
Dspecial77: posts small blind $0.01
beckzz2011: posts big blind $0.02
*** HOLE CARDS ***
Dealt to LLregs [7d 8s]
cesariox778: folds
R.MacGyver13: calls $0.02
leedsrounder: folds
LLregs: folds
Dspecial77: folds
beckzz2011: checks
*** FLOP *** [Qh 2c 5c]
beckzz2011: bets $0.03
R.MacGyver13: calls $0.03
*** TURN *** [Qh 2c 5c] [8d]
beckzz2011: checks
R.MacGyver13: checks
*** RIVER *** [Qh 2c 5c 8d] [8c]
beckzz2011: checks
R.MacGyver13: checks
*** SHOW DOWN ***
beckzz2011: shows [2d 4s] (two pair, Eights and Deuces)
R.MacGyver13: mucks hand
beckzz2011 collected $0.11 from pot
*** SUMMARY ***
Total pot $0.11 | Rake $0
Board [Qh 2c 5c 8d 8c]
Seat 1: LLregs (button) folded before Flop (didn't bet)
Seat 2: Dspecial77 (small blind) folded before Flop
Seat 3: beckzz2011 (big blind) showed [2d 4s] and won ($0.11) with two pair, Eights and Deuces
Seat 4: cesariox778 folded before Flop (didn't bet)
Seat 5: R.MacGyver13 mucked [Td Kc]
Seat 6: leedsrounder folded before Flop (didn't bet)

PokerStars Zoom Hand #247970792689:  Hold'em No Limit ($0.01/$0.02) - 2023/12/31 0:05:59 WET [2023/12/30 19:05:59 ET]
Table 'Halley' 6-max Seat #1 is the button
Seat 1: JucyBits ($2 in chips)
Seat 2: LLregs ($20.62 in chips)
Seat 3: TamiSieche ($1.93 in chips)
Seat 4: zeroelegante ($15.20 in chips)
Seat 5: bmisu30 ($0.73 in chips)
Seat 6: Compagno26 ($2.21 in chips)
LLregs: posts small blind $0.01
TamiSieche: posts big blind $0.02
*** HOLE CARDS ***
Dealt to LLregs [Ts 9s]
zeroelegante: folds
bmisu30: raises $0.02 to $0.04
Compagno26: folds
JucyBits: folds
LLregs: calls $0.03
TamiSieche: calls $0.02
*** FLOP *** [Ac 5s 9h]
LLregs: checks
TamiSieche: checks
bmisu30: checks
*** TURN *** [Ac 5s 9h] [3h]
LLregs: checks
TamiSieche: checks
bmisu30: bets $0.06
LLregs: calls $0.06
TamiSieche: folds
*** RIVER *** [Ac 5s 9h 3h] [Td]
LLregs: checks
bmisu30: checks
*** SHOW DOWN ***
LLregs: shows [Ts 9s] (two pair, Tens and Nines)
bmisu30: mucks hand
LLregs collected $0.23 from pot
*** SUMMARY ***
Total pot $0.24 | Rake $0.01
Board [Ac 5s 9h 3h Td]
Seat 1: JucyBits (button) folded before Flop (didn't bet)
Seat 2: LLregs (small blind) showed [Ts 9s] and won ($0.23) with two pair, Tens and Nines
Seat 3: TamiSieche (big blind) folded on the Turn
Seat 4: zeroelegante folded before Flop (didn't bet)
Seat 5: bmisu30 mucked [3c 8c]
Seat 6: Compagno26 folded before Flop (didn't bet)

PokerStars Zoom Hand #247970806786:  Hold'em No Limit ($0.01/$0.02) - 2023/12/31 0:06:45 WET [2023/12/30 19:06:45 ET]
Table 'Halley' 6-max Seat #1 is the button
Seat 1: KeepShine ($2.20 in chips)
Seat 2: JucyBits ($2 in chips)
Seat 3: broks01 ($2.10 in chips)
Seat 4: leedsrounder ($4.87 in chips)
Seat 5: Maariancs ($2.47 in chips)
Seat 6: LLregs ($20.73 in chips)
JucyBits: posts small blind $0.01
broks01: posts big blind $0.02
*** HOLE CARDS ***
Dealt to LLregs [Kh 3h]
leedsrounder: folds
Maariancs: folds
LLregs: folds
KeepShine: folds
JucyBits: raises $0.03 to $0.05
broks01: folds
Uncalled bet ($0.03) returned to JucyBits
JucyBits collected $0.04 from pot
JucyBits: doesn't show hand
*** SUMMARY ***
Total pot $0.04 | Rake $0
Seat 1: KeepShine (button) folded before Flop (didn't bet)
Seat 2: JucyBits (small blind) collected ($0.04)
Seat 3: broks01 (big blind) folded before Flop
Seat 4: leedsrounder folded before Flop (didn't bet)
Seat 5: Maariancs folded before Flop (didn't bet)
Seat 6: LLregs folded before Flop (didn't bet)

PokerStars Zoom Hand #247970803715:  Hold'em No Limit ($0.01/$0.02) - 2023/12/31 0:06:35 WET [2023/12/30 19:06:35 ET]
Table 'Halley' 6-max Seat #1 is the button
Seat 1: Jrussy ($1.91 in chips)
Seat 2: joseleo61 ($3.76 in chips)
Seat 3: LLregs ($20.75 in chips)
Seat 4: pekkakoo ($3.10 in chips)
Seat 5: capuuh ($5.42 in chips)
Seat 6: TONILUCCE ($5.30 in chips)
joseleo61: posts small blind $0.01
LLregs: posts big blind $0.02
*** HOLE CARDS ***
Dealt to LLregs [3d 7d]
pekkakoo: folds
capuuh: folds
TONILUCCE: raises $0.02 to $0.04
Jrussy: folds
joseleo61: folds
LLregs: folds
Uncalled bet ($0.02) returned to TONILUCCE
TONILUCCE collected $0.05 from pot
TONILUCCE: doesn't show hand
*** SUMMARY ***
Total pot $0.05 | Rake $0
Seat 1: Jrussy (button) folded before Flop (didn't bet)
Seat 2: joseleo61 (small blind) folded before Flop
Seat 3: LLregs (big blind) folded before Flop
Seat 4: pekkakoo folded before Flop (didn't bet)
Seat 5: capuuh folded before Flop (didn't bet)
Seat 6: TONILUCCE collected ($0.05)

PokerStars Zoom Hand #247970808503:  Hold'em No Limit ($0.01/$0.02) - 2023/12/31 0:06:50 WET [2023/12/30 19:06:50 ET]
Table 'Halley' 6-max Seat #1 is the button
Seat 1: micro0401 ($2.06 in chips)
Seat 2: mySon22s ($2.01 in chips)
Seat 3: capuuh ($5.41 in chips)
Seat 4: Bergländer ($1.24 in chips)
Seat 5: LLregs ($20.73 in chips)
Seat 6: 3ldickson ($1.01 in chips)
mySon22s: posts small blind $0.01
capuuh: posts big blind $0.02
*** HOLE CARDS ***
Dealt to LLregs [Jc Qh]
Bergländer: folds
LLregs: raises $0.04 to $0.06
3ldickson: folds
micro0401: calls $0.06
mySon22s: folds
capuuh: folds
*** FLOP *** [Ac Qd 5h]
LLregs: checks
micro0401: bets $0.07
LLregs: calls $0.07
*** TURN *** [Ac Qd 5h] [Kd]
LLregs: checks
micro0401: checks
*** RIVER *** [Ac Qd 5h Kd] [4d]
LLregs: bets $0.13
micro0401: raises $0.29 to $0.42
LLregs: folds
Uncalled bet ($0.29) returned to micro0401
micro0401 collected $0.53 from pot
micro0401: doesn't show hand
*** SUMMARY ***
Total pot $0.55 | Rake $0.02
Board [Ac Qd 5h Kd 4d]
Seat 1: micro0401 (button) collected ($0.53)
Seat 2: mySon22s (small blind) folded before Flop
Seat 3: capuuh (big blind) folded before Flop
Seat 4: Bergländer folded before Flop (didn't bet)
Seat 5: LLregs folded on the River
Seat 6: 3ldickson folded before Flop (didn't bet)

PokerStars Zoom Hand #247970831202:  Hold'em No Limit ($0.01/$0.02) - 2023/12/31 0:08:04 WET [2023/12/30 19:08:04 ET]
Table 'Halley' 6-max Seat #1 is the button
Seat 1: ricske68 ($2.46 in chips)
Seat 2: GarotoMaroto#1 ($1.13 in chips)
Seat 3: bluethebear ($1.28 in chips)
Seat 4: jandsonpower ($2 in chips)
Seat 5: dafneoia90 ($1.63 in chips)
Seat 6: LLregs ($20.47 in chips)
GarotoMaroto#1: posts small blind $0.01
bluethebear: posts big blind $0.02
*** HOLE CARDS ***
Dealt to LLregs [Js Td]
jandsonpower: folds
dafneoia90: folds
LLregs: raises $0.04 to $0.06
ricske68: folds
GarotoMaroto#1: folds
bluethebear: folds
Uncalled bet ($0.04) returned to LLregs
LLregs collected $0.05 from pot
LLregs: doesn't show hand
*** SUMMARY ***
Total pot $0.05 | Rake $0
Seat 1: ricske68 (button) folded before Flop (didn't bet)
Seat 2: GarotoMaroto#1 (small blind) folded before Flop
Seat 3: bluethebear (big blind) folded before Flop
Seat 4: jandsonpower folded before Flop (didn't bet)
Seat 5: dafneoia90 folded before Flop (didn't bet)
Seat 6: LLregs collected ($0.05)

PokerStars Zoom Hand #247970835500:  Hold'em No Limit ($0.01/$0.02) - 2023/12/31 0:08:18 WET [2023/12/30 19:08:18 ET]
Table 'Halley' 6-max Seat #1 is the button
Seat 1: my sapphire ($1.86 in chips)
Seat 2: LLregs ($20.50 in chips)
Seat 3: leedsrounder ($2.03 in chips)
Seat 4: NoDenyPanda ($5.21 in chips)
Seat 5: simplydochry ($2 in chips)
Seat 6: bignelsonAK ($0.99 in chips)
LLregs: posts small blind $0.01
leedsrounder: posts big blind $0.02
*** HOLE CARDS ***
Dealt to LLregs [7d 9s]
NoDenyPanda: folds
simplydochry: folds
bignelsonAK: raises $0.02 to $0.04
my sapphire: folds
LLregs: folds
leedsrounder: folds
Uncalled bet ($0.02) returned to bignelsonAK
bignelsonAK collected $0.05 from pot
bignelsonAK: doesn't show hand
*** SUMMARY ***
Total pot $0.05 | Rake $0
Seat 1: my sapphire (button) folded before Flop (didn't bet)
Seat 2: LLregs (small blind) folded before Flop
Seat 3: leedsrounder (big blind) folded before Flop
Seat 4: NoDenyPanda folded before Flop (didn't bet)
Seat 5: simplydochry folded before Flop (didn't bet)
Seat 6: bignelsonAK collected ($0.05)

PokerStars Zoom Hand #247970836771:  Hold'em No Limit ($0.01/$0.02) - 2023/12/31 0:08:22 WET [2023/12/30 19:08:22 ET]
Table 'Halley' 6-max Seat #1 is the button
Seat 1: eektwomice ($3.46 in chips)
Seat 2: Communist654 ($2.08 in chips)
Seat 3: LLregs ($20.49 in chips)
Seat 4: Baron_teran ($2.56 in chips)
Seat 5: eduardo feijó ($1.78 in chips)
Seat 6: my sapphire ($2.39 in chips)
Communist654: posts small blind $0.01
LLregs: posts big blind $0.02
*** HOLE CARDS ***
Dealt to LLregs [8c 5s]
Baron_teran: folds
eduardo feijó: folds
my sapphire: folds
eektwomice: raises $0.03 to $0.05
Communist654: folds
LLregs: folds
Uncalled bet ($0.03) returned to eektwomice
eektwomice collected $0.05 from pot
eektwomice: doesn't show hand
*** SUMMARY ***
Total pot $0.05 | Rake $0
Seat 1: eektwomice (button) collected ($0.05)
Seat 2: Communist654 (small blind) folded before Flop
Seat 3: LLregs (big blind) folded before Flop
Seat 4: Baron_teran folded before Flop (didn't bet)
Seat 5: eduardo feijó folded before Flop (didn't bet)
Seat 6: my sapphire folded before Flop (didn't bet)

PokerStars Zoom Hand #247970828387:  Hold'em No Limit ($0.01/$0.02) - 2023/12/31 0:07:55 WET [2023/12/30 19:07:55 ET]
Table 'Halley' 6-max Seat #1 is the button
Seat 1: m4tthaios ($5.30 in chips)
Seat 2: AdriPato ($2.09 in chips)
Seat 3: roydivision1 ($4.60 in chips)
Seat 4: LLregs ($20.47 in chips)
Seat 5: emopokera ($12.14 in chips)
Seat 6: Bergländer ($1.61 in chips)
AdriPato: posts small blind $0.01
roydivision1: posts big blind $0.02
*** HOLE CARDS ***
Dealt to LLregs [2h 7s]
LLregs: folds
emopokera: folds
Bergländer: calls $0.02
m4tthaios: folds
AdriPato: calls $0.01
roydivision1: checks
*** FLOP *** [Th 6d 7c]
AdriPato: checks
roydivision1: bets $0.05
Bergländer: calls $0.05
AdriPato: folds
*** TURN *** [Th 6d 7c] [8c]
roydivision1: bets $0.08
Bergländer: folds
Uncalled bet ($0.08) returned to roydivision1
roydivision1 collected $0.15 from pot
roydivision1: doesn't show hand
*** SUMMARY ***
Total pot $0.16 | Rake $0.01
Board [Th 6d 7c 8c]
Seat 1: m4tthaios (button) folded before Flop (didn't bet)
Seat 2: AdriPato (small blind) folded on the Flop
Seat 3: roydivision1 (big blind) collected ($0.15)
Seat 4: LLregs folded before Flop (didn't bet)
Seat 5: emopokera folded before Flop (didn't bet)
Seat 6: Bergländer folded on the Turn

PokerStars Zoom Hand #247970830249:  Hold'em No Limit ($0.01/$0.02) - 2023/12/31 0:08:01 WET [2023/12/30 19:08:01 ET]
Table 'Halley' 6-max Seat #1 is the button
Seat 1: LLregs ($20.47 in chips)
Seat 2: pokerstoc938 ($1.98 in chips)
Seat 3: AdriPato ($2.41 in chips)
Seat 4: princepe82 ($2 in chips)
Seat 5: my sapphire ($9.58 in chips)
Seat 6: farfel99 ($0.58 in chips)
pokerstoc938: posts small blind $0.01
AdriPato: posts big blind $0.02
*** HOLE CARDS ***
Dealt to LLregs [7c Qh]
princepe82: folds
my sapphire: folds
farfel99: calls $0.02
LLregs: folds
pokerstoc938: raises $0.04 to $0.06
AdriPato: calls $0.04
farfel99: calls $0.04
*** FLOP *** [Ac 3d 8s]
pokerstoc938: checks
AdriPato: checks
farfel99: checks
*** TURN *** [Ac 3d 8s] [4h]
pokerstoc938: bets $0.17
AdriPato: calls $0.17
farfel99: folds
*** RIVER *** [Ac 3d 8s 4h] [6c]
pokerstoc938: bets $0.50
AdriPato: calls $0.50
*** SHOW DOWN ***
pokerstoc938: shows [8h 8d] (three of a kind, Eights)
AdriPato: mucks hand
pokerstoc938 collected $1.47 from pot
*** SUMMARY ***
Total pot $1.52 | Rake $0.05
Board [Ac 3d 8s 4h 6c]
Seat 1: LLregs (button) folded before Flop (didn't bet)
Seat 2: pokerstoc938 (small blind) showed [8h 8d] and won ($1.47) with three of a kind, Eights
Seat 3: AdriPato (big blind) mucked [As 9c]
Seat 4: princepe82 folded before Flop (didn't bet)
Seat 5: my sapphire folded before Flop (didn't bet)
Seat 6: farfel99 folded on the Turn

PokerStars Zoom Hand #247970841400:  Hold'em No Limit ($0.01/$0.02) - 2023/12/31 0:08:37 WET [2023/12/30 19:08:37 ET]
Table 'Halley' 6-max Seat #1 is the button
Seat 1: violacc ($0.65 in chips)
Seat 2: Naildey ($3.16 in chips)
Seat 3: emopokera ($12.11 in chips)
Seat 4: AugereDivus ($3.85 in chips)
Seat 5: LLregs ($20.47 in chips)
Seat 6: Raymond322 ($4.43 in chips)
Naildey: posts small blind $0.01
emopokera: posts big blind $0.02
*** HOLE CARDS ***
Dealt to LLregs [Js Ts]
AugereDivus: folds
LLregs: raises $0.04 to $0.06
Raymond322: folds
violacc: folds
Naildey: folds
emopokera: folds
Uncalled bet ($0.04) returned to LLregs
LLregs collected $0.05 from pot
LLregs: doesn't show hand
*** SUMMARY ***
Total pot $0.05 | Rake $0
Seat 1: violacc (button) folded before Flop (didn't bet)
Seat 2: Naildey (small blind) folded before Flop
Seat 3: emopokera (big blind) folded before Flop
Seat 4: AugereDivus folded before Flop (didn't bet)
Seat 5: LLregs collected ($0.05)
Seat 6: Raymond322 folded before Flop (didn't bet)

PokerStars Zoom Hand #247970847176:  Hold'em No Limit ($0.01/$0.02) - 2023/12/31 0:08:56 WET [2023/12/30 19:08:56 ET]
Table 'Halley' 6-max Seat #1 is the button
Seat 1: valdir1957 ($5.13 in chips)
Seat 2: Capitari ($2.25 in chips)
Seat 3: piistoon ($2 in chips)
Seat 4: dealmekkplease ($2.44 in chips)
Seat 5: LLregs ($20.50 in chips)
Seat 6: FrancoJokerPokk ($2.90 in chips)
Capitari: posts small blind $0.01
piistoon: posts big blind $0.02
*** HOLE CARDS ***
Dealt to LLregs [2c 9s]
dealmekkplease: folds
LLregs: folds
FrancoJokerPokk: folds
valdir1957: folds
Capitari: folds
Uncalled bet ($0.01) returned to piistoon
piistoon collected $0.02 from pot
piistoon: doesn't show hand
*** SUMMARY ***
Total pot $0.02 | Rake $0
Seat 1: valdir1957 (button) folded before Flop (didn't bet)
Seat 2: Capitari (small blind) folded before Flop
Seat 3: piistoon (big blind) collected ($0.02)
Seat 4: dealmekkplease folded before Flop (didn't bet)
Seat 5: LLregs folded before Flop (didn't bet)
Seat 6: FrancoJokerPokk folded before Flop (didn't bet)

PokerStars Zoom Hand #247970848413:  Hold'em No Limit ($0.01/$0.02) - 2023/12/31 0:09:00 WET [2023/12/30 19:09:00 ET]
Table 'Halley' 6-max Seat #1 is the button
Seat 1: LLregs ($20.50 in chips)
Seat 2: Shmatrixs ($3.19 in chips)
Seat 3: eektwomice ($3.48 in chips)
Seat 4: kuelas ($1.85 in chips)
Seat 5: Compagno26 ($1.95 in chips)
Seat 6: violacc ($0.64 in chips)
Shmatrixs: posts small blind $0.01
eektwomice: posts big blind $0.02
*** HOLE CARDS ***
Dealt to LLregs [6c 2h]
kuelas: folds
Compagno26: folds
violacc: folds
LLregs: folds
Shmatrixs: folds
Uncalled bet ($0.01) returned to eektwomice
eektwomice collected $0.02 from pot
eektwomice: doesn't show hand
*** SUMMARY ***
Total pot $0.02 | Rake $0
Seat 1: LLregs (button) folded before Flop (didn't bet)
Seat 2: Shmatrixs (small blind) folded before Flop
Seat 3: eektwomice (big blind) collected ($0.02)
Seat 4: kuelas folded before Flop (didn't bet)
Seat 5: Compagno26 folded before Flop (didn't bet)
Seat 6: violacc folded before Flop (didn't bet)

PokerStars Zoom Hand #247970850922:  Hold'em No Limit ($0.01/$0.02) - 2023/12/31 0:09:08 WET [2023/12/30 19:09:08 ET]
Table 'Halley' 6-max Seat #1 is the button
Seat 1: HarleyyQinn ($1.70 in chips)
Seat 2: AugereDivus ($3.83 in chips)
Seat 3: Livio100 ($1.47 in chips)
Seat 4: Holding1994 ($5.85 in chips)
Seat 5: frankquanki ($1.07 in chips)
Seat 6: LLregs ($20.50 in chips)
AugereDivus: posts small blind $0.01
Livio100: posts big blind $0.02
*** HOLE CARDS ***
Dealt to LLregs [3c Ah]
Holding1994: folds
frankquanki: folds
LLregs: folds
HarleyyQinn: folds
AugereDivus: folds
Uncalled bet ($0.01) returned to Livio100
Livio100 collected $0.02 from pot
Livio100: doesn't show hand
*** SUMMARY ***
Total pot $0.02 | Rake $0
Seat 1: HarleyyQinn (button) folded before Flop (didn't bet)
Seat 2: AugereDivus (small blind) folded before Flop
Seat 3: Livio100 (big blind) collected ($0.02)
Seat 4: Holding1994 folded before Flop (didn't bet)
Seat 5: frankquanki folded before Flop (didn't bet)
Seat 6: LLregs folded before Flop (didn't bet)

PokerStars Zoom Hand #247970849968:  Hold'em No Limit ($0.01/$0.02) - 2023/12/31 0:09:05 WET [2023/12/30 19:09:05 ET]
Table 'Halley' 6-max Seat #1 is the button
Seat 1: AdriPato ($2.01 in chips)
Seat 2: DropIceoleito ($1.78 in chips)
Seat 3: martha 90kg ($1.02 in chips)
Seat 4: LLregs ($20.50 in chips)
Seat 5: Gomez224 ($2 in chips)
Seat 6: TONILUCCE ($5.25 in chips)
DropIceoleito: posts small blind $0.01
martha 90kg: posts big blind $0.02
*** HOLE CARDS ***
Dealt to LLregs [Jh 4d]
LLregs: folds
Gomez224: folds
TONILUCCE: raises $0.02 to $0.04
AdriPato: folds
DropIceoleito: folds
martha 90kg: folds
Uncalled bet ($0.02) returned to TONILUCCE
TONILUCCE collected $0.05 from pot
TONILUCCE: doesn't show hand
*** SUMMARY ***
Total pot $0.05 | Rake $0
Seat 1: AdriPato (button) folded before Flop (didn't bet)
Seat 2: DropIceoleito (small blind) folded before Flop
Seat 3: martha 90kg (big blind) folded before Flop
Seat 4: LLregs folded before Flop (didn't bet)
Seat 5: Gomez224 folded before Flop (didn't bet)
Seat 6: TONILUCCE collected ($0.05)

PokerStars Zoom Hand #247970852058:  Hold'em No Limit ($0.01/$0.02) - 2023/12/31 0:09:12 WET [2023/12/30 19:09:12 ET]
Table 'Halley' 6-max Seat #1 is the button
Seat 1: mataski ($2.94 in chips)
Seat 2: HarleyyQinn ($1.70 in chips)
Seat 3: LLregs ($20.50 in chips)
Seat 4: capuuh ($5.33 in chips)
Seat 5: joseleo61 ($3.83 in chips)
Seat 6: frankquanki ($1.07 in chips)
HarleyyQinn: posts small blind $0.01
LLregs: posts big blind $0.02
*** HOLE CARDS ***
Dealt to LLregs [Th Js]
capuuh: folds
joseleo61: folds
frankquanki: folds
mataski: folds
HarleyyQinn: folds
Uncalled bet ($0.01) returned to LLregs
LLregs collected $0.02 from pot
LLregs: doesn't show hand
*** SUMMARY ***
Total pot $0.02 | Rake $0
Seat 1: mataski (button) folded before Flop (didn't bet)
Seat 2: HarleyyQinn (small blind) folded before Flop
Seat 3: LLregs (big blind) collected ($0.02)
Seat 4: capuuh folded before Flop (didn't bet)
Seat 5: joseleo61 folded before Flop (didn't bet)
Seat 6: frankquanki folded before Flop (didn't bet)

PokerStars Zoom Hand #247970855425:  Hold'em No Limit ($0.01/$0.02) - 2023/12/31 0:09:23 WET [2023/12/30 19:09:23 ET]
Table 'Halley' 6-max Seat #1 is the button
Seat 1: GeRA XG ($3.39 in chips)
Seat 2: LLregs ($20.51 in chips)
Seat 3: violacc ($0.64 in chips)
Seat 4: bignelsonAK ($0.95 in chips)
Seat 5: kiyoto0407 ($1.55 in chips)
Seat 6: leedsrounder ($4.97 in chips)
LLregs: posts small blind $0.01
violacc: posts big blind $0.02
*** HOLE CARDS ***
Dealt to LLregs [9h Jh]
bignelsonAK: folds
kiyoto0407: raises $0.04 to $0.06
leedsrounder: folds
GeRA XG: folds
LLregs: calls $0.05
violacc: folds
*** FLOP *** [6c Td 6s]
LLregs: checks
kiyoto0407: checks
*** TURN *** [6c Td 6s] [Kh]
LLregs: checks
kiyoto0407: bets $0.07
LLregs: calls $0.07
*** RIVER *** [6c Td 6s Kh] [4d]
LLregs: checks
kiyoto0407: checks
*** SHOW DOWN ***
LLregs: shows [9h Jh] (a pair of Sixes)
kiyoto0407: shows [Jd Ad] (a pair of Sixes - Ace kicker)
kiyoto0407 collected $0.27 from pot
*** SUMMARY ***
Total pot $0.28 | Rake $0.01
Board [6c Td 6s Kh 4d]
Seat 1: GeRA XG (button) folded before Flop (didn't bet)
Seat 2: LLregs (small blind) showed [9h Jh] and lost with a pair of Sixes
Seat 3: violacc (big blind) folded before Flop
Seat 4: bignelsonAK folded before Flop (didn't bet)
Seat 5: kiyoto0407 showed [Jd Ad] and won ($0.27) with a pair of Sixes
Seat 6: leedsrounder folded before Flop (didn't bet)

PokerStars Zoom Hand #247970869763:  Hold'em No Limit ($0.01/$0.02) - 2023/12/31 0:10:10 WET [2023/12/30 19:10:10 ET]
Table 'Halley' 6-max Seat #1 is the button
Seat 1: LLregs ($20.38 in chips)
Seat 2: emopokera ($1.67 in chips)
Seat 3: AugereDivus ($3.82 in chips)
Seat 4: OMGimbusy ($1.83 in chips)
Seat 5: Raymond322 ($4.56 in chips)
Seat 6: Livio100 ($1.44 in chips)
emopokera: posts small blind $0.01
AugereDivus: posts big blind $0.02
*** HOLE CARDS ***
Dealt to LLregs [Ts 8d]
OMGimbusy: folds
Raymond322: raises $0.04 to $0.06
Livio100: folds
LLregs: folds
emopokera: folds
AugereDivus: folds
Uncalled bet ($0.04) returned to Raymond322
Raymond322 collected $0.05 from pot
Raymond322: doesn't show hand
*** SUMMARY ***
Total pot $0.05 | Rake $0
Seat 1: LLregs (button) folded before Flop (didn't bet)
Seat 2: emopokera (small blind) folded before Flop
Seat 3: AugereDivus (big blind) folded before Flop
Seat 4: OMGimbusy folded before Flop (didn't bet)
Seat 5: Raymond322 collected ($0.05)
Seat 6: Livio100 folded before Flop (didn't bet)

PokerStars Zoom Hand #247970867188:  Hold'em No Limit ($0.01/$0.02) - 2023/12/31 0:10:02 WET [2023/12/30 19:10:02 ET]
Table 'Halley' 6-max Seat #1 is the button
Seat 1: szajm ($2.06 in chips)
Seat 2: mySon22s ($2.01 in chips)
Seat 3: AdriPato ($2.13 in chips)
Seat 4: LLregs ($20.38 in chips)
Seat 5: jandsonpower ($2.44 in chips)
Seat 6: my sapphire ($1.86 in chips)
mySon22s: posts small blind $0.01
AdriPato: posts big blind $0.02
*** HOLE CARDS ***
Dealt to LLregs [Jd Tc]
LLregs: folds
jandsonpower: folds
my sapphire: folds
szajm: raises $0.04 to $0.06
mySon22s: folds
AdriPato: folds
Uncalled bet ($0.04) returned to szajm
szajm collected $0.05 from pot
szajm: doesn't show hand
*** SUMMARY ***
Total pot $0.05 | Rake $0
Seat 1: szajm (button) collected ($0.05)
Seat 2: mySon22s (small blind) folded before Flop
Seat 3: AdriPato (big blind) folded before Flop
Seat 4: LLregs folded before Flop (didn't bet)
Seat 5: jandsonpower folded before Flop (didn't bet)
Seat 6: my sapphire folded before Flop (didn't bet)

PokerStars Zoom Hand #247970871198:  Hold'em No Limit ($0.01/$0.02) - 2023/12/31 0:10:15 WET [2023/12/30 19:10:15 ET]
Table 'Halley' 6-max Seat #1 is the button
Seat 1: joshua_raw1 ($3.51 in chips)
Seat 2: Shmatrixs ($2.02 in chips)
Seat 3: Deny0403 ($8.07 in chips)
Seat 4: LLregs ($20.38 in chips)
Seat 5: MariaG05 ($0.62 in chips)
Seat 6: TONILUCCE ($5.28 in chips)
Shmatrixs: posts small blind $0.01
Deny0403: posts big blind $0.02
*** HOLE CARDS ***
Dealt to LLregs [6c Ad]
LLregs: folds
MariaG05: folds
TONILUCCE: raises $0.02 to $0.04
joshua_raw1: folds
Shmatrixs: folds
Deny0403: folds
Uncalled bet ($0.02) returned to TONILUCCE
TONILUCCE collected $0.05 from pot
TONILUCCE: doesn't show hand
*** SUMMARY ***
Total pot $0.05 | Rake $0
Seat 1: joshua_raw1 (button) folded before Flop (didn't bet)
Seat 2: Shmatrixs (small blind) folded before Flop
Seat 3: Deny0403 (big blind) folded before Flop
Seat 4: LLregs folded before Flop (didn't bet)
Seat 5: MariaG05 folded before Flop (didn't bet)
Seat 6: TONILUCCE collected ($0.05)

PokerStars Zoom Hand #247970879182:  Hold'em No Limit ($0.01/$0.02) - 2023/12/31 0:10:41 WET [2023/12/30 19:10:41 ET]
Table 'Halley' 6-max Seat #1 is the button
Seat 1: LLregs ($20.35 in chips)
Seat 2: greenxcss ($2 in chips)
Seat 3: JORDYLEON ($2 in chips)
Seat 4: AA-west-AA ($0.86 in chips)
Seat 5: ricske68 ($2.43 in chips)
Seat 6: simplydochry ($2.05 in chips)
greenxcss: posts small blind $0.01
JORDYLEON: posts big blind $0.02
*** HOLE CARDS ***
Dealt to LLregs [3s Tc]
AA-west-AA: raises $0.02 to $0.04
ricske68: folds
simplydochry: folds
LLregs: folds
greenxcss: folds
JORDYLEON: folds
Uncalled bet ($0.02) returned to AA-west-AA
AA-west-AA collected $0.05 from pot
AA-west-AA: doesn't show hand
*** SUMMARY ***
Total pot $0.05 | Rake $0
Seat 1: LLregs (button) folded before Flop (didn't bet)
Seat 2: greenxcss (small blind) folded before Flop
Seat 3: JORDYLEON (big blind) folded before Flop
Seat 4: AA-west-AA collected ($0.05)
Seat 5: ricske68 folded before Flop (didn't bet)
Seat 6: simplydochry folded before Flop (didn't bet)

PokerStars Zoom Hand #247970868810:  Hold'em No Limit ($0.01/$0.02) - 2023/12/31 0:10:07 WET [2023/12/30 19:10:07 ET]
Table 'Halley' 6-max Seat #1 is the button
Seat 1: GarotoMaroto#1 ($0.66 in chips)
Seat 2: j10playerj10 ($4.72 in chips)
Seat 3: ovi2xs ($1.31 in chips)
Seat 4: LLregs ($20.38 in chips)
Seat 5: simplydochry ($2.05 in chips)
Seat 6: Backdoor95 ($0.85 in chips)
j10playerj10: posts small blind $0.01
ovi2xs: posts big blind $0.02
*** HOLE CARDS ***
Dealt to LLregs [9d 7h]
LLregs: folds
simplydochry: folds
Backdoor95: folds
GarotoMaroto#1: folds
j10playerj10: raises $0.04 to $0.06
ovi2xs: calls $0.04
*** FLOP *** [Tc Th 5d]
j10playerj10: checks
ovi2xs: checks
*** TURN *** [Tc Th 5d] [Ts]
j10playerj10: bets $0.06
ovi2xs: calls $0.06
*** RIVER *** [Tc Th 5d Ts] [As]
j10playerj10: checks
ovi2xs: bets $0.23
j10playerj10: folds
Uncalled bet ($0.23) returned to ovi2xs
ovi2xs collected $0.23 from pot
ovi2xs: doesn't show hand
*** SUMMARY ***
Total pot $0.24 | Rake $0.01
Board [Tc Th 5d Ts As]
Seat 1: GarotoMaroto#1 (button) folded before Flop (didn't bet)
Seat 2: j10playerj10 (small blind) folded on the River
Seat 3: ovi2xs (big blind) collected ($0.23)
Seat 4: LLregs folded before Flop (didn't bet)
Seat 5: simplydochry folded before Flop (didn't bet)
Seat 6: Backdoor95 folded before Flop (didn't bet)

PokerStars Zoom Hand #247970873589:  Hold'em No Limit ($0.01/$0.02) - 2023/12/31 0:10:23 WET [2023/12/30 19:10:23 ET]
Table 'Halley' 6-max Seat #1 is the button
Seat 1: Raymond322 ($4.59 in chips)
Seat 2: AdriPato ($2.11 in chips)
Seat 3: LLregs ($20.38 in chips)
Seat 4: Pere Ubu ($1.65 in chips)
Seat 5: emopokera ($1.70 in chips)
Seat 6: MariaG05 ($0.62 in chips)
AdriPato: posts small blind $0.01
LLregs: posts big blind $0.02
*** HOLE CARDS ***
Dealt to LLregs [4d 7s]
Pere Ubu: folds
emopokera: folds
MariaG05: folds
Raymond322: raises $0.04 to $0.06
AdriPato: calls $0.05
LLregs: folds
*** FLOP *** [7d 9h 6h]
AdriPato: checks
Raymond322: checks
*** TURN *** [7d 9h 6h] [2h]
AdriPato: checks
Raymond322: checks
*** RIVER *** [7d 9h 6h 2h] [2d]
AdriPato: checks
Raymond322: checks
*** SHOW DOWN ***
AdriPato: shows [Jc Qc] (a pair of Deuces)
Raymond322: shows [Ts Ac] (a pair of Deuces - Ace kicker)
Raymond322 collected $0.14 from pot
*** SUMMARY ***
Total pot $0.14 | Rake $0
Board [7d 9h 6h 2h 2d]
Seat 1: Raymond322 (button) showed [Ts Ac] and won ($0.14) with a pair of Deuces
Seat 2: AdriPato (small blind) showed [Jc Qc] and lost with a pair of Deuces
Seat 3: LLregs (big blind) folded before Flop
Seat 4: Pere Ubu folded before Flop (didn't bet)
Seat 5: emopokera folded before Flop (didn't bet)
Seat 6: MariaG05 folded before Flop (didn't bet)

PokerStars Zoom Hand #247970872365:  Hold'em No Limit ($0.01/$0.02) - 2023/12/31 0:10:19 WET [2023/12/30 19:10:19 ET]
Table 'Halley' 6-max Seat #1 is the button
Seat 1: SannBy ($2.63 in chips)
Seat 2: JORDYLEON ($2 in chips)
Seat 3: joshua_raw1 ($3.51 in chips)
Seat 4: sebastiaosj ($2.51 in chips)
Seat 5: dcyd718 ($2.49 in chips)
Seat 6: LLregs ($20.38 in chips)
JORDYLEON: posts small blind $0.01
joshua_raw1: posts big blind $0.02
*** HOLE CARDS ***
Dealt to LLregs [Tc 2h]
sebastiaosj: raises $0.02 to $0.04
dcyd718: folds
LLregs: folds
SannBy: folds
JORDYLEON: folds
joshua_raw1: calls $0.02
*** FLOP *** [2d 4s 5h]
joshua_raw1: bets $0.07
sebastiaosj: calls $0.07
*** TURN *** [2d 4s 5h] [Th]
joshua_raw1: bets $0.24
sebastiaosj: calls $0.24
*** RIVER *** [2d 4s 5h Th] [4h]
joshua_raw1: bets $0.74
sebastiaosj: raises $1.42 to $2.16 and is all-in
joshua_raw1: folds
Uncalled bet ($1.42) returned to sebastiaosj
sebastiaosj collected $2.11 from pot
sebastiaosj: doesn't show hand
*** SUMMARY ***
Total pot $2.19 | Rake $0.08
Board [2d 4s 5h Th 4h]
Seat 1: SannBy (button) folded before Flop (didn't bet)
Seat 2: JORDYLEON (small blind) folded before Flop
Seat 3: joshua_raw1 (big blind) folded on the River
Seat 4: sebastiaosj collected ($2.11)
Seat 5: dcyd718 folded before Flop (didn't bet)
Seat 6: LLregs folded before Flop (didn't bet)

PokerStars Zoom Hand #247970875770:  Hold'em No Limit ($0.01/$0.02) - 2023/12/31 0:10:30 WET [2023/12/30 19:10:30 ET]
Table 'Halley' 6-max Seat #1 is the button
Seat 1: SMartines ($2.13 in chips)
Seat 2: LLregs ($20.36 in chips)
Seat 3: Harold_Seven ($1.74 in chips)
Seat 4: TONILUCCE ($5.31 in chips)
Seat 5: ekipavd996 ($4.79 in chips)
Seat 6: OMGimbusy ($1.80 in chips)
LLregs: posts small blind $0.01
Harold_Seven: posts big blind $0.02
*** HOLE CARDS ***
Dealt to LLregs [4d Jd]
TONILUCCE: raises $0.02 to $0.04
ekipavd996: folds
OMGimbusy: folds
SMartines: raises $0.11 to $0.15
LLregs: folds
Harold_Seven: folds
TONILUCCE: calls $0.11
*** FLOP *** [8c 4c Qd]
TONILUCCE: checks
SMartines: bets $0.22
TONILUCCE: folds
Uncalled bet ($0.22) returned to SMartines
SMartines collected $0.32 from pot
SMartines: doesn't show hand
*** SUMMARY ***
Total pot $0.33 | Rake $0.01
Board [8c 4c Qd]
Seat 1: SMartines (button) collected ($0.32)
Seat 2: LLregs (small blind) folded before Flop
Seat 3: Harold_Seven (big blind) folded before Flop
Seat 4: TONILUCCE folded on the Flop
Seat 5: ekipavd996 folded before Flop (didn't bet)
Seat 6: OMGimbusy folded before Flop (didn't bet)

PokerStars Zoom Hand #247970876652:  Hold'em No Limit ($0.01/$0.02) - 2023/12/31 0:10:33 WET [2023/12/30 19:10:33 ET]
Table 'Halley' 6-max Seat #1 is the button
Seat 1: ricske68 ($2.43 in chips)
Seat 2: Threnodytz ($1.16 in chips)
Seat 3: greenxcss ($2 in chips)
Seat 4: zat210 ($2.09 in chips)
Seat 5: LLregs ($20.35 in chips)
Seat 6: bornagain002 ($4.50 in chips)
Threnodytz: posts small blind $0.01
greenxcss: posts big blind $0.02
*** HOLE CARDS ***
Dealt to LLregs [2c 8d]
zat210: folds
LLregs: folds
bornagain002: raises $0.06 to $0.08
ricske68: folds
Threnodytz: calls $0.07
greenxcss: folds
*** FLOP *** [3c Tc 7d]
Threnodytz: checks
bornagain002: bets $0.08
Threnodytz: calls $0.08
*** TURN *** [3c Tc 7d] [Ad]
Threnodytz: checks
bornagain002: checks
*** RIVER *** [3c Tc 7d Ad] [7s]
Threnodytz: checks
bornagain002: checks
*** SHOW DOWN ***
Threnodytz: shows [8h 8s] (two pair, Eights and Sevens)
bornagain002: shows [4d 4c] (two pair, Sevens and Fours)
Threnodytz collected $0.33 from pot
*** SUMMARY ***
Total pot $0.34 | Rake $0.01
Board [3c Tc 7d Ad 7s]
Seat 1: ricske68 (button) folded before Flop (didn't bet)
Seat 2: Threnodytz (small blind) showed [8h 8s] and won ($0.33) with two pair, Eights and Sevens
Seat 3: greenxcss (big blind) folded before Flop
Seat 4: zat210 folded before Flop (didn't bet)
Seat 5: LLregs folded before Flop (didn't bet)
Seat 6: bornagain002 showed [4d 4c] and lost with two pair, Sevens and Fours

PokerStars Zoom Hand #247970880073:  Hold'em No Limit ($0.01/$0.02) - 2023/12/31 0:10:44 WET [2023/12/30 19:10:44 ET]
Table 'Halley' 6-max Seat #1 is the button
Seat 1: emopokera ($11.73 in chips)
Seat 2: jandsonpower ($2.45 in chips)
Seat 3: LLregs ($20.35 in chips)
Seat 4: LF22631 ($1.44 in chips)
Seat 5: simplydochry ($2.05 in chips)
Seat 6: Aidi1996 ($2.05 in chips)
jandsonpower: posts small blind $0.01
LLregs: posts big blind $0.02
*** HOLE CARDS ***
Dealt to LLregs [4d 9d]
LF22631: calls $0.02
simplydochry: folds
Aidi1996: folds
emopokera: folds
jandsonpower: folds
LLregs: checks
*** FLOP *** [8c 6s Qs]
LLregs: checks
LF22631: checks
*** TURN *** [8c 6s Qs] [4s]
LLregs: bets $0.02
LF22631: folds
Uncalled bet ($0.02) returned to LLregs
LLregs collected $0.05 from pot
LLregs: doesn't show hand
*** SUMMARY ***
Total pot $0.05 | Rake $0
Board [8c 6s Qs 4s]
Seat 1: emopokera (button) folded before Flop (didn't bet)
Seat 2: jandsonpower (small blind) folded before Flop
Seat 3: LLregs (big blind) collected ($0.05)
Seat 4: LF22631 folded on the Turn
Seat 5: simplydochry folded before Flop (didn't bet)
Seat 6: Aidi1996 folded before Flop (didn't bet)

PokerStars Zoom Hand #247970877950:  Hold'em No Limit ($0.01/$0.02) - 2023/12/31 0:10:37 WET [2023/12/30 19:10:37 ET]
Table 'Halley' 6-max Seat #1 is the button
Seat 1: emopokera ($5.90 in chips)
Seat 2: ikurah ($4.25 in chips)
Seat 3: GeRA XG ($4.30 in chips)
Seat 4: my sapphire ($2.46 in chips)
Seat 5: LLregs ($20.35 in chips)
Seat 6: alex_4_jack ($2.09 in chips)
ikurah: posts small blind $0.01
GeRA XG: posts big blind $0.02
*** HOLE CARDS ***
Dealt to LLregs [Qd 3h]
my sapphire: raises $0.03 to $0.05
LLregs: folds
alex_4_jack: calls $0.05
emopokera: calls $0.05
ikurah: folds
GeRA XG: folds
*** FLOP *** [9h Kc Jc]
my sapphire: checks
alex_4_jack: checks
emopokera: bets $0.09
my sapphire: folds
alex_4_jack: calls $0.09
*** TURN *** [9h Kc Jc] [2c]
alex_4_jack: checks
emopokera: checks
*** RIVER *** [9h Kc Jc 2c] [Qc]
alex_4_jack: bets $0.10
emopokera: folds
Uncalled bet ($0.10) returned to alex_4_jack
alex_4_jack collected $0.35 from pot
alex_4_jack: doesn't show hand
*** SUMMARY ***
Total pot $0.36 | Rake $0.01
Board [9h Kc Jc 2c Qc]
Seat 1: emopokera (button) folded on the River
Seat 2: ikurah (small blind) folded before Flop
Seat 3: GeRA XG (big blind) folded before Flop
Seat 4: my sapphire folded on the Flop
Seat 5: LLregs folded before Flop (didn't bet)
Seat 6: alex_4_jack collected ($0.35)

PokerStars Zoom Hand #247970888253:  Hold'em No Limit ($0.01/$0.02) - 2023/12/31 0:11:11 WET [2023/12/30 19:11:11 ET]
Table 'Halley' 6-max Seat #1 is the button
Seat 1: AugereDivus ($3.80 in chips)
Seat 2: LLregs ($20.38 in chips)
Seat 3: Gomez224 ($2.10 in chips)
Seat 4: AdriPato ($2.09 in chips)
Seat 5: demianhyde ($2 in chips)
Seat 6: Ukr Troll ($6.69 in chips)
LLregs: posts small blind $0.01
Gomez224: posts big blind $0.02
*** HOLE CARDS ***
Dealt to LLregs [2c Td]
AdriPato: folds
demianhyde: folds
Ukr Troll: raises $0.04 to $0.06
AugereDivus: folds
LLregs: folds
Gomez224: folds
Uncalled bet ($0.04) returned to Ukr Troll
Ukr Troll collected $0.05 from pot
Ukr Troll: doesn't show hand
*** SUMMARY ***
Total pot $0.05 | Rake $0
Seat 1: AugereDivus (button) folded before Flop (didn't bet)
Seat 2: LLregs (small blind) folded before Flop
Seat 3: Gomez224 (big blind) folded before Flop
Seat 4: AdriPato folded before Flop (didn't bet)
Seat 5: demianhyde folded before Flop (didn't bet)
Seat 6: Ukr Troll collected ($0.05)

PokerStars Zoom Hand #247970889555:  Hold'em No Limit ($0.01/$0.02) - 2023/12/31 0:11:15 WET [2023/12/30 19:11:15 ET]
Table 'Halley' 6-max Seat #1 is the button
Seat 1: degelcamus ($2 in chips)
Seat 2: 888lifeIS ($2 in chips)
Seat 3: mataski ($2.96 in chips)
Seat 4: JucyBits ($2 in chips)
Seat 5: Fluffy Sable ($2.28 in chips)
Seat 6: LLregs ($20.37 in chips)
888lifeIS: posts small blind $0.01
mataski: posts big blind $0.02
*** HOLE CARDS ***
Dealt to LLregs [5s 9h]
JucyBits: folds
Fluffy Sable: folds
LLregs: folds
degelcamus: raises $0.02 to $0.04
888lifeIS: folds
mataski: folds
Uncalled bet ($0.02) returned to degelcamus
degelcamus collected $0.05 from pot
degelcamus: doesn't show hand
*** SUMMARY ***
Total pot $0.05 | Rake $0
Seat 1: degelcamus (button) collected ($0.05)
Seat 2: 888lifeIS (small blind) folded before Flop
Seat 3: mataski (big blind) folded before Flop
Seat 4: JucyBits folded before Flop (didn't bet)
Seat 5: Fluffy Sable folded before Flop (didn't bet)
Seat 6: LLregs folded before Flop (didn't bet)

PokerStars Zoom Hand #247970890784:  Hold'em No Limit ($0.01/$0.02) - 2023/12/31 0:11:19 WET [2023/12/30 19:11:19 ET]
Table 'Halley' 6-max Seat #1 is the button
Seat 1: Jrussy ($2.02 in chips)
Seat 2: shovetoi ($3.59 in chips)
Seat 3: lottokahe2 ($2 in chips)
Seat 4: beckzz2011 ($1.85 in chips)
Seat 5: pekkakoo ($3.45 in chips)
Seat 6: LLregs ($20.37 in chips)
shovetoi: posts small blind $0.01
lottokahe2: posts big blind $0.02
*** HOLE CARDS ***
Dealt to LLregs [Qc 4d]
beckzz2011: folds
pekkakoo: folds
LLregs: folds
Jrussy: folds
shovetoi: folds
Uncalled bet ($0.01) returned to lottokahe2
lottokahe2 collected $0.02 from pot
lottokahe2: doesn't show hand
*** SUMMARY ***
Total pot $0.02 | Rake $0
Seat 1: Jrussy (button) folded before Flop (didn't bet)
Seat 2: shovetoi (small blind) folded before Flop
Seat 3: lottokahe2 (big blind) collected ($0.02)
Seat 4: beckzz2011 folded before Flop (didn't bet)
Seat 5: pekkakoo folded before Flop (didn't bet)
Seat 6: LLregs folded before Flop (didn't bet)

PokerStars Zoom Hand #247970893086:  Hold'em No Limit ($0.01/$0.02) - 2023/12/31 0:11:27 WET [2023/12/30 19:11:27 ET]
Table 'Halley' 6-max Seat #1 is the button
Seat 1: LLregs ($20.37 in chips)
Seat 2: JucyBits ($2 in chips)
Seat 3: dcyd718 ($2.39 in chips)
Seat 4: Harold_Seven ($1.11 in chips)
Seat 5: Livio100 ($1 in chips)
Seat 6: shovetoi ($3.58 in chips)
JucyBits: posts small blind $0.01
dcyd718: posts big blind $0.02
*** HOLE CARDS ***
Dealt to LLregs [Kc 8c]
Harold_Seven: calls $0.02
Livio100: folds
shovetoi: folds
LLregs: folds
JucyBits: folds
dcyd718: checks
*** FLOP *** [Qs Tc Jd]
dcyd718: checks
Harold_Seven: bets $0.02
dcyd718: folds
Uncalled bet ($0.02) returned to Harold_Seven
Harold_Seven collected $0.05 from pot
Harold_Seven: doesn't show hand
*** SUMMARY ***
Total pot $0.05 | Rake $0
Board [Qs Tc Jd]
Seat 1: LLregs (button) folded before Flop (didn't bet)
Seat 2: JucyBits (small blind) folded before Flop
Seat 3: dcyd718 (big blind) folded on the Flop
Seat 4: Harold_Seven collected ($0.05)
Seat 5: Livio100 folded before Flop (didn't bet)
Seat 6: shovetoi folded before Flop (didn't bet)

PokerStars Zoom Hand #247970896934:  Hold'em No Limit ($0.01/$0.02) - 2023/12/31 0:11:40 WET [2023/12/30 19:11:40 ET]
Table 'Halley' 6-max Seat #1 is the button
Seat 1: Ukr Troll ($2.77 in chips)
Seat 2: Jrussy ($2.02 in chips)
Seat 3: LLregs ($20.37 in chips)
Seat 4: szajm ($2.17 in chips)
Seat 5: olsekpoker ($2.43 in chips)
Seat 6: AugereDivus ($4.83 in chips)
Jrussy: posts small blind $0.01
LLregs: posts big blind $0.02
*** HOLE CARDS ***
Dealt to LLregs [5h Td]
szajm: folds
olsekpoker: folds
AugereDivus: folds
Ukr Troll: folds
Jrussy: folds
Uncalled bet ($0.01) returned to LLregs
LLregs collected $0.02 from pot
LLregs: doesn't show hand
*** SUMMARY ***
Total pot $0.02 | Rake $0
Seat 1: Ukr Troll (button) folded before Flop (didn't bet)
Seat 2: Jrussy (small blind) folded before Flop
Seat 3: LLregs (big blind) collected ($0.02)
Seat 4: szajm folded before Flop (didn't bet)
Seat 5: olsekpoker folded before Flop (didn't bet)
Seat 6: AugereDivus folded before Flop (didn't bet)

PokerStars Zoom Hand #247970891846:  Hold'em No Limit ($0.01/$0.02) - 2023/12/31 0:11:23 WET [2023/12/30 19:11:23 ET]
Table 'Halley' 6-max Seat #1 is the button
Seat 1: cesariox778 ($2.05 in chips)
Seat 2: trickywizard64 ($3.63 in chips)
Seat 3: Ukr Troll ($6.72 in chips)
Seat 4: dcyd718 ($2.39 in chips)
Seat 5: LLregs ($20.37 in chips)
Seat 6: eektwomice ($2.39 in chips)
trickywizard64: posts small blind $0.01
Ukr Troll: posts big blind $0.02
*** HOLE CARDS ***
Dealt to LLregs [9c Ad]
dcyd718: folds
LLregs: folds
eektwomice: folds
cesariox778: raises $0.02 to $0.04
trickywizard64: folds
Ukr Troll: calls $0.02
*** FLOP *** [Jd Ah 2d]
Ukr Troll: checks
cesariox778: bets $0.03
Ukr Troll: calls $0.03
*** TURN *** [Jd Ah 2d] [8s]
Ukr Troll: checks
cesariox778: bets $0.11
Ukr Troll: folds
Uncalled bet ($0.11) returned to cesariox778
cesariox778 collected $0.14 from pot
cesariox778: doesn't show hand
*** SUMMARY ***
Total pot $0.15 | Rake $0.01
Board [Jd Ah 2d 8s]
Seat 1: cesariox778 (button) collected ($0.14)
Seat 2: trickywizard64 (small blind) folded before Flop
Seat 3: Ukr Troll (big blind) folded on the Turn
Seat 4: dcyd718 folded before Flop (didn't bet)
Seat 5: LLregs folded before Flop (didn't bet)
Seat 6: eektwomice folded before Flop (didn't bet)

PokerStars Zoom Hand #247970900271:  Hold'em No Limit ($0.01/$0.02) - 2023/12/31 0:11:50 WET [2023/12/30 19:11:50 ET]
Table 'Halley' 6-max Seat #1 is the button
Seat 1: emopokera ($5.73 in chips)
Seat 2: Shmatrixs ($1.82 in chips)
Seat 3: conspy84 ($3.03 in chips)
Seat 4: LLregs ($20.38 in chips)
Seat 5: Raymond322 ($4.64 in chips)
Seat 6: Harold_Seven ($1.14 in chips)
Shmatrixs: posts small blind $0.01
conspy84: posts big blind $0.02
*** HOLE CARDS ***
Dealt to LLregs [Js Ad]
LLregs: raises $0.04 to $0.06
Raymond322: folds
Harold_Seven: folds
emopokera: folds
Shmatrixs: folds
conspy84: folds
Uncalled bet ($0.04) returned to LLregs
LLregs collected $0.05 from pot
LLregs: doesn't show hand
*** SUMMARY ***
Total pot $0.05 | Rake $0
Seat 1: emopokera (button) folded before Flop (didn't bet)
Seat 2: Shmatrixs (small blind) folded before Flop
Seat 3: conspy84 (big blind) folded before Flop
Seat 4: LLregs collected ($0.05)
Seat 5: Raymond322 folded before Flop (didn't bet)
Seat 6: Harold_Seven folded before Flop (didn't bet)

PokerStars Zoom Hand #247970895556:  Hold'em No Limit ($0.01/$0.02) - 2023/12/31 0:11:35 WET [2023/12/30 19:11:35 ET]
Table 'Halley' 6-max Seat #1 is the button
Seat 1: mataski ($2.93 in chips)
Seat 2: scorpion_spe ($1.89 in chips)
Seat 3: beckzz2011 ($6.67 in chips)
Seat 4: LLregs ($20.37 in chips)
Seat 5: princepe82 ($2.43 in chips)
Seat 6: jandsonpower ($2.03 in chips)
scorpion_spe: posts small blind $0.01
beckzz2011: posts big blind $0.02
*** HOLE CARDS ***
Dealt to LLregs [Js 2c]
LLregs: folds
princepe82: folds
jandsonpower: folds
mataski: folds
scorpion_spe: calls $0.01
beckzz2011: checks
*** FLOP *** [Qs 5d 9c]
scorpion_spe: checks
beckzz2011: checks
*** TURN *** [Qs 5d 9c] [Td]
scorpion_spe: checks
beckzz2011: checks
*** RIVER *** [Qs 5d 9c Td] [As]
scorpion_spe: checks
beckzz2011: checks
*** SHOW DOWN ***
scorpion_spe: shows [8h 3h] (high card Ace)
beckzz2011: shows [4h Jd] (high card Ace - Queen+Jack kicker)
beckzz2011 collected $0.04 from pot
*** SUMMARY ***
Total pot $0.04 | Rake $0
Board [Qs 5d 9c Td As]
Seat 1: mataski (button) folded before Flop (didn't bet)
Seat 2: scorpion_spe (small blind) showed [8h 3h] and lost with high card Ace
Seat 3: beckzz2011 (big blind) showed [4h Jd] and won ($0.04) with high card Ace
Seat 4: LLregs folded before Flop (didn't bet)
Seat 5: princepe82 folded before Flop (didn't bet)
Seat 6: jandsonpower folded before Flop (didn't bet)

PokerStars Zoom Hand #247970922509:  Hold'em No Limit ($0.01/$0.02) - 2023/12/31 0:13:05 WET [2023/12/30 19:13:05 ET]
Table 'Halley' 6-max Seat #1 is the button
Seat 1: Raymond322 ($4.48 in chips)
Seat 2: Tony-Broke ($2 in chips)
Seat 3: Ghul Dukaht ($9 in chips)
Seat 4: xink3r7 ($3.61 in chips)
Seat 5: jjuul ($6.96 in chips)
Seat 6: LLregs ($20.31 in chips)
Tony-Broke: posts small blind $0.01
Ghul Dukaht: posts big blind $0.02
*** HOLE CARDS ***
Dealt to LLregs [7h 3s]
xink3r7: folds
jjuul: raises $0.03 to $0.05
LLregs: folds
Raymond322: folds
Tony-Broke: folds
Ghul Dukaht: folds
Uncalled bet ($0.03) returned to jjuul
jjuul collected $0.05 from pot
jjuul: doesn't show hand
*** SUMMARY ***
Total pot $0.05 | Rake $0
Seat 1: Raymond322 (button) folded before Flop (didn't bet)
Seat 2: Tony-Broke (small blind) folded before Flop
Seat 3: Ghul Dukaht (big blind) folded before Flop
Seat 4: xink3r7 folded before Flop (didn't bet)
Seat 5: jjuul collected ($0.05)
Seat 6: LLregs folded before Flop (didn't bet)

PokerStars Zoom Hand #247970918567:  Hold'em No Limit ($0.01/$0.02) - 2023/12/31 0:12:52 WET [2023/12/30 19:12:52 ET]
Table 'Halley' 6-max Seat #1 is the button
Seat 1: LLregs ($20.31 in chips)
Seat 2: CelsinhoBra ($0.39 in chips)
Seat 3: badbeteador ($2.30 in chips)
Seat 4: loulou53 ($3.13 in chips)
Seat 5: my sapphire ($9.69 in chips)
Seat 6: Compagno26 ($1.87 in chips)
CelsinhoBra: posts small blind $0.01
badbeteador: posts big blind $0.02
*** HOLE CARDS ***
Dealt to LLregs [Ac 8s]
loulou53: folds
my sapphire: folds
Compagno26: raises $0.02 to $0.04
LLregs: folds
CelsinhoBra: folds
badbeteador: calls $0.02
*** FLOP *** [9h 6h 3d]
badbeteador: checks
Compagno26: bets $0.05
badbeteador: raises $0.10 to $0.15
Compagno26: folds
Uncalled bet ($0.10) returned to badbeteador
badbeteador collected $0.18 from pot
badbeteador: doesn't show hand
*** SUMMARY ***
Total pot $0.19 | Rake $0.01
Board [9h 6h 3d]
Seat 1: LLregs (button) folded before Flop (didn't bet)
Seat 2: CelsinhoBra (small blind) folded before Flop
Seat 3: badbeteador (big blind) collected ($0.18)
Seat 4: loulou53 folded before Flop (didn't bet)
Seat 5: my sapphire folded before Flop (didn't bet)
Seat 6: Compagno26 folded on the Flop

PokerStars Zoom Hand #247970926096:  Hold'em No Limit ($0.01/$0.02) - 2023/12/31 0:13:17 WET [2023/12/30 19:13:17 ET]
Table 'Halley' 6-max Seat #1 is the button
Seat 1: Maariancs ($4.34 in chips)
Seat 2: degelcamus ($2 in chips)
Seat 3: LLregs ($20.31 in chips)
Seat 4: Raymond322 ($4.48 in chips)
Seat 5: JucyBits ($2 in chips)
Seat 6: bignelsonAK ($0.95 in chips)
degelcamus: posts small blind $0.01
LLregs: posts big blind $0.02
*** HOLE CARDS ***
Dealt to LLregs [Ah 2d]
Raymond322: folds
JucyBits: folds
bignelsonAK: folds
Maariancs: raises $0.03 to $0.05
degelcamus: folds
LLregs: folds
Uncalled bet ($0.03) returned to Maariancs
Maariancs collected $0.05 from pot
Maariancs: doesn't show hand
*** SUMMARY ***
Total pot $0.05 | Rake $0
Seat 1: Maariancs (button) collected ($0.05)
Seat 2: degelcamus (small blind) folded before Flop
Seat 3: LLregs (big blind) folded before Flop
Seat 4: Raymond322 folded before Flop (didn't bet)
Seat 5: JucyBits folded before Flop (didn't bet)
Seat 6: bignelsonAK folded before Flop (didn't bet)

PokerStars Zoom Hand #247970904486:  Hold'em No Limit ($0.01/$0.02) - 2023/12/31 0:12:05 WET [2023/12/30 19:12:05 ET]
Table 'Halley' 6-max Seat #1 is the button
Seat 1: DuXBR ($1.90 in chips)
Seat 2: LLregs ($20.41 in chips)
Seat 3: FrancoJokerPokk ($2.65 in chips)
Seat 4: SMartines ($2.23 in chips)
Seat 5: shovetoi ($2.32 in chips)
Seat 6: RaPoK23 ($2 in chips)
LLregs: posts small blind $0.01
FrancoJokerPokk: posts big blind $0.02
*** HOLE CARDS ***
Dealt to LLregs [8h 9h]
SMartines: folds
shovetoi: folds
RaPoK23: raises $0.02 to $0.04
DuXBR: folds
LLregs: calls $0.03
FrancoJokerPokk: calls $0.02
*** FLOP *** [8d Qd Td]
LLregs: checks
FrancoJokerPokk: bets $0.06
RaPoK23: calls $0.06
LLregs: calls $0.06
*** TURN *** [8d Qd Td] [As]
LLregs: checks
FrancoJokerPokk: bets $0.15
RaPoK23: calls $0.15
LLregs: folds
*** RIVER *** [8d Qd Td As] [6c]
FrancoJokerPokk: bets $0.39
RaPoK23: raises $1.36 to $1.75 and is all-in
FrancoJokerPokk: calls $1.36
*** SHOW DOWN ***
RaPoK23: shows [9c 9s] (a pair of Nines)
FrancoJokerPokk: shows [Ad Kc] (a pair of Aces)
FrancoJokerPokk collected $3.96 from pot
*** SUMMARY ***
Total pot $4.10 | Rake $0.14
Board [8d Qd Td As 6c]
Seat 1: DuXBR (button) folded before Flop (didn't bet)
Seat 2: LLregs (small blind) folded on the Turn
Seat 3: FrancoJokerPokk (big blind) showed [Ad Kc] and won ($3.96) with a pair of Aces
Seat 4: SMartines folded before Flop (didn't bet)
Seat 5: shovetoi folded before Flop (didn't bet)
Seat 6: RaPoK23 showed [9c 9s] and lost with a pair of Nines

PokerStars Zoom Hand #247970929690:  Hold'em No Limit ($0.01/$0.02) - 2023/12/31 0:13:29 WET [2023/12/30 19:13:29 ET]
Table 'Halley' 6-max Seat #1 is the button
Seat 1: Quorthon_Zei ($2.08 in chips)
Seat 2: LLregs ($20.29 in chips)
Seat 3: Fluffy Sable ($2.96 in chips)
Seat 4: huevo_nob10 ($3.25 in chips)
Seat 5: CelsinhoBra ($0.39 in chips)
Seat 6: Gomez224 ($2 in chips)
LLregs: posts small blind $0.01
Fluffy Sable: posts big blind $0.02
*** HOLE CARDS ***
Dealt to LLregs [8d 6h]
huevo_nob10: folds
CelsinhoBra: folds
Gomez224: folds
Quorthon_Zei: folds
LLregs: folds
Uncalled bet ($0.01) returned to Fluffy Sable
Fluffy Sable collected $0.02 from pot
Fluffy Sable: doesn't show hand
*** SUMMARY ***
Total pot $0.02 | Rake $0
Seat 1: Quorthon_Zei (button) folded before Flop (didn't bet)
Seat 2: LLregs (small blind) folded before Flop
Seat 3: Fluffy Sable (big blind) collected ($0.02)
Seat 4: huevo_nob10 folded before Flop (didn't bet)
Seat 5: CelsinhoBra folded before Flop (didn't bet)
Seat 6: Gomez224 folded before Flop (didn't bet)

PokerStars Zoom Hand #247970923714:  Hold'em No Limit ($0.01/$0.02) - 2023/12/31 0:13:08 WET [2023/12/30 19:13:08 ET]
Table 'Halley' 6-max Seat #1 is the button
Seat 1: xink3r7 ($3.61 in chips)
Seat 2: VIDOPRO23 ($1.34 in chips)
Seat 3: JuanChu070 ($2.62 in chips)
Seat 4: LLregs ($20.31 in chips)
Seat 5: degelcamus ($2.10 in chips)
Seat 6: cesariox778 ($2.31 in chips)
VIDOPRO23: posts small blind $0.01
JuanChu070: posts big blind $0.02
*** HOLE CARDS ***
Dealt to LLregs [2c 4s]
LLregs: folds
degelcamus: folds
cesariox778: folds
xink3r7: calls $0.02
VIDOPRO23: folds
JuanChu070: checks
*** FLOP *** [Qh Tc 5d]
JuanChu070: checks
xink3r7: checks
*** TURN *** [Qh Tc 5d] [9c]
JuanChu070: checks
xink3r7: checks
*** RIVER *** [Qh Tc 5d 9c] [Js]
JuanChu070: checks
xink3r7: bets $0.02
JuanChu070: calls $0.02
*** SHOW DOWN ***
xink3r7: shows [Kh 4c] (a straight, Nine to King)
JuanChu070: mucks hand
xink3r7 collected $0.09 from pot
*** SUMMARY ***
Total pot $0.09 | Rake $0
Board [Qh Tc 5d 9c Js]
Seat 1: xink3r7 (button) showed [Kh 4c] and won ($0.09) with a straight, Nine to King
Seat 2: VIDOPRO23 (small blind) folded before Flop
Seat 3: JuanChu070 (big blind) mucked [Td 6d]
Seat 4: LLregs folded before Flop (didn't bet)
Seat 5: degelcamus folded before Flop (didn't bet)
Seat 6: cesariox778 folded before Flop (didn't bet)

PokerStars Zoom Hand #247970924899:  Hold'em No Limit ($0.01/$0.02) - 2023/12/31 0:13:13 WET [2023/12/30 19:13:13 ET]
Table 'Halley' 6-max Seat #1 is the button
Seat 1: Threnodytz ($1.27 in chips)
Seat 2: KV24E ($2.94 in chips)
Seat 3: Shmatrixs ($2.92 in chips)
Seat 4: Leoo00oo ($3.97 in chips)
Seat 5: LLregs ($20.31 in chips)
Seat 6: JucyBits ($2.20 in chips)
KV24E: posts small blind $0.01
Shmatrixs: posts big blind $0.02
*** HOLE CARDS ***
Dealt to LLregs [5c 4s]
Leoo00oo: folds
LLregs: folds
JucyBits: folds
Threnodytz: raises $0.02 to $0.04
KV24E: folds
Shmatrixs: calls $0.02
*** FLOP *** [5s 9d 3s]
Shmatrixs: checks
Threnodytz: checks
*** TURN *** [5s 9d 3s] [3d]
Shmatrixs: checks
Threnodytz: bets $0.03
Shmatrixs: folds
Uncalled bet ($0.03) returned to Threnodytz
Threnodytz collected $0.09 from pot
Threnodytz: doesn't show hand
*** SUMMARY ***
Total pot $0.09 | Rake $0
Board [5s 9d 3s 3d]
Seat 1: Threnodytz (button) collected ($0.09)
Seat 2: KV24E (small blind) folded before Flop
Seat 3: Shmatrixs (big blind) folded on the Turn
Seat 4: Leoo00oo folded before Flop (didn't bet)
Seat 5: LLregs folded before Flop (didn't bet)
Seat 6: JucyBits folded before Flop (didn't bet)

PokerStars Zoom Hand #247970931103:  Hold'em No Limit ($0.01/$0.02) - 2023/12/31 0:13:33 WET [2023/12/30 19:13:33 ET]
Table 'Halley' 6-max Seat #1 is the button
Seat 1: LLregs ($20.28 in chips)
Seat 2: 888lifeIS ($2 in chips)
Seat 3: Ghul Dukaht ($8.97 in chips)
Seat 4: cesariox778 ($2.29 in chips)
Seat 5: joshua_raw1 ($3.03 in chips)
Seat 6: Deny0403 ($2.52 in chips)
888lifeIS: posts small blind $0.01
Ghul Dukaht: posts big blind $0.02
*** HOLE CARDS ***
Dealt to LLregs [7h 4d]
cesariox778: folds
joshua_raw1: raises $0.03 to $0.05
Deny0403: calls $0.05
LLregs: folds
888lifeIS: folds
Ghul Dukaht: folds
*** FLOP *** [Ks 7d 8d]
joshua_raw1: checks
Deny0403: bets $0.09
joshua_raw1: calls $0.09
*** TURN *** [Ks 7d 8d] [3s]
joshua_raw1: checks
Deny0403: bets $0.20
joshua_raw1: calls $0.20
*** RIVER *** [Ks 7d 8d 3s] [2s]
joshua_raw1: bets $2.69 and is all-in
Deny0403: folds
Uncalled bet ($2.69) returned to joshua_raw1
joshua_raw1 collected $0.69 from pot
joshua_raw1: doesn't show hand
*** SUMMARY ***
Total pot $0.71 | Rake $0.02
Board [Ks 7d 8d 3s 2s]
Seat 1: LLregs (button) folded before Flop (didn't bet)
Seat 2: 888lifeIS (small blind) folded before Flop
Seat 3: Ghul Dukaht (big blind) folded before Flop
Seat 4: cesariox778 folded before Flop (didn't bet)
Seat 5: joshua_raw1 collected ($0.69)
Seat 6: Deny0403 folded on the River

PokerStars Zoom Hand #247970933632:  Hold'em No Limit ($0.01/$0.02) - 2023/12/31 0:13:42 WET [2023/12/30 19:13:42 ET]
Table 'Halley' 6-max Seat #1 is the button
Seat 1: shovetoi ($3.35 in chips)
Seat 2: ironman584 ($1.98 in chips)
Seat 3: LLregs ($20.28 in chips)
Seat 4: shediackink ($1.67 in chips)
Seat 5: leedsrounder ($2.30 in chips)
Seat 6: TamiSieche ($1.75 in chips)
ironman584: posts small blind $0.01
LLregs: posts big blind $0.02
*** HOLE CARDS ***
Dealt to LLregs [3h 6c]
shediackink: folds
leedsrounder: folds
TamiSieche: folds
shovetoi: raises $0.03 to $0.05
ironman584: folds
LLregs: folds
Uncalled bet ($0.03) returned to shovetoi
shovetoi collected $0.05 from pot
shovetoi: doesn't show hand
*** SUMMARY ***
Total pot $0.05 | Rake $0
Seat 1: shovetoi (button) collected ($0.05)
Seat 2: ironman584 (small blind) folded before Flop
Seat 3: LLregs (big blind) folded before Flop
Seat 4: shediackink folded before Flop (didn't bet)
Seat 5: leedsrounder folded before Flop (didn't bet)
Seat 6: TamiSieche folded before Flop (didn't bet)

PokerStars Zoom Hand #247970944110:  Hold'em No Limit ($0.01/$0.02) - 2023/12/31 0:14:17 WET [2023/12/30 19:14:17 ET]
Table 'Halley' 6-max Seat #1 is the button
Seat 1: bluethebear ($1.63 in chips)
Seat 2: Airline PS ($1.43 in chips)
Seat 3: jandsonpower ($2.26 in chips)
Seat 4: LLregs ($20.26 in chips)
Seat 5: Gomez224 ($2.08 in chips)
Seat 6: my sapphire ($1.83 in chips)
Airline PS: posts small blind $0.01
jandsonpower: posts big blind $0.02
*** HOLE CARDS ***
Dealt to LLregs [6s 4c]
LLregs: folds
Gomez224: folds
my sapphire: folds
bluethebear: folds
Airline PS: raises $0.03 to $0.05
jandsonpower: folds
Uncalled bet ($0.03) returned to Airline PS
Airline PS collected $0.04 from pot
Airline PS: doesn't show hand
*** SUMMARY ***
Total pot $0.04 | Rake $0
Seat 1: bluethebear (button) folded before Flop (didn't bet)
Seat 2: Airline PS (small blind) collected ($0.04)
Seat 3: jandsonpower (big blind) folded before Flop
Seat 4: LLregs folded before Flop (didn't bet)
Seat 5: Gomez224 folded before Flop (didn't bet)
Seat 6: my sapphire folded before Flop (didn't bet)

PokerStars Zoom Hand #247970943211:  Hold'em No Limit ($0.01/$0.02) - 2023/12/31 0:14:14 WET [2023/12/30 19:14:14 ET]
Table 'Halley' 6-max Seat #1 is the button
Seat 1: OMGimbusy ($1.78 in chips)
Seat 2: Parfair420 ($1.83 in chips)
Seat 3: dealmekkplease ($3.42 in chips)
Seat 4: Bergländer ($2.31 in chips)
Seat 5: LLregs ($20.26 in chips)
Seat 6: AAAVVV77 ($2.02 in chips)
Parfair420: posts small blind $0.01
dealmekkplease: posts big blind $0.02
*** HOLE CARDS ***
Dealt to LLregs [6d 2c]
Bergländer: calls $0.02
LLregs: folds
AAAVVV77: raises $0.02 to $0.04
OMGimbusy: calls $0.04
Parfair420: folds
dealmekkplease: calls $0.02
Bergländer: calls $0.02
*** FLOP *** [Qs As 2d]
dealmekkplease: bets $0.06
Bergländer: folds
AAAVVV77: folds
OMGimbusy: folds
Uncalled bet ($0.06) returned to dealmekkplease
dealmekkplease collected $0.16 from pot
dealmekkplease: doesn't show hand
*** SUMMARY ***
Total pot $0.17 | Rake $0.01
Board [Qs As 2d]
Seat 1: OMGimbusy (button) folded on the Flop
Seat 2: Parfair420 (small blind) folded before Flop
Seat 3: dealmekkplease (big blind) collected ($0.16)
Seat 4: Bergländer folded on the Flop
Seat 5: LLregs folded before Flop (didn't bet)
Seat 6: AAAVVV77 folded on the Flop

PokerStars Zoom Hand #247970932110:  Hold'em No Limit ($0.01/$0.02) - 2023/12/31 0:13:37 WET [2023/12/30 19:13:37 ET]
Table 'Halley' 6-max Seat #1 is the button
Seat 1: ekipavd996 ($1.52 in chips)
Seat 2: mataski ($3.67 in chips)
Seat 3: paschaman980 ($2.14 in chips)
Seat 4: Gustaveira ($2.02 in chips)
Seat 5: Marcus579 ($6.62 in chips)
Seat 6: LLregs ($20.28 in chips)
mataski: posts small blind $0.01
paschaman980: posts big blind $0.02
*** HOLE CARDS ***
Dealt to LLregs [7s 6c]
Gustaveira: calls $0.02
Marcus579: calls $0.02
LLregs: folds
ekipavd996: calls $0.02
mataski: folds
paschaman980: checks
*** FLOP *** [Kc 4s 4d]
paschaman980: checks
Gustaveira: checks
Marcus579: bets $0.05
ekipavd996: calls $0.05
paschaman980: folds
Gustaveira: folds
*** TURN *** [Kc 4s 4d] [Qc]
Marcus579: bets $0.09
ekipavd996: calls $0.09
*** RIVER *** [Kc 4s 4d Qc] [6s]
Marcus579: checks
ekipavd996: bets $1.36 and is all-in
Marcus579: calls $1.36
*** SHOW DOWN ***
ekipavd996: shows [6h 4h] (a full house, Fours full of Sixes)
Marcus579: shows [Kh Jh] (two pair, Kings and Fours)
ekipavd996 collected $2.98 from pot
*** SUMMARY ***
Total pot $3.09 | Rake $0.11
Board [Kc 4s 4d Qc 6s]
Seat 1: ekipavd996 (button) showed [6h 4h] and won ($2.98) with a full house, Fours full of Sixes
Seat 2: mataski (small blind) folded before Flop
Seat 3: paschaman980 (big blind) folded on the Flop
Seat 4: Gustaveira folded on the Flop
Seat 5: Marcus579 showed [Kh Jh] and lost with two pair, Kings and Fours
Seat 6: LLregs folded before Flop (didn't bet)

PokerStars Zoom Hand #247970945033:  Hold'em No Limit ($0.01/$0.02) - 2023/12/31 0:14:20 WET [2023/12/30 19:14:20 ET]
Table 'Halley' 6-max Seat #1 is the button
Seat 1: IngeniEbr10 ($3.87 in chips)
Seat 2: LLregs ($20.26 in chips)
Seat 3: Paysii ($1.91 in chips)
Seat 4: Bily Bo ($2.92 in chips)
Seat 5: Gomez224 ($2.34 in chips)
Seat 6: Fluffy Sable ($2.96 in chips)
LLregs: posts small blind $0.01
Paysii: posts big blind $0.02
*** HOLE CARDS ***
Dealt to LLregs [6s 8h]
Bily Bo: folds
Gomez224: raises $0.04 to $0.06
Fluffy Sable: folds
IngeniEbr10: folds
LLregs: folds
Paysii: folds
Uncalled bet ($0.04) returned to Gomez224
Gomez224 collected $0.05 from pot
Gomez224: doesn't show hand
*** SUMMARY ***
Total pot $0.05 | Rake $0
Seat 1: IngeniEbr10 (button) folded before Flop (didn't bet)
Seat 2: LLregs (small blind) folded before Flop
Seat 3: Paysii (big blind) folded before Flop
Seat 4: Bily Bo folded before Flop (didn't bet)
Seat 5: Gomez224 collected ($0.05)
Seat 6: Fluffy Sable folded before Flop (didn't bet)

PokerStars Zoom Hand #247970948014:  Hold'em No Limit ($0.01/$0.02) - 2023/12/31 0:14:30 WET [2023/12/30 19:14:30 ET]
Table 'Halley' 6-max Seat #1 is the button
Seat 1: ironman584 ($1.97 in chips)
Seat 2: mataski ($3.64 in chips)
Seat 3: LLregs ($20.25 in chips)
Seat 4: Cris0ner ($2.22 in chips)
Seat 5: 5ars33r ($2.82 in chips)
Seat 6: degelcamus ($2.15 in chips)
mataski: posts small blind $0.01
LLregs: posts big blind $0.02
*** HOLE CARDS ***
Dealt to LLregs [9s 3h]
Cris0ner: folds
5ars33r: raises $0.03 to $0.05
degelcamus: folds
ironman584: folds
mataski: folds
LLregs: folds
Uncalled bet ($0.03) returned to 5ars33r
5ars33r collected $0.05 from pot
5ars33r: doesn't show hand
*** SUMMARY ***
Total pot $0.05 | Rake $0
Seat 1: ironman584 (button) folded before Flop (didn't bet)
Seat 2: mataski (small blind) folded before Flop
Seat 3: LLregs (big blind) folded before Flop
Seat 4: Cris0ner folded before Flop (didn't bet)
Seat 5: 5ars33r collected ($0.05)
Seat 6: degelcamus folded before Flop (didn't bet)

PokerStars Zoom Hand #247970945929:  Hold'em No Limit ($0.01/$0.02) - 2023/12/31 0:14:23 WET [2023/12/30 19:14:23 ET]
Table 'Halley' 6-max Seat #1 is the button
Seat 1: joshua_raw1 ($3.35 in chips)
Seat 2: broks01 ($2.62 in chips)
Seat 3: Communist654 ($2 in chips)
Seat 4: j10playerj10 ($6.91 in chips)
Seat 5: degelcamus ($2 in chips)
Seat 6: LLregs ($20.25 in chips)
broks01: posts small blind $0.01
Communist654: posts big blind $0.02
*** HOLE CARDS ***
Dealt to LLregs [Qs 3c]
j10playerj10: folds
degelcamus: folds
LLregs: folds
joshua_raw1: folds
broks01: raises $0.03 to $0.05
Communist654: calls $0.03
*** FLOP *** [4d 5c 2d]
broks01: bets $0.03
Communist654: calls $0.03
*** TURN *** [4d 5c 2d] [Kc]
broks01: bets $0.10
Communist654: calls $0.10
*** RIVER *** [4d 5c 2d Kc] [5d]
broks01: bets $0.23
Communist654: calls $0.23
*** SHOW DOWN ***
broks01: shows [7d Jd] (a flush, Jack high)
Communist654: mucks hand
broks01 collected $0.79 from pot
*** SUMMARY ***
Total pot $0.82 | Rake $0.03
Board [4d 5c 2d Kc 5d]
Seat 1: joshua_raw1 (button) folded before Flop (didn't bet)
Seat 2: broks01 (small blind) showed [7d Jd] and won ($0.79) with a flush, Jack high
Seat 3: Communist654 (big blind) mucked [Ks 2s]
Seat 4: j10playerj10 folded before Flop (didn't bet)
Seat 5: degelcamus folded before Flop (didn't bet)
Seat 6: LLregs folded before Flop (didn't bet)

PokerStars Zoom Hand #247970952492:  Hold'em No Limit ($0.01/$0.02) - 2023/12/31 0:14:45 WET [2023/12/30 19:14:45 ET]
Table 'Halley' 6-max Seat #1 is the button
Seat 1: LLregs ($20.23 in chips)
Seat 2: Quorthon_Zei ($3.97 in chips)
Seat 3: SannBy ($2.50 in chips)
Seat 4: sebastiaosj ($3.31 in chips)
Seat 5: ikurah ($4.19 in chips)
Seat 6: ricske68 ($2.70 in chips)
Quorthon_Zei: posts small blind $0.01
SannBy: posts big blind $0.02
*** HOLE CARDS ***
Dealt to LLregs [3h Qd]
sebastiaosj: folds
ikurah: raises $0.03 to $0.05
ricske68: folds
LLregs: folds
Quorthon_Zei: folds
SannBy: folds
Uncalled bet ($0.03) returned to ikurah
ikurah collected $0.05 from pot
ikurah: doesn't show hand
*** SUMMARY ***
Total pot $0.05 | Rake $0
Seat 1: LLregs (button) folded before Flop (didn't bet)
Seat 2: Quorthon_Zei (small blind) folded before Flop
Seat 3: SannBy (big blind) folded before Flop
Seat 4: sebastiaosj folded before Flop (didn't bet)
Seat 5: ikurah collected ($0.05)
Seat 6: ricske68 folded before Flop (didn't bet)

PokerStars Zoom Hand #247970946801:  Hold'em No Limit ($0.01/$0.02) - 2023/12/31 0:14:26 WET [2023/12/30 19:14:26 ET]
Table 'Halley' 6-max Seat #1 is the button
Seat 1: jandsonpower ($2.20 in chips)
Seat 2: Dspecial77 ($2.05 in chips)
Seat 3: ImpEdGard ($2 in chips)
Seat 4: simplydochry ($2.71 in chips)
Seat 5: LLregs ($20.25 in chips)
Seat 6: AugereDivus ($9.32 in chips)
Dspecial77: posts small blind $0.01
ImpEdGard: posts big blind $0.02
*** HOLE CARDS ***
Dealt to LLregs [4h 3c]
simplydochry: raises $0.04 to $0.06
LLregs: folds
AugereDivus: folds
jandsonpower: folds
Dspecial77: folds
ImpEdGard: calls $0.04
*** FLOP *** [6s 4c Qc]
ImpEdGard: checks
simplydochry: bets $0.05
ImpEdGard: calls $0.05
*** TURN *** [6s 4c Qc] [Ah]
ImpEdGard: checks
simplydochry: bets $0.17
ImpEdGard: calls $0.17
*** RIVER *** [6s 4c Qc Ah] [Qh]
ImpEdGard: checks
simplydochry: checks
*** SHOW DOWN ***
ImpEdGard: shows [Kc Jc] (a pair of Queens)
simplydochry: shows [As Jd] (two pair, Aces and Queens)
simplydochry collected $0.55 from pot
*** SUMMARY ***
Total pot $0.57 | Rake $0.02
Board [6s 4c Qc Ah Qh]
Seat 1: jandsonpower (button) folded before Flop (didn't bet)
Seat 2: Dspecial77 (small blind) folded before Flop
Seat 3: ImpEdGard (big blind) showed [Kc Jc] and lost with a pair of Queens
Seat 4: simplydochry showed [As Jd] and won ($0.55) with two pair, Aces and Queens
Seat 5: LLregs folded before Flop (didn't bet)
Seat 6: AugereDivus folded before Flop (didn't bet)

PokerStars Zoom Hand #247970956039:  Hold'em No Limit ($0.01/$0.02) - 2023/12/31 0:14:57 WET [2023/12/30 19:14:57 ET]
Table 'Halley' 6-max Seat #1 is the button
Seat 1: Deny0403 ($8.54 in chips)
Seat 2: Ashaman2020 ($5.39 in chips)
Seat 3: Maariancs ($2 in chips)
Seat 4: MariaG05 ($0.67 in chips)
Seat 5: johnathan79717 ($2.22 in chips)
Seat 6: LLregs ($20.22 in chips)
Ashaman2020: posts small blind $0.01
Maariancs: posts big blind $0.02
*** HOLE CARDS ***
Dealt to LLregs [3h Qh]
MariaG05: folds
johnathan79717: folds
LLregs: folds
Deny0403: folds
Ashaman2020: raises $0.02 to $0.04
Maariancs: folds
Uncalled bet ($0.02) returned to Ashaman2020
Ashaman2020 collected $0.04 from pot
Ashaman2020: doesn't show hand
*** SUMMARY ***
Total pot $0.04 | Rake $0
Seat 1: Deny0403 (button) folded before Flop (didn't bet)
Seat 2: Ashaman2020 (small blind) collected ($0.04)
Seat 3: Maariancs (big blind) folded before Flop
Seat 4: MariaG05 folded before Flop (didn't bet)
Seat 5: johnathan79717 folded before Flop (didn't bet)
Seat 6: LLregs folded before Flop (didn't bet)

PokerStars Zoom Hand #247970954846:  Hold'em No Limit ($0.01/$0.02) - 2023/12/31 0:14:53 WET [2023/12/30 19:14:53 ET]
Table 'Halley' 6-max Seat #1 is the button
Seat 1: IngeniEbr10 ($2.05 in chips)
Seat 2: LLregs ($20.23 in chips)
Seat 3: jandsonpower ($2.05 in chips)
Seat 4: beckzz2011 ($6.63 in chips)
Seat 5: eektwomice ($2.33 in chips)
Seat 6: zat210 ($1.95 in chips)
LLregs: posts small blind $0.01
jandsonpower: posts big blind $0.02
*** HOLE CARDS ***
Dealt to LLregs [8h 6c]
beckzz2011: folds
eektwomice: folds
zat210: folds
IngeniEbr10: raises $0.04 to $0.06
LLregs: folds
jandsonpower: folds
Uncalled bet ($0.04) returned to IngeniEbr10
IngeniEbr10 collected $0.05 from pot
IngeniEbr10: doesn't show hand
*** SUMMARY ***
Total pot $0.05 | Rake $0
Seat 1: IngeniEbr10 (button) collected ($0.05)
Seat 2: LLregs (small blind) folded before Flop
Seat 3: jandsonpower (big blind) folded before Flop
Seat 4: beckzz2011 folded before Flop (didn't bet)
Seat 5: eektwomice folded before Flop (didn't bet)
Seat 6: zat210 folded before Flop (didn't bet)

PokerStars Zoom Hand #247970956911:  Hold'em No Limit ($0.01/$0.02) - 2023/12/31 0:15:00 WET [2023/12/30 19:15:00 ET]
Table 'Halley' 6-max Seat #1 is the button
Seat 1: junior071176 ($1.84 in chips)
Seat 2: Frijolesconarro ($2.13 in chips)
Seat 3: WEBOO1 ($2 in chips)
Seat 4: princepe82 ($2.15 in chips)
Seat 5: LLregs ($20.22 in chips)
Seat 6: 2plateado2 ($4.63 in chips)
Frijolesconarro: posts small blind $0.01
WEBOO1: posts big blind $0.02
*** HOLE CARDS ***
Dealt to LLregs [Kd Ks]
princepe82: folds
LLregs: raises $0.04 to $0.06
2plateado2: folds
junior071176: calls $0.06
Frijolesconarro: folds
WEBOO1: folds
*** FLOP *** [2h 3h 8s]
LLregs: bets $0.07
junior071176: calls $0.07
*** TURN *** [2h 3h 8s] [8d]
LLregs: bets $0.13
junior071176: calls $0.13
*** RIVER *** [2h 3h 8s 8d] [Jc]
LLregs: checks
junior071176: checks
*** SHOW DOWN ***
LLregs: shows [Kd Ks] (two pair, Kings and Eights)
junior071176: mucks hand
LLregs collected $0.53 from pot
*** SUMMARY ***
Total pot $0.55 | Rake $0.02
Board [2h 3h 8s 8d Jc]
Seat 1: junior071176 (button) mucked [9d 6d]
Seat 2: Frijolesconarro (small blind) folded before Flop
Seat 3: WEBOO1 (big blind) folded before Flop
Seat 4: princepe82 folded before Flop (didn't bet)
Seat 5: LLregs showed [Kd Ks] and won ($0.53) with two pair, Kings and Eights
Seat 6: 2plateado2 folded before Flop (didn't bet)

PokerStars Zoom Hand #247970982731:  Hold'em No Limit ($0.01/$0.02) - 2023/12/31 0:16:27 WET [2023/12/30 19:16:27 ET]
Table 'Halley' 6-max Seat #1 is the button
Seat 1: LLregs ($20.49 in chips)
Seat 2: capuuh ($2.11 in chips)
Seat 3: my sapphire ($2.17 in chips)
Seat 4: cliffton1980 ($3.53 in chips)
Seat 5: AugereDivus ($4.94 in chips)
Seat 6: jbarrios007 ($2 in chips)
capuuh: posts small blind $0.01
my sapphire: posts big blind $0.02
*** HOLE CARDS ***
Dealt to LLregs [6s Kd]
cliffton1980: folds
AugereDivus: folds
jbarrios007: folds
LLregs: folds
capuuh: raises $0.04 to $0.06
my sapphire: calls $0.04
*** FLOP *** [7c 7s 7d]
capuuh: checks
my sapphire: bets $0.06
capuuh: folds
Uncalled bet ($0.06) returned to my sapphire
my sapphire collected $0.12 from pot
my sapphire: doesn't show hand
*** SUMMARY ***
Total pot $0.12 | Rake $0
Board [7c 7s 7d]
Seat 1: LLregs (button) folded before Flop (didn't bet)
Seat 2: capuuh (small blind) folded on the Flop
Seat 3: my sapphire (big blind) collected ($0.12)
Seat 4: cliffton1980 folded before Flop (didn't bet)
Seat 5: AugereDivus folded before Flop (didn't bet)
Seat 6: jbarrios007 folded before Flop (didn't bet)

PokerStars Zoom Hand #247970986494:  Hold'em No Limit ($0.01/$0.02) - 2023/12/31 0:16:40 WET [2023/12/30 19:16:40 ET]
Table 'Halley' 6-max Seat #1 is the button
Seat 1: mataski ($4.41 in chips)
Seat 2: Maariancs ($2 in chips)
Seat 3: jjuul ($6.98 in chips)
Seat 4: LLregs ($20.49 in chips)
Seat 5: DropIceoleito ($1.52 in chips)
Seat 6: Frijolesconarro ($2.30 in chips)
Maariancs: posts small blind $0.01
jjuul: posts big blind $0.02
*** HOLE CARDS ***
Dealt to LLregs [Ks Jd]
LLregs: raises $0.04 to $0.06
DropIceoleito: folds
Frijolesconarro: calls $0.06
mataski: folds
Maariancs: raises $0.18 to $0.24
jjuul: folds
LLregs: folds
Frijolesconarro: calls $0.18
*** FLOP *** [Ts Kc 8h]
Maariancs: checks
Frijolesconarro: bets $0.27
Maariancs: calls $0.27
*** TURN *** [Ts Kc 8h] [7s]
Maariancs: checks
Frijolesconarro: checks
*** RIVER *** [Ts Kc 8h 7s] [9c]
Maariancs: bets $0.35
Frijolesconarro: calls $0.35
*** SHOW DOWN ***
Maariancs: shows [Ah Kd] (a pair of Kings)
Frijolesconarro: shows [6d Ad] (a straight, Six to Ten)
Frijolesconarro collected $1.74 from pot
*** SUMMARY ***
Total pot $1.80 | Rake $0.06
Board [Ts Kc 8h 7s 9c]
Seat 1: mataski (button) folded before Flop (didn't bet)
Seat 2: Maariancs (small blind) showed [Ah Kd] and lost with a pair of Kings
Seat 3: jjuul (big blind) folded before Flop
Seat 4: LLregs folded before Flop
Seat 5: DropIceoleito folded before Flop (didn't bet)
Seat 6: Frijolesconarro showed [6d Ad] and won ($1.74) with a straight, Six to Ten

PokerStars Zoom Hand #247970992877:  Hold'em No Limit ($0.01/$0.02) - 2023/12/31 0:17:01 WET [2023/12/30 19:17:01 ET]
Table 'Halley' 6-max Seat #1 is the button
Seat 1: chiefkeef35 ($2 in chips)
Seat 2: Cris0ner ($2.24 in chips)
Seat 3: LLregs ($20.43 in chips)
Seat 4: reidy0102 ($2.36 in chips)
Seat 5: emopokera ($2.31 in chips)
Seat 6: mataski ($3.60 in chips)
Cris0ner: posts small blind $0.01
LLregs: posts big blind $0.02
*** HOLE CARDS ***
Dealt to LLregs [Qc 6s]
reidy0102: raises $0.06 to $0.08
emopokera: folds
mataski: folds
chiefkeef35: folds
Cris0ner: folds
LLregs: calls $0.06
*** FLOP *** [Ks 2d Jc]
LLregs: checks
reidy0102: checks
*** TURN *** [Ks 2d Jc] [Kd]
LLregs: bets $0.08
reidy0102: calls $0.08
*** RIVER *** [Ks 2d Jc Kd] [Qs]
LLregs: bets $0.11
reidy0102: folds
Uncalled bet ($0.11) returned to LLregs
LLregs collected $0.32 from pot
LLregs: doesn't show hand
*** SUMMARY ***
Total pot $0.33 | Rake $0.01
Board [Ks 2d Jc Kd Qs]
Seat 1: chiefkeef35 (button) folded before Flop (didn't bet)
Seat 2: Cris0ner (small blind) folded before Flop
Seat 3: LLregs (big blind) collected ($0.32)
Seat 4: reidy0102 folded on the River
Seat 5: emopokera folded before Flop (didn't bet)
Seat 6: mataski folded before Flop (didn't bet)

PokerStars Zoom Hand #247971003208:  Hold'em No Limit ($0.01/$0.02) - 2023/12/31 0:17:36 WET [2023/12/30 19:17:36 ET]
Table 'Halley' 6-max Seat #1 is the button
Seat 1: francuz2000 ($1.90 in chips)
Seat 2: LLregs ($20.59 in chips)
Seat 3: mataski ($3.60 in chips)
Seat 4: 2plateado2 ($4.63 in chips)
Seat 5: cesariox778 ($2.26 in chips)
Seat 6: Synyster17x ($1.43 in chips)
LLregs: posts small blind $0.01
mataski: posts big blind $0.02
*** HOLE CARDS ***
Dealt to LLregs [7c 5h]
2plateado2: folds
cesariox778: folds
Synyster17x: raises $0.03 to $0.05
francuz2000: folds
LLregs: folds
mataski: folds
Uncalled bet ($0.03) returned to Synyster17x
Synyster17x collected $0.05 from pot
Synyster17x: doesn't show hand
*** SUMMARY ***
Total pot $0.05 | Rake $0
Seat 1: francuz2000 (button) folded before Flop (didn't bet)
Seat 2: LLregs (small blind) folded before Flop
Seat 3: mataski (big blind) folded before Flop
Seat 4: 2plateado2 folded before Flop (didn't bet)
Seat 5: cesariox778 folded before Flop (didn't bet)
Seat 6: Synyster17x collected ($0.05)

PokerStars Zoom Hand #247971005602:  Hold'em No Limit ($0.01/$0.02) - 2023/12/31 0:17:44 WET [2023/12/30 19:17:44 ET]
Table 'Halley' 6-max Seat #1 is the button
Seat 1: LLregs ($20.58 in chips)
Seat 2: Communist654 ($4.49 in chips)
Seat 3: jbarrios007 ($2.03 in chips)
Seat 4: frankquanki ($16.08 in chips)
Seat 5: mySon22s ($2.52 in chips)
Seat 6: Threnodytz ($1.21 in chips)
Communist654: posts small blind $0.01
jbarrios007: posts big blind $0.02
*** HOLE CARDS ***
Dealt to LLregs [Ac 8s]
frankquanki: folds
mySon22s: folds
Threnodytz: folds
LLregs: raises $0.06 to $0.08
Communist654: folds
jbarrios007: folds
Uncalled bet ($0.06) returned to LLregs
LLregs collected $0.05 from pot
LLregs: doesn't show hand
*** SUMMARY ***
Total pot $0.05 | Rake $0
Seat 1: LLregs (button) collected ($0.05)
Seat 2: Communist654 (small blind) folded before Flop
Seat 3: jbarrios007 (big blind) folded before Flop
Seat 4: frankquanki folded before Flop (didn't bet)
Seat 5: mySon22s folded before Flop (didn't bet)
Seat 6: Threnodytz folded before Flop (didn't bet)

PokerStars Zoom Hand #247971004138:  Hold'em No Limit ($0.01/$0.02) - 2023/12/31 0:17:39 WET [2023/12/30 19:17:39 ET]
Table 'Halley' 6-max Seat #1 is the button
Seat 1: emopokera ($11.37 in chips)
Seat 2: TamiSieche ($0.66 in chips)
Seat 3: leedsrounder ($2.32 in chips)
Seat 4: LLregs ($20.58 in chips)
Seat 5: 888lifeIS ($2.35 in chips)
Seat 6: lottokahe2 ($1.98 in chips)
TamiSieche: posts small blind $0.01
leedsrounder: posts big blind $0.02
*** HOLE CARDS ***
Dealt to LLregs [4d 6s]
LLregs: folds
888lifeIS: folds
lottokahe2: folds
emopokera: folds
TamiSieche: raises $0.18 to $0.20
leedsrounder: raises $2.12 to $2.32 and is all-in
TamiSieche: calls $0.46 and is all-in
Uncalled bet ($1.66) returned to leedsrounder
*** FLOP *** [3s 9d 2h]
*** TURN *** [3s 9d 2h] [5c]
*** RIVER *** [3s 9d 2h 5c] [7d]
*** SHOW DOWN ***
TamiSieche: shows [As Qd] (high card Ace)
leedsrounder: shows [Jc Ad] (high card Ace - lower kicker)
TamiSieche collected $1.27 from pot
*** SUMMARY ***
Total pot $1.32 | Rake $0.05
Board [3s 9d 2h 5c 7d]
Seat 1: emopokera (button) folded before Flop (didn't bet)
Seat 2: TamiSieche (small blind) showed [As Qd] and won ($1.27) with high card Ace
Seat 3: leedsrounder (big blind) showed [Jc Ad] and lost with high card Ace
Seat 4: LLregs folded before Flop (didn't bet)
Seat 5: 888lifeIS folded before Flop (didn't bet)
Seat 6: lottokahe2 folded before Flop (didn't bet)

PokerStars Zoom Hand #247971010285:  Hold'em No Limit ($0.01/$0.02) - 2023/12/31 0:18:00 WET [2023/12/30 19:18:00 ET]
Table 'Halley' 6-max Seat #1 is the button
Seat 1: MariaG05 ($0.81 in chips)
Seat 2: reidy0102 ($2.21 in chips)
Seat 3: kiyoto0407 ($1.49 in chips)
Seat 4: ironman584 ($1.79 in chips)
Seat 5: my sapphire ($1.91 in chips)
Seat 6: LLregs ($20.61 in chips)
reidy0102: posts small blind $0.01
kiyoto0407: posts big blind $0.02
*** HOLE CARDS ***
Dealt to LLregs [Qd 6h]
ironman584: folds
my sapphire: folds
LLregs: folds
MariaG05: folds
reidy0102: raises $0.08 to $0.10
kiyoto0407: folds
Uncalled bet ($0.08) returned to reidy0102
reidy0102 collected $0.04 from pot
reidy0102: doesn't show hand
*** SUMMARY ***
Total pot $0.04 | Rake $0
Seat 1: MariaG05 (button) folded before Flop (didn't bet)
Seat 2: reidy0102 (small blind) collected ($0.04)
Seat 3: kiyoto0407 (big blind) folded before Flop
Seat 4: ironman584 folded before Flop (didn't bet)
Seat 5: my sapphire folded before Flop (didn't bet)
Seat 6: LLregs folded before Flop (didn't bet)

PokerStars Zoom Hand #247971009116:  Hold'em No Limit ($0.01/$0.02) - 2023/12/31 0:17:56 WET [2023/12/30 19:17:56 ET]
Table 'Halley' 6-max Seat #1 is the button
Seat 1: Tony-Broke ($2.76 in chips)
Seat 2: FumigAA ($1.66 in chips)
Seat 3: broks01 ($2 in chips)
Seat 4: beckzz2011 ($6.70 in chips)
Seat 5: LLregs ($20.61 in chips)
Seat 6: Ghul Dukaht ($7.94 in chips)
FumigAA: posts small blind $0.01
broks01: posts big blind $0.02
*** HOLE CARDS ***
Dealt to LLregs [9s Kh]
beckzz2011: folds
LLregs: folds
Ghul Dukaht: folds
Tony-Broke: raises $0.03 to $0.05
FumigAA: folds
broks01: folds
Uncalled bet ($0.03) returned to Tony-Broke
Tony-Broke collected $0.05 from pot
Tony-Broke: doesn't show hand
*** SUMMARY ***
Total pot $0.05 | Rake $0
Seat 1: Tony-Broke (button) collected ($0.05)
Seat 2: FumigAA (small blind) folded before Flop
Seat 3: broks01 (big blind) folded before Flop
Seat 4: beckzz2011 folded before Flop (didn't bet)
Seat 5: LLregs folded before Flop (didn't bet)
Seat 6: Ghul Dukaht folded before Flop (didn't bet)

PokerStars Zoom Hand #247971011498:  Hold'em No Limit ($0.01/$0.02) - 2023/12/31 0:18:04 WET [2023/12/30 19:18:04 ET]
Table 'Halley' 6-max Seat #1 is the button
Seat 1: IgorFuraZoio ($1.97 in chips)
Seat 2: 2plateado2 ($4.63 in chips)
Seat 3: LLregs ($20.61 in chips)
Seat 4: Holding1994 ($5.30 in chips)
Seat 5: AugereDivus ($4.96 in chips)
Seat 6: violacc ($0.70 in chips)
2plateado2: posts small blind $0.01
LLregs: posts big blind $0.02
*** HOLE CARDS ***
Dealt to LLregs [Td 6h]
Holding1994: folds
AugereDivus: raises $0.04 to $0.06
violacc: folds
IgorFuraZoio: folds
2plateado2: folds
LLregs: folds
Uncalled bet ($0.04) returned to AugereDivus
AugereDivus collected $0.05 from pot
AugereDivus: doesn't show hand
*** SUMMARY ***
Total pot $0.05 | Rake $0
Seat 1: IgorFuraZoio (button) folded before Flop (didn't bet)
Seat 2: 2plateado2 (small blind) folded before Flop
Seat 3: LLregs (big blind) folded before Flop
Seat 4: Holding1994 folded before Flop (didn't bet)
Seat 5: AugereDivus collected ($0.05)
Seat 6: violacc folded before Flop (didn't bet)

PokerStars Zoom Hand #247971013205:  Hold'em No Limit ($0.01/$0.02) - 2023/12/31 0:18:10 WET [2023/12/30 19:18:10 ET]
Table 'Halley' 6-max Seat #1 is the button
Seat 1: IngeniEbr10 ($2 in chips)
Seat 2: LLregs ($20.59 in chips)
Seat 3: TamiSieche ($1.27 in chips)
Seat 4: Paysii ($1.82 in chips)
Seat 5: Holding1994 ($3.46 in chips)
Seat 6: eektwomice ($3.33 in chips)
LLregs: posts small blind $0.01
TamiSieche: posts big blind $0.02
*** HOLE CARDS ***
Dealt to LLregs [3d 6d]
Paysii: folds
Holding1994: folds
eektwomice: folds
IngeniEbr10: folds
LLregs: calls $0.01
TamiSieche: checks
*** FLOP *** [Js 9s 6c]
LLregs: checks
TamiSieche: checks
*** TURN *** [Js 9s 6c] [9h]
LLregs: bets $0.04
TamiSieche: folds
Uncalled bet ($0.04) returned to LLregs
LLregs collected $0.04 from pot
LLregs: doesn't show hand
*** SUMMARY ***
Total pot $0.04 | Rake $0
Board [Js 9s 6c 9h]
Seat 1: IngeniEbr10 (button) folded before Flop (didn't bet)
Seat 2: LLregs (small blind) collected ($0.04)
Seat 3: TamiSieche (big blind) folded on the Turn
Seat 4: Paysii folded before Flop (didn't bet)
Seat 5: Holding1994 folded before Flop (didn't bet)
Seat 6: eektwomice folded before Flop (didn't bet)

PokerStars Zoom Hand #247971021587:  Hold'em No Limit ($0.01/$0.02) - 2023/12/31 0:18:38 WET [2023/12/30 19:18:38 ET]
Table 'Halley' 6-max Seat #1 is the button
Seat 1: bakayoko31 ($2.08 in chips)
Seat 2: JTbukowski ($1.36 in chips)
Seat 3: Airline PS ($1.83 in chips)
Seat 4: LLregs ($20.61 in chips)
Seat 5: TONILUCCE ($4.87 in chips)
Seat 6: j10playerj10 ($6.93 in chips)
JTbukowski: posts small blind $0.01
Airline PS: posts big blind $0.02
*** HOLE CARDS ***
Dealt to LLregs [Jh 5c]
LLregs: folds
TONILUCCE: folds
j10playerj10: folds
bakayoko31: raises $0.04 to $0.06
JTbukowski: folds
Airline PS: folds
Uncalled bet ($0.04) returned to bakayoko31
bakayoko31 collected $0.05 from pot
bakayoko31: doesn't show hand
*** SUMMARY ***
Total pot $0.05 | Rake $0
Seat 1: bakayoko31 (button) collected ($0.05)
Seat 2: JTbukowski (small blind) folded before Flop
Seat 3: Airline PS (big blind) folded before Flop
Seat 4: LLregs folded before Flop (didn't bet)
Seat 5: TONILUCCE folded before Flop (didn't bet)
Seat 6: j10playerj10 folded before Flop (didn't bet)

PokerStars Zoom Hand #247971022827:  Hold'em No Limit ($0.01/$0.02) - 2023/12/31 0:18:42 WET [2023/12/30 19:18:42 ET]
Table 'Halley' 6-max Seat #1 is the button
Seat 1: 39ha54 ($2.03 in chips)
Seat 2: Quorthon_Zei ($3 in chips)
Seat 3: j10playerj10 ($6.93 in chips)
Seat 4: Shmatrixs ($2.76 in chips)
Seat 5: roydivision1 ($2.90 in chips)
Seat 6: LLregs ($20.61 in chips)
Quorthon_Zei: posts small blind $0.01
j10playerj10: posts big blind $0.02
*** HOLE CARDS ***
Dealt to LLregs [Kd Tc]
Shmatrixs: folds
roydivision1: folds
LLregs: raises $0.04 to $0.06
39ha54: folds
Quorthon_Zei: folds
j10playerj10: calls $0.04
*** FLOP *** [Ad 9c 6d]
j10playerj10: checks
LLregs: checks
*** TURN *** [Ad 9c 6d] [5c]
j10playerj10: checks
LLregs: checks
*** RIVER *** [Ad 9c 6d 5c] [Ks]
j10playerj10: bets $0.07
LLregs: calls $0.07
*** SHOW DOWN ***
j10playerj10: shows [Ac 3h] (a pair of Aces)
LLregs: mucks hand
j10playerj10 collected $0.26 from pot
*** SUMMARY ***
Total pot $0.27 | Rake $0.01
Board [Ad 9c 6d 5c Ks]
Seat 1: 39ha54 (button) folded before Flop (didn't bet)
Seat 2: Quorthon_Zei (small blind) folded before Flop
Seat 3: j10playerj10 (big blind) showed [Ac 3h] and won ($0.26) with a pair of Aces
Seat 4: Shmatrixs folded before Flop (didn't bet)
Seat 5: roydivision1 folded before Flop (didn't bet)
Seat 6: LLregs mucked [Kd Tc]

PokerStars Zoom Hand #247971033737:  Hold'em No Limit ($0.01/$0.02) - 2023/12/31 0:19:19 WET [2023/12/30 19:19:19 ET]
Table 'Halley' 6-max Seat #1 is the button
Seat 1: cesariox778 ($2.05 in chips)
Seat 2: LLregs ($20.48 in chips)
Seat 3: 888lifeIS ($2.35 in chips)
Seat 4: dcyd718 ($3.07 in chips)
Seat 5: my sapphire ($1.95 in chips)
Seat 6: VIDOPRO23 ($1.68 in chips)
LLregs: posts small blind $0.01
888lifeIS: posts big blind $0.02
*** HOLE CARDS ***
Dealt to LLregs [Ah 2d]
dcyd718: folds
my sapphire: raises $0.03 to $0.05
VIDOPRO23: folds
cesariox778: folds
LLregs: folds
888lifeIS: folds
Uncalled bet ($0.03) returned to my sapphire
my sapphire collected $0.05 from pot
my sapphire: doesn't show hand
*** SUMMARY ***
Total pot $0.05 | Rake $0
Seat 1: cesariox778 (button) folded before Flop (didn't bet)
Seat 2: LLregs (small blind) folded before Flop
Seat 3: 888lifeIS (big blind) folded before Flop
Seat 4: dcyd718 folded before Flop (didn't bet)
Seat 5: my sapphire collected ($0.05)
Seat 6: VIDOPRO23 folded before Flop (didn't bet)

PokerStars Zoom Hand #247971032522:  Hold'em No Limit ($0.01/$0.02) - 2023/12/31 0:19:15 WET [2023/12/30 19:19:15 ET]
Table 'Halley' 6-max Seat #1 is the button
Seat 1: j10playerj10 ($7.06 in chips)
Seat 2: Alanxx77 ($4.72 in chips)
Seat 3: Airline PS ($1.80 in chips)
Seat 4: MamzerSatlan ($2.45 in chips)
Seat 5: LLregs ($20.48 in chips)
Seat 6: eektwomice ($3.32 in chips)
Alanxx77: posts small blind $0.01
Airline PS: posts big blind $0.02
*** HOLE CARDS ***
Dealt to LLregs [3d Kh]
MamzerSatlan: folds
LLregs: folds
eektwomice: folds
j10playerj10: calls $0.02
Alanxx77: raises $0.08 to $0.10
Airline PS: folds
j10playerj10: folds
Uncalled bet ($0.08) returned to Alanxx77
Alanxx77 collected $0.06 from pot
Alanxx77: doesn't show hand
*** SUMMARY ***
Total pot $0.06 | Rake $0
Seat 1: j10playerj10 (button) folded before Flop
Seat 2: Alanxx77 (small blind) collected ($0.06)
Seat 3: Airline PS (big blind) folded before Flop
Seat 4: MamzerSatlan folded before Flop (didn't bet)
Seat 5: LLregs folded before Flop (didn't bet)
Seat 6: eektwomice folded before Flop (didn't bet)

PokerStars Zoom Hand #247971036419:  Hold'em No Limit ($0.01/$0.02) - 2023/12/31 0:19:28 WET [2023/12/30 19:19:28 ET]
Table 'Halley' 6-max Seat #1 is the button
Seat 1: LLregs ($20.47 in chips)
Seat 2: scorpion_spe ($1.49 in chips)
Seat 3: bethrea ($2 in chips)
Seat 4: broks01 ($3.21 in chips)
Seat 5: Quorthon_Zei ($3.75 in chips)
Seat 6: Ghul Dukaht ($8.08 in chips)
scorpion_spe: posts small blind $0.01
bethrea: posts big blind $0.02
*** HOLE CARDS ***
Dealt to LLregs [9c Ac]
broks01: folds
Quorthon_Zei: folds
Ghul Dukaht: folds
LLregs: raises $0.04 to $0.06
scorpion_spe: calls $0.05
bethrea: folds
*** FLOP *** [Ad Tc 3s]
scorpion_spe: checks
LLregs: bets $0.07
scorpion_spe: calls $0.07
*** TURN *** [Ad Tc 3s] [3c]
scorpion_spe: checks
LLregs: bets $0.09
scorpion_spe: calls $0.09
*** RIVER *** [Ad Tc 3s 3c] [Qs]
scorpion_spe: checks
LLregs: checks
*** SHOW DOWN ***
scorpion_spe: shows [Td 8h] (two pair, Tens and Threes)
LLregs: shows [9c Ac] (two pair, Aces and Threes)
LLregs collected $0.44 from pot
*** SUMMARY ***
Total pot $0.46 | Rake $0.02
Board [Ad Tc 3s 3c Qs]
Seat 1: LLregs (button) showed [9c Ac] and won ($0.44) with two pair, Aces and Threes
Seat 2: scorpion_spe (small blind) showed [Td 8h] and lost with two pair, Tens and Threes
Seat 3: bethrea (big blind) folded before Flop
Seat 4: broks01 folded before Flop (didn't bet)
Seat 5: Quorthon_Zei folded before Flop (didn't bet)
Seat 6: Ghul Dukaht folded before Flop (didn't bet)

PokerStars Zoom Hand #247971047060:  Hold'em No Limit ($0.01/$0.02) - 2023/12/31 0:20:04 WET [2023/12/30 19:20:04 ET]
Table 'Halley' 6-max Seat #1 is the button
Seat 1: MariaG05 ($0.94 in chips)
Seat 2: pewpew58 ($3.78 in chips)
Seat 3: LLregs ($20.69 in chips)
Seat 4: Dspecial77 ($2.42 in chips)
Seat 5: drchilled ($2.19 in chips)
Seat 6: JORDYLEON ($2.41 in chips)
pewpew58: posts small blind $0.01
LLregs: posts big blind $0.02
*** HOLE CARDS ***
Dealt to LLregs [Js 7h]
Dspecial77: folds
drchilled: raises $0.04 to $0.06
JORDYLEON has timed out
JORDYLEON: folds
MariaG05: folds
pewpew58: folds
LLregs: folds
Uncalled bet ($0.04) returned to drchilled
drchilled collected $0.05 from pot
drchilled: doesn't show hand
*** SUMMARY ***
Total pot $0.05 | Rake $0
Seat 1: MariaG05 (button) folded before Flop (didn't bet)
Seat 2: pewpew58 (small blind) folded before Flop
Seat 3: LLregs (big blind) folded before Flop
Seat 4: Dspecial77 folded before Flop (didn't bet)
Seat 5: drchilled collected ($0.05)
Seat 6: JORDYLEON folded before Flop (didn't bet)

PokerStars Zoom Hand #247971056478:  Hold'em No Limit ($0.01/$0.02) - 2023/12/31 0:20:36 WET [2023/12/30 19:20:36 ET]
Table 'Halley' 6-max Seat #1 is the button
Seat 1: LLregs ($20.67 in chips)
Seat 2: PR3SUR3 ($2.20 in chips)
Seat 3: beckzz2011 ($6.80 in chips)
Seat 4: DropIceoleito ($1.33 in chips)
Seat 5: IngeniEbr10 ($3.70 in chips)
Seat 6: Cris0ner ($2.14 in chips)
PR3SUR3: posts small blind $0.01
beckzz2011: posts big blind $0.02
*** HOLE CARDS ***
Dealt to LLregs [Kc Ah]
DropIceoleito: folds
IngeniEbr10: folds
Cris0ner: raises $0.04 to $0.06
LLregs: raises $0.16 to $0.22
PR3SUR3: folds
beckzz2011: folds
Cris0ner: calls $0.16
*** FLOP *** [5s 5c 3s]
Cris0ner: checks
LLregs: bets $0.22
Cris0ner: calls $0.22
*** TURN *** [5s 5c 3s] [2s]
Cris0ner: checks
LLregs: bets $0.29
Cris0ner: raises $0.45 to $0.74
LLregs: folds
Uncalled bet ($0.45) returned to Cris0ner
Cris0ner collected $1.44 from pot
Cris0ner: doesn't show hand
*** SUMMARY ***
Total pot $1.49 | Rake $0.05
Board [5s 5c 3s 2s]
Seat 1: LLregs (button) folded on the Turn
Seat 2: PR3SUR3 (small blind) folded before Flop
Seat 3: beckzz2011 (big blind) folded before Flop
Seat 4: DropIceoleito folded before Flop (didn't bet)
Seat 5: IngeniEbr10 folded before Flop (didn't bet)
Seat 6: Cris0ner collected ($1.44)
